level,page_num,block_num,par_num,line_num,word_num,left,top,width,height,conf,text,bottom,right
1,1,0,0,0,0,0,0,1700,2200,-1,,2200,1700
2,1,1,0,0,0,903,93,610,22,-1,,115,1513
3,1,1,1,0,0,903,93,610,22,-1,,115,1513
4,1,1,1,1,0,903,93,610,22,-1,,115,1513
5,1,1,1,1,1,903,93,116,21,96,VEHICLE,114,1019
5,1,1,1,1,2,1031,94,121,21,96,LOADING,115,1152
5,1,1,1,1,3,1164,94,112,20,93,REPORT,114,1276
5,1,1,1,1,4,1274,89,12,36,91,-,125,1286
5,1,1,1,1,5,1304,94,53,20,94,BILL,114,1357
5,1,1,1,1,6,1367,94,36,20,93,OF,114,1403
5,1,1,1,1,7,1414,93,99,21,90,LADING,114,1513
2,1,2,0,0,0,854,142,767,5,-1,,147,1621
3,1,2,1,0,0,854,142,767,5,-1,,147,1621
4,1,2,1,1,0,854,142,767,5,-1,,147,1621
5,1,2,1,1,1,854,142,767,5,95, ,147,1621
2,1,3,0,0,0,812,242,672,1,-1,,243,1484
3,1,3,1,0,0,812,242,672,1,-1,,243,1484
4,1,3,1,1,0,812,242,672,1,-1,,243,1484
5,1,3,1,1,1,812,242,672,1,95, ,243,1484
2,1,4,0,0,0,55,119,1563,207,-1,,326,1618
3,1,4,1,0,0,55,119,1563,207,-1,,326,1618
4,1,4,1,1,0,139,119,1479,28,-1,,147,1618
5,1,4,1,1,1,139,122,74,22,95,Page:,144,213
5,1,4,1,1,2,239,122,12,18,89,1,140,251
5,1,4,1,1,3,420,144,7,1,0,_,145,427
5,1,4,1,1,4,471,122,44,19,0,530,141,515
5,1,4,1,1,5,683,144,22,1,22,_,145,705
5,1,4,1,1,6,807,120,131,27,96,RAPPORT,147,938
5,1,4,1,1,7,949,120,35,21,92,DE,141,984
5,1,4,1,1,8,995,120,195,22,91,CHARGEMENT,142,1190
5,1,4,1,1,9,1199,132,7,3,92,-,135,1206
5,1,4,1,1,10,1217,120,134,21,91,VEHICULE,141,1351
5,1,4,1,1,11,1362,132,7,2,91,-,134,1369
5,1,4,1,1,12,1379,119,239,22,91,CONNAISSEMENT,141,1618
4,1,4,1,2,0,128,148,535,25,-1,,173,663
5,1,4,1,2,1,128,150,110,16,0,DOCUMENT,166,238
5,1,4,1,2,2,244,151,82,15,0,NUMBER,166,326
5,1,4,1,2,3,355,152,61,18,88,6891,170,416
5,1,4,1,2,4,470,149,1,3,87,|,152,471
5,1,4,1,2,5,528,148,37,24,35,pate,172,565
5,1,4,1,2,6,571,143,92,37,0,bexeeoition,180,663
4,1,4,1,3,0,128,167,1473,42,-1,,209,1601
5,1,4,1,3,1,128,170,23,15,96,No,185,151
5,1,4,1,3,2,158,170,25,15,92,DU,185,183
5,1,4,1,3,3,190,170,111,15,90,DOGUMENT,185,301
5,1,4,1,3,4,514,167,137,42,0,mm/dd/yy,209,651
5,1,4,1,3,5,791,186,29,20,94,24,206,820
5,1,4,1,3,6,831,185,78,22,94,HOUR,207,909
5,1,4,1,3,7,921,185,116,22,0,NUMBER,207,1037
5,1,4,1,3,8,1059,183,206,21,0,_(613)996-6666,204,1265
5,1,4,1,3,9,1302,197,7,3,83,-,200,1309
5,1,4,1,3,10,1320,184,120,23,95,NUMERO,207,1440
5,1,4,1,3,11,1450,186,29,20,94,24,206,1479
5,1,4,1,3,12,1490,184,111,22,95,HEURES,206,1601
4,1,4,1,4,0,140,212,1223,26,-1,,238,1363
5,1,4,1,4,1,140,212,109,19,95,0362663,231,249
5,1,4,1,4,2,272,212,93,20,96,10/007,232,365
5,1,4,1,4,3,520,213,129,20,95,10/08/24,233,649
5,1,4,1,4,4,1041,216,232,22,92,COLLECT,238,1273
5,1,4,1,4,5,1173,212,15,34,89,-,246,1188
5,1,4,1,4,6,1198,216,75,22,91,FRAIS,238,1273
5,1,4,1,4,7,1283,216,80,22,91,VIRES,238,1363
4,1,4,1,5,0,55,222,1510,51,-1,,273,1565
5,1,4,1,5,1,55,238,3,4,50,|,242,58
5,1,4,1,5,2,73,222,203,45,50,CONSIGNESICUSTOMER-,267,276
5,1,4,1,5,3,287,222,177,45,20,DESTINATAIRECLENT,267,464
5,1,4,1,5,4,664,245,2,28,88,|,273,666
5,1,4,1,5,5,680,242,148,25,0,NeGetaelsseuewr,267,828
5,1,4,1,5,6,844,243,2,26,93,|,269,846
5,1,4,1,5,7,855,246,222,13,88,CONSIGNOR,259,1077
5,1,4,1,5,8,960,236,8,41,89,-,277,968
5,1,4,1,5,9,977,243,100,26,87,EXPEDITEUR,269,1077
5,1,4,1,5,10,1457,241,50,26,7,eal,267,1507
5,1,4,1,5,11,1518,241,47,26,16,eter,267,1565
4,1,4,1,6,0,55,274,1557,30,-1,,304,1612
5,1,4,1,6,1,55,276,1,5,93,|,281,56
5,1,4,1,6,2,138,274,81,19,92,PETRO,293,219
5,1,4,1,6,3,236,274,99,19,96,CANADA,293,335
5,1,4,1,6,4,352,275,164,18,95,LUBRICANTS,293,516
5,1,4,1,6,5,536,275,47,18,96,INC,293,583
5,1,4,1,6,6,663,274,168,22,53,(0005064508,296,831
5,1,4,1,6,7,853,276,97,17,91,SUNCOR,293,950
5,1,4,1,6,8,969,276,98,17,96,ENERGY,293,1067
5,1,4,1,6,9,1085,276,132,17,96,MONTREAL,293,1217
5,1,4,1,6,10,1441,280,1,11,84,|,291,1442
5,1,4,1,6,11,1471,274,110,30,91,0082041,304,1581
5,1,4,1,6,12,1589,302,23,1,89,_|,303,1612
4,1,4,1,7,0,138,301,1111,25,-1,,326,1249
5,1,4,1,7,1,138,306,63,16,91,PCLI,322,201
5,1,4,1,7,2,222,313,11,3,85,~,316,233
5,1,4,1,7,3,254,306,96,20,95,QUEBEC,326,350
5,1,4,1,7,4,370,305,45,18,96,302,323,415
5,1,4,1,7,5,664,302,166,21,48,0009406423,323,830
5,1,4,1,7,6,840,301,91,23,89,|11675,324,931
5,1,4,1,7,7,953,310,47,14,95,rue,324,1000
5,1,4,1,7,8,1020,306,164,18,96,Sherbrooke,324,1184
5,1,4,1,7,9,1203,308,46,16,96,est,324,1249
2,1,5,0,0,0,136,334,378,50,-1,,384,514
3,1,5,1,0,0,136,334,378,50,-1,,384,514
4,1,5,1,1,0,138,334,295,18,-1,,352,433
5,1,5,1,1,1,138,334,45,17,96,385,351,183
5,1,5,1,1,2,205,335,146,17,95,SOUTHDOWN,352,351
5,1,5,1,1,3,369,336,64,16,96,ROAD,352,433
4,1,5,1,2,0,136,364,378,20,-1,,384,514
5,1,5,1,2,1,136,364,192,20,96,"MISSISSAUGA,",384,328
5,1,5,1,2,2,352,364,33,17,92,ON,381,385
5,1,5,1,2,3,402,364,49,18,73,L5J,382,451
5,1,5,1,2,4,470,364,44,18,46,2Y¥3,382,514
2,1,6,0,0,0,844,317,2,49,-1,,366,846
3,1,6,1,0,0,844,317,2,49,-1,,366,846
4,1,6,1,1,0,844,317,2,49,-1,,366,846
5,1,6,1,1,1,844,317,2,49,95, ,366,846
2,1,7,0,0,0,851,336,631,21,-1,,357,1482
3,1,7,1,0,0,851,336,631,21,-1,,357,1482
4,1,7,1,1,0,851,336,631,21,-1,,357,1482
5,1,7,1,1,1,851,336,143,20,96,"Montreal,",356,994
5,1,7,1,1,2,1019,337,31,20,92,QC,357,1050
5,1,7,1,1,3,1069,336,48,18,84,H1B,354,1117
5,1,7,1,1,4,1137,336,44,18,17,iCc3,354,1181
5,1,7,1,1,5,1275,336,68,21,55,(613),357,1343
5,1,7,1,1,6,1356,336,126,18,55,996-6666,354,1482
2,1,8,0,0,0,266,376,834,85,-1,,461,1100
3,1,8,1,0,0,266,376,834,85,-1,,461,1100
4,1,8,1,1,0,844,376,256,39,-1,,415,1100
5,1,8,1,1,1,844,376,123,39,81,lvannick,415,967
5,1,8,1,1,2,984,394,116,19,95,Mercier,413,1100
4,1,8,1,2,0,266,412,571,17,-1,,429,837
5,1,8,1,2,1,266,412,66,15,52,“RELEASE,427,332
5,1,8,1,2,2,338,416,47,13,84,(C-ol-A),429,385
5,1,8,1,2,3,390,416,59,11,59,NUMBER,427,449
5,1,8,1,2,4,552,412,4,7,74,|,419,556
5,1,8,1,2,5,560,416,78,12,79,CUSTOMER,428,638
5,1,8,1,2,6,644,414,75,14,96,PURCHASE,428,719
5,1,8,1,2,7,724,417,49,11,96,ORDER,428,773
5,1,8,1,2,8,778,417,59,11,96,NUMBER,428,837
4,1,8,1,3,0,552,419,294,42,-1,,461,846
5,1,8,1,3,1,552,430,1,29,90,|,459,553
5,1,8,1,3,2,610,430,17,11,95,No,441,627
5,1,8,1,3,3,632,430,17,11,96,DE,441,649
5,1,8,1,3,4,655,431,68,11,92,DEMANDE,442,723
5,1,8,1,3,5,728,431,19,11,91,DU,442,747
5,1,8,1,3,6,752,431,49,11,91,CLIENT,442,801
5,1,8,1,3,7,844,419,2,42,88,|,461,846
2,1,9,0,0,0,309,412,534,3,-1,,415,843
3,1,9,1,0,0,309,412,534,3,-1,,415,843
4,1,9,1,1,0,309,412,534,3,-1,,415,843
5,1,9,1,1,1,309,412,534,3,95, ,415,843
2,1,10,0,0,0,552,473,2,9,-1,,482,554
3,1,10,1,0,0,552,473,2,9,-1,,482,554
4,1,10,1,1,0,552,473,2,9,-1,,482,554
5,1,10,1,1,1,552,473,2,9,62,i,482,554
2,1,11,0,0,0,117,480,705,3,-1,,483,822
3,1,11,1,0,0,117,480,705,3,-1,,483,822
4,1,11,1,1,0,117,480,705,3,-1,,483,822
5,1,11,1,1,1,117,480,705,3,95, ,483,822
2,1,12,0,0,0,705,524,918,3,-1,,527,1623
3,1,12,1,0,0,705,524,918,3,-1,,527,1623
4,1,12,1,1,0,705,524,918,3,-1,,527,1623
5,1,12,1,1,1,705,524,918,3,95, ,527,1623
2,1,13,0,0,0,705,482,2,188,-1,,670,707
3,1,13,1,0,0,705,482,2,188,-1,,670,707
4,1,13,1,1,0,705,482,2,188,-1,,670,707
5,1,13,1,1,1,705,482,2,188,95, ,670,707
2,1,14,0,0,0,289,676,309,3,-1,,679,598
3,1,14,1,0,0,289,676,309,3,-1,,679,598
4,1,14,1,1,0,289,676,309,3,-1,,679,598
5,1,14,1,1,1,289,676,309,3,95, ,679,598
2,1,15,0,0,0,757,678,640,1,-1,,679,1397
3,1,15,1,0,0,757,678,640,1,-1,,679,1397
4,1,15,1,1,0,757,678,640,1,-1,,679,1397
5,1,15,1,1,1,757,678,640,1,95, ,679,1397
2,1,16,0,0,0,55,142,2,562,-1,,704,57
3,1,16,1,0,0,55,142,2,562,-1,,704,57
4,1,16,1,1,0,55,142,2,562,-1,,704,57
5,1,16,1,1,1,55,142,2,562,95, ,704,57
2,1,17,0,0,0,58,744,1531,4,-1,,748,1589
3,1,17,1,0,0,58,744,1531,4,-1,,748,1589
4,1,17,1,1,0,58,744,1531,4,-1,,748,1589
5,1,17,1,1,1,58,744,1531,4,95, ,748,1589
2,1,18,0,0,0,992,746,597,3,-1,,749,1589
3,1,18,1,0,0,992,746,597,3,-1,,749,1589
4,1,18,1,1,0,992,746,597,3,-1,,749,1589
5,1,18,1,1,1,992,746,597,3,95, ,749,1589
2,1,19,0,0,0,53,475,1559,334,-1,,809,1612
3,1,19,1,0,0,57,475,1441,157,-1,,632,1498
4,1,19,1,1,0,57,475,788,40,-1,,515,845
5,1,19,1,1,1,57,475,241,29,12,“QARRIER-TRANSPORTEUR,504,298
5,1,19,1,1,2,844,512,1,3,57,|,515,845
4,1,19,1,2,0,137,516,1269,30,-1,,546,1406
5,1,19,1,2,1,137,516,48,18,95,GEO,534,185
5,1,19,1,2,2,202,517,17,17,94,A,534,219
5,1,19,1,2,3,236,517,65,17,94,HALL,534,301
5,1,19,1,2,4,570,516,111,19,84,0101535,535,681
5,1,19,1,2,5,698,512,15,44,29,|,556,713
5,1,19,1,2,6,726,521,147,25,0,VenicleNUMBER,546,873
5,1,19,1,2,7,916,532,70,14,25,LICENSE,546,986
5,1,19,1,2,8,992,533,70,13,25,NUMBER,546,1062
5,1,19,1,2,9,1081,526,6,1,77,|,527,1087
5,1,19,1,2,10,1125,533,78,13,0,ADDRESS,546,1203
5,1,19,1,2,11,1210,533,21,13,95,OF,546,1231
5,1,19,1,2,12,1237,533,56,13,95,METER,546,1293
5,1,19,1,2,13,1300,533,33,13,93,AND,546,1333
5,1,19,1,2,14,1339,533,67,13,96,TRADER,546,1406
4,1,19,1,3,0,139,546,1332,24,-1,,570,1471
5,1,19,1,3,1,139,546,61,18,93,8800,564,200
5,1,19,1,3,2,222,555,11,3,89,-,558,233
5,1,19,1,3,3,255,546,29,18,90,6E,564,284
5,1,19,1,3,4,302,547,148,19,89,CROISSANT,566,450
5,1,19,1,3,5,730,555,19,13,96,No,568,749
5,1,19,1,3,6,756,555,21,13,89,DU,568,777
5,1,19,1,3,7,784,555,82,13,89,VEHICULE,568,866
5,1,19,1,3,8,916,555,71,13,95,NOMBRE,568,987
5,1,19,1,3,9,994,555,21,14,92,DE,569,1015
5,1,19,1,3,10,1022,555,62,14,90,PEAMIS,569,1084
5,1,19,1,3,11,1090,548,9,31,89,|,579,1099
5,1,19,1,3,12,1111,555,90,14,74,L'ADRESSE,569,1201
5,1,19,1,3,13,1207,556,22,13,90,DE,569,1229
5,1,19,1,3,14,1234,556,57,14,90,METRE,570,1291
5,1,19,1,3,15,1298,556,19,14,96,ET,570,1317
5,1,19,1,3,16,1324,556,21,14,92,DE,570,1345
5,1,19,1,3,17,1351,556,120,14,42,COMMERCANT,570,1471
4,1,19,1,4,0,136,572,1362,36,-1,,608,1498
5,1,19,1,4,1,136,572,83,33,95,ANJOU,605,219
5,1,19,1,4,2,469,599,22,3,94,=,602,491
5,1,19,1,4,3,704,597,3,11,51,|,608,707
5,1,19,1,4,4,720,578,61,18,51,1137,596,781
5,1,19,1,4,5,1103,579,78,19,95,11675,598,1181
5,1,19,1,4,6,1203,585,46,13,95,rue,598,1249
5,1,19,1,4,7,1269,579,163,19,96,Sherbrooke,598,1432
5,1,19,1,4,8,1452,582,46,16,96,est,598,1498
4,1,19,1,5,0,136,602,1294,34,-1,,636,1430
5,1,19,1,5,1,136,608,49,18,80,Hid,626,185
5,1,19,1,5,2,204,608,45,18,63,1A1,626,249
5,1,19,1,5,3,480,606,43,25,27,RST,631,523
5,1,19,1,5,4,538,607,8,24,10,a,631,546
5,1,19,1,5,5,580,602,82,34,5,laren,636,662
5,1,19,1,5,6,720,609,61,18,95,1099,627,781
5,1,19,1,5,7,1101,609,142,21,96,"Montreal,",630,1243
5,1,19,1,5,8,1268,611,30,21,92,QC,632,1298
5,1,19,1,5,9,1318,610,48,18,86,H1B,628,1366
5,1,19,1,5,10,1386,610,44,18,25,1¢3,628,1430
3,1,19,2,0,0,55,635,1259,24,-1,,659,1314
4,1,19,2,1,0,55,635,1259,24,-1,,659,1314
5,1,19,2,1,1,55,635,1,5,92,|,640,56
5,1,19,2,1,2,144,636,67,21,70,(514),657,211
5,1,19,2,1,3,225,637,124,18,70,352-5550,655,349
5,1,19,2,1,4,1108,639,68,20,76,(613),659,1176
5,1,19,2,1,5,1189,639,125,18,79,996-6666,657,1314
3,1,19,3,0,0,55,664,1557,22,-1,,686,1612
4,1,19,3,1,0,55,664,1557,22,-1,,686,1612
5,1,19,3,1,1,55,664,51,13,63,—,677,106
5,1,19,3,1,2,245,676,32,2,5,—_,678,277
5,1,19,3,1,3,335,677,3,1,0,.,678,338
5,1,19,3,1,4,704,675,32,4,66,|,679,736
5,1,19,3,1,5,1273,678,18,8,27,—,686,1291
5,1,19,3,1,6,1354,678,75,3,19,——,681,1429
5,1,19,3,1,7,1546,679,66,1,21,_—___!,680,1612
3,1,19,4,0,0,68,687,1520,32,-1,,719,1588
4,1,19,4,1,0,1155,687,91,13,-1,,700,1246
5,1,19,4,1,1,1155,687,91,13,95,MEASURED,700,1246
4,1,19,4,2,0,68,685,1520,34,-1,,719,1588
5,1,19,4,2,1,68,685,143,34,92,PRODUCT/METER,719,211
5,1,19,4,2,2,565,718,4,1,30,7,719,569
5,1,19,4,2,3,1169,706,56,13,46,ay,719,1225
5,1,19,4,2,4,1298,698,104,13,92,CORRECTED,711,1402
5,1,19,4,2,5,1413,687,9,34,80,|,721,1422
5,1,19,4,2,6,1430,698,46,13,96,TEMP,711,1476
5,1,19,4,2,7,1489,687,12,34,96,|,721,1501
5,1,19,4,2,8,1518,698,70,13,96,DENSITY,711,1588
3,1,19,5,0,0,53,707,1535,102,-1,,809,1588
4,1,19,5,1,0,53,707,1535,41,-1,,748,1588
5,1,19,5,1,1,53,740,3,6,87,|,746,56
5,1,19,5,1,2,68,723,135,13,0,proourtavereR,736,203
5,1,19,5,1,3,360,710,81,13,96,PRODUCT,723,441
5,1,19,5,1,4,447,710,112,13,91,DESCRIPTION,723,559
5,1,19,5,1,5,562,700,9,33,93,-,733,571
5,1,19,5,1,6,576,710,111,13,94,DESCRIPTION,723,687
5,1,19,5,1,7,694,711,21,13,96,DU,724,715
5,1,19,5,1,8,722,711,75,13,96,PRODUIT,724,797
5,1,19,5,1,9,940,707,1,22,95,|,729,941
5,1,19,5,1,10,959,747,12,1,49,7,748,971
5,1,19,5,1,11,1155,725,46,14,0,Meat,739,1201
5,1,19,5,1,12,1217,725,29,14,0,ces,739,1246
5,1,19,5,1,13,1323,726,61,13,49,70150.,739,1384
5,1,19,5,1,14,1420,726,72,22,49,|cetsius|,748,1492
5,1,19,5,1,15,1518,726,70,13,25,ensite,739,1588
4,1,19,5,2,0,138,758,1442,21,-1,,779,1580
5,1,19,5,2,1,138,758,94,18,94,103265,776,232
5,1,19,5,2,2,246,753,15,33,94,|,786,261
5,1,19,5,2,3,268,759,49,18,95,NOT,777,317
5,1,19,5,2,4,335,759,148,18,96,REGULATED,777,483
5,1,19,5,2,5,500,760,83,17,96,UNDER,777,583
5,1,19,5,2,6,600,760,49,17,96,TDG,777,649
5,1,19,5,2,7,969,760,95,17,95,0.9651,777,1064
5,1,19,5,2,8,1169,760,78,18,95,44001,778,1247
5,1,19,5,2,9,1318,760,79,18,92,42465,778,1397
5,1,19,5,2,10,1419,760,61,18,81,|60.6,778,1480
5,1,19,5,2,11,1502,760,78,19,83,|910.6,779,1580
4,1,19,5,3,0,135,788,947,21,-1,,809,1082
5,1,19,5,3,1,135,788,97,17,91,MTR271,805,232
5,1,19,5,3,2,244,784,14,31,92,|,815,258
5,1,19,5,3,3,268,789,82,16,95,HEAVY,805,350
5,1,19,5,3,4,367,789,100,18,93,VACUUM,807,467
5,1,19,5,3,5,484,789,98,18,77,GASOIL,807,582
5,1,19,5,3,6,590,789,85,20,77,(HVGO),809,675
5,1,19,5,3,7,967,791,47,16,93,API,807,1014
5,1,19,5,3,8,1036,789,46,18,75,54B,807,1082
2,1,20,0,0,0,467,871,291,69,-1,,940,758
3,1,20,1,0,0,467,871,291,69,-1,,940,758
4,1,20,1,1,0,467,871,291,69,-1,,940,758
5,1,20,1,1,1,467,875,91,65,78,(42,940,558
5,1,20,1,1,2,618,871,140,57,81,(0.%,928,758
2,1,21,0,0,0,446,969,360,84,-1,,1053,806
3,1,21,1,0,0,446,969,360,84,-1,,1053,806
4,1,21,1,1,0,696,969,110,32,-1,,1001,806
5,1,21,1,1,1,696,969,110,32,43,a,1001,806
4,1,21,1,2,0,446,994,321,59,-1,,1053,767
5,1,21,1,2,1,446,994,108,59,70,oot,1053,554
5,1,21,1,2,2,592,1002,175,47,66,10.52,1049,767
2,1,22,0,0,0,413,1068,1083,178,-1,,1246,1496
3,1,22,1,0,0,413,1068,1083,178,-1,,1246,1496
4,1,22,1,1,0,413,1068,496,86,-1,,1154,909
5,1,22,1,1,1,413,1085,157,69,75,Back,1154,570
5,1,22,1,1,2,637,1092,17,54,79,f,1146,654
5,1,22,1,1,3,722,1083,47,49,17,tr,1132,769
5,1,22,1,1,4,794,1068,115,78,17,pol,1146,909
4,1,22,1,2,0,445,1189,1051,57,-1,,1246,1496
5,1,22,1,2,1,445,1204,42,42,43,g,1246,487
5,1,22,1,2,2,549,1189,96,57,53,och,1246,645
5,1,22,1,2,3,697,1198,153,44,25,BORK,1242,850
5,1,22,1,2,4,1495,1210,1,6,71,|,1216,1496
2,1,23,0,0,0,54,921,2,363,-1,,1284,56
3,1,23,1,0,0,54,921,2,363,-1,,1284,56
4,1,23,1,1,0,54,921,2,363,-1,,1284,56
5,1,23,1,1,1,54,921,2,363,95, ,1284,56
2,1,24,0,0,0,52,1489,1345,53,-1,,1542,1397
3,1,24,1,0,0,52,1489,1345,53,-1,,1542,1397
4,1,24,1,1,0,52,1489,628,24,-1,,1513,680
5,1,24,1,1,1,52,1503,1,10,90,|,1513,53
5,1,24,1,1,2,300,1489,80,19,96,Total,1508,380
5,1,24,1,1,3,400,1489,96,19,96,Litres,1508,496
5,1,24,1,1,4,516,1489,32,23,96,by,1512,548
5,1,24,1,1,5,567,1489,113,19,96,Product,1508,680
4,1,24,1,2,0,52,1517,1345,25,-1,,1542,1397
5,1,24,1,2,1,52,1517,1,11,94,|,1528,53
5,1,24,1,2,2,269,1519,93,19,96,103265,1538,362
5,1,24,1,2,3,466,1521,82,17,96,HEAVY,1538,548
5,1,24,1,2,4,565,1521,101,18,93,VACUUM,1539,666
5,1,24,1,2,5,683,1521,192,21,48,GASOIL(HVGO),1542,875
5,1,24,1,2,6,1168,1522,79,18,96,44001,1540,1247
5,1,24,1,2,7,1318,1522,79,18,95,42465,1540,1397
2,1,25,0,0,0,247,676,4,1012,-1,,1688,251
3,1,25,1,0,0,247,676,4,1012,-1,,1688,251
4,1,25,1,1,0,247,676,4,1012,-1,,1688,251
5,1,25,1,1,1,247,676,4,1012,95, ,1688,251
2,1,26,0,0,0,1119,678,4,1013,-1,,1691,1123
3,1,26,1,0,0,1119,678,4,1013,-1,,1691,1123
4,1,26,1,1,0,1119,678,4,1013,-1,,1691,1123
5,1,26,1,1,1,1119,678,4,1013,95, ,1691,1123
2,1,27,0,0,0,1412,706,2,985,-1,,1691,1414
3,1,27,1,0,0,1412,706,2,985,-1,,1691,1414
4,1,27,1,1,0,1412,706,2,985,-1,,1691,1414
5,1,27,1,1,1,1412,706,2,985,95, ,1691,1414
2,1,28,0,0,0,1273,717,2,974,-1,,1691,1275
3,1,28,1,0,0,1273,717,2,974,-1,,1691,1275
4,1,28,1,1,0,1273,717,2,974,-1,,1691,1275
5,1,28,1,1,1,1273,717,2,974,95, ,1691,1275
2,1,29,0,0,0,53,1698,982,61,-1,,1759,1035
3,1,29,1,0,0,53,1698,982,61,-1,,1759,1035
4,1,29,1,1,0,53,1698,876,20,-1,,1718,929
5,1,29,1,1,1,53,1698,1,18,95,|,1716,54
5,1,29,1,1,2,66,1699,58,16,47,(hereby,1715,124
5,1,29,1,1,3,130,1699,54,13,95,declare,1712,184
5,1,29,1,1,4,189,1699,27,13,91,that,1712,216
5,1,29,1,1,5,222,1699,22,13,96,the,1712,244
5,1,29,1,1,6,249,1701,61,11,96,contents,1712,310
5,1,29,1,1,7,316,1700,13,12,96,of,1712,329
5,1,29,1,1,8,334,1700,24,13,96,this,1713,358
5,1,29,1,1,9,365,1700,93,16,96,consignment,1716,458
5,1,29,1,1,10,464,1703,22,10,96,are,1713,486
5,1,29,1,1,11,492,1701,28,15,96,fully,1716,520
5,1,29,1,1,12,527,1701,25,13,96,and,1714,552
5,1,29,1,1,13,559,1701,75,16,92,accurately,1717,634
5,1,29,1,1,14,639,1701,71,13,96,described,1714,710
5,1,29,1,1,15,716,1701,44,13,94,above,1714,760
5,1,29,1,1,16,766,1701,16,17,94,by,1718,782
5,1,29,1,1,17,788,1701,22,13,96,the,1714,810
5,1,29,1,1,18,816,1705,47,13,95,proper,1718,863
5,1,29,1,1,19,869,1702,60,16,96,shipping,1718,929
4,1,29,1,2,0,66,1718,878,19,-1,,1737,944
5,1,29,1,2,1,66,1721,44,13,83,"name,",1734,110
5,1,29,1,2,2,116,1721,22,11,96,are,1732,138
5,1,29,1,2,3,145,1718,59,17,96,properly,1735,204
5,1,29,1,2,4,209,1718,67,14,82,classified,1732,276
5,1,29,1,2,5,282,1719,26,13,96,and,1732,308
5,1,29,1,2,6,314,1719,74,17,94,"packaged,",1736,388
5,1,29,1,2,7,396,1719,34,14,96,have,1733,430
5,1,29,1,2,8,436,1719,76,17,95,dangerous,1736,512
5,1,29,1,2,9,519,1719,43,17,96,goods,1736,562
5,1,29,1,2,10,569,1720,43,16,95,safety,1736,612
5,1,29,1,2,11,618,1720,44,13,96,marks,1733,662
5,1,29,1,2,12,668,1720,58,17,96,properly,1737,726
5,1,29,1,2,13,733,1720,47,14,91,affixed,1734,780
5,1,29,1,2,14,786,1723,14,11,96,or,1734,800
5,1,29,1,2,15,806,1721,69,16,95,displayed,1737,875
5,1,29,1,2,16,881,1724,17,10,96,on,1734,898
5,1,29,1,2,17,904,1721,40,15,96,"them,",1736,944
4,1,29,1,3,0,66,1738,969,21,-1,,1759,1035
5,1,29,1,3,1,66,1738,26,12,93,and,1750,92
5,1,29,1,3,2,98,1741,22,10,93,are,1751,120
5,1,29,1,3,3,126,1741,11,9,96,in,1750,137
5,1,29,1,3,4,144,1738,15,13,94,ali,1751,159
5,1,29,1,3,5,165,1740,61,14,94,respects,1754,226
5,1,29,1,3,6,232,1738,12,13,96,in,1751,244
5,1,29,1,3,7,250,1742,46,12,96,proper,1754,296
5,1,29,1,3,8,302,1739,65,13,38,condition,1752,367
5,1,29,1,3,9,373,1739,19,13,96,for,1752,392
5,1,29,1,3,10,397,1740,65,15,86,transport,1755,462
5,1,29,1,3,11,467,1740,71,15,93,according,1755,538
5,1,29,1,3,12,544,1741,12,11,96,to,1752,556
5,1,29,1,3,13,562,1740,22,12,96,the,1752,584
5,1,29,1,3,14,590,1740,106,16,95,Transportation,1756,696
5,1,29,1,3,15,702,1740,13,13,96,of,1753,715
5,1,29,1,3,16,722,1740,78,16,96,Dangerous,1756,800
5,1,29,1,3,17,807,1740,48,13,93,Goods,1753,855
5,1,29,1,3,18,862,1740,85,17,28,Regulations,1757,947
5,1,29,1,3,19,955,1730,7,33,28,|,1763,962
5,1,29,1,3,20,985,1748,50,11,8,Fagen,1759,1035
2,1,30,0,0,0,128,1687,636,2,-1,,1689,764
3,1,30,1,0,0,128,1687,636,2,-1,,1689,764
4,1,30,1,1,0,128,1687,636,2,-1,,1689,764
5,1,30,1,1,1,128,1687,636,2,95, ,1689,764
2,1,31,0,0,0,458,1687,306,3,-1,,1690,764
3,1,31,1,0,0,458,1687,306,3,-1,,1690,764
4,1,31,1,1,0,458,1687,306,3,-1,,1690,764
5,1,31,1,1,1,458,1687,306,3,95, ,1690,764
2,1,32,0,0,0,1495,678,4,1149,-1,,1827,1499
3,1,32,1,0,0,1495,678,4,1149,-1,,1827,1499
4,1,32,1,1,0,1495,678,4,1149,-1,,1827,1499
5,1,32,1,1,1,1495,678,4,1149,95, ,1827,1499
2,1,33,0,0,0,952,1689,4,139,-1,,1828,956
3,1,33,1,0,0,952,1689,4,139,-1,,1828,956
4,1,33,1,1,0,952,1689,4,139,-1,,1828,956
5,1,33,1,1,1,952,1689,4,139,95, ,1828,956
2,1,34,0,0,0,53,1822,413,5,-1,,1827,466
3,1,34,1,0,0,53,1822,413,5,-1,,1827,466
4,1,34,1,1,0,53,1822,413,5,-1,,1827,466
5,1,34,1,1,1,53,1822,413,5,95, ,1827,466
2,1,35,0,0,0,683,1827,917,2,-1,,1829,1600
3,1,35,1,0,0,683,1827,917,2,-1,,1829,1600
4,1,35,1,1,0,683,1827,917,2,-1,,1829,1600
5,1,35,1,1,1,683,1827,917,2,95, ,1829,1600
2,1,36,0,0,0,66,1744,1545,114,-1,,1858,1611
3,1,36,1,0,0,66,1744,1545,114,-1,,1858,1611
4,1,36,1,1,0,986,1744,625,29,-1,,1773,1611
5,1,36,1,1,1,986,1762,7,10,15,TIME,1772,993
5,1,36,1,1,2,1077,1752,2,11,86,T,1763,1079
5,1,36,1,1,3,1126,1748,46,25,89,START,1773,1172
5,1,36,1,1,4,1180,1744,58,29,66,LOADING,1773,1238
5,1,36,1,1,5,1320,1749,43,11,95,FINISH,1760,1363
5,1,36,1,1,6,1369,1749,60,11,74,LOADING,1760,1429
5,1,36,1,1,7,1501,1745,78,15,41,“TIMEOUT,1760,1579
4,1,36,1,2,0,134,1758,1440,35,-1,,1793,1574
5,1,36,1,2,1,134,1764,116,18,96,Yannick,1782,250
5,1,36,1,2,2,266,1766,64,17,96,Merc,1783,330
5,1,36,1,2,3,335,1764,11,19,82,i,1783,346
5,1,36,1,2,4,351,1770,30,13,96,er,1783,381
5,1,36,1,2,5,995,1762,50,11,70,RAIVEE,1773,1045
5,1,36,1,2,6,1077,1764,2,29,87,|,1793,1079
5,1,36,1,2,7,1097,1758,27,23,89,DEBI,1781,1124
5,1,36,1,2,8,1218,1758,52,23,0,iEMENT,1781,1270
5,1,36,1,2,9,1309,1763,20,11,96,FIN,1774,1329
5,1,36,1,2,10,1335,1763,18,11,91,DU,1774,1353
5,1,36,1,2,11,1358,1763,99,11,85,CHARGEMENT,1774,1457
5,1,36,1,2,12,1520,1764,54,10,81,DEPART,1774,1574
4,1,36,1,3,0,149,1794,1430,33,-1,,1827,1579
5,1,36,1,3,1,149,1804,55,16,96,Shipper,1820,204
5,1,36,1,3,2,210,1808,40,9,92,name,1817,250
5,1,36,1,3,3,256,1804,54,17,92,(please,1821,310
5,1,36,1,3,4,315,1805,36,16,96,print),1821,351
5,1,36,1,3,5,416,1800,11,1,46,~,1801,427
5,1,36,1,3,6,968,1797,77,18,96,02:13,1815,1045
5,1,36,1,3,7,1077,1794,2,33,90,|,1827,1079
5,1,36,1,3,8,1135,1798,78,18,95,02:18,1816,1213
5,1,36,1,3,9,1335,1798,77,18,95,02:42,1816,1412
5,1,36,1,3,10,1502,1798,77,18,95,02:42,1816,1579
4,1,36,1,4,0,66,1825,1497,21,-1,,1846,1563
5,1,36,1,4,1,66,1828,60,14,96,DRIVER,1842,126
5,1,36,1,4,2,133,1829,46,13,92,NAME,1842,179
5,1,36,1,4,3,185,1836,4,2,92,-,1838,189
5,1,36,1,4,4,196,1829,36,13,96,NOM,1842,232
5,1,36,1,4,5,239,1830,21,12,92,DU,1842,260
5,1,36,1,4,6,266,1825,118,18,3,CONOUCTEUR,1843,384
5,1,36,1,4,7,586,1830,60,14,96,DRIVER,1844,646
5,1,36,1,4,8,653,1831,70,13,96,NUMBER,1844,723
5,1,36,1,4,9,930,1839,3,2,7,:,1841,933
5,1,36,1,4,10,994,1827,15,1,49,Wy,1828,1009
5,1,36,1,4,11,1083,1827,99,16,22,ONDUGFEA,1843,1182
5,1,36,1,4,12,1274,1832,53,14,96,TOTAL,1846,1327
5,1,36,1,4,13,1333,1832,83,14,92,QUANTITY,1846,1416
5,1,36,1,4,14,1422,1840,4,2,92,-,1842,1426
5,1,36,1,4,15,1432,1833,61,13,92,QUANT.,1846,1493
5,1,36,1,4,16,1499,1833,64,13,92,TOTALE,1846,1563
4,1,36,1,5,0,572,1831,171,27,-1,,1858,743
5,1,36,1,5,1,572,1831,48,27,53,NOBU,1858,620
5,1,36,1,5,2,626,1831,117,27,0,CONDUGEUA,1858,743
2,1,37,0,0,0,47,1826,1579,336,-1,,2162,1626
3,1,37,1,0,0,47,1826,1579,336,-1,,2162,1626
4,1,37,1,1,0,47,1826,1579,336,-1,,2162,1626
5,1,37,1,1,1,47,1826,1579,336,95,   ,2162,1626
2,1,38,0,0,0,134,1858,1396,48,-1,,1906,1530
3,1,38,1,0,0,134,1858,1396,48,-1,,1906,1530
4,1,38,1,1,0,1318,1858,212,19,-1,,1877,1530
5,1,38,1,1,1,1318,1859,79,18,83,44001,1877,1397
5,1,38,1,1,2,1433,1858,97,19,92,Litres,1877,1530
4,1,38,1,2,0,134,1888,601,18,-1,,1906,735
5,1,38,1,2,1,134,1888,82,16,47,ANDRE,1904,216
5,1,38,1,2,2,226,1881,40,34,25,____,1915,266
5,1,38,1,2,3,267,1888,164,17,25,DRAINVILLE,1905,431
5,1,38,1,2,4,601,1888,134,18,86,00004028,1906,735
2,1,39,0,0,0,75,1913,1524,60,-1,,1973,1599
3,1,39,1,0,0,75,1913,1524,58,-1,,1971,1599
4,1,39,1,1,0,75,1913,1524,19,-1,,1932,1599
5,1,39,1,1,1,75,1917,67,12,89,PRODUCT,1929,142
5,1,39,1,1,2,155,1911,12,28,68,|,1939,167
5,1,39,1,1,3,168,1918,36,11,68,TANK,1929,204
5,1,39,1,1,4,209,1918,67,11,47,CAPACITY|,1929,276
5,1,39,1,1,5,284,1918,48,11,47,WATER,1929,332
5,1,39,1,1,6,338,1918,21,11,53,DIP,1929,359
5,1,39,1,1,7,367,1918,55,12,53,BEFORE,1930,422
5,1,39,1,1,8,428,1918,30,12,10,DIPS],1930,458
5,1,39,1,1,9,478,1918,110,12,0,BEFORE{NVENT,1930,588
5,1,39,1,1,10,598,1911,10,28,89,|,1939,608
5,1,39,1,1,11,613,1920,45,10,93,AFTER,1930,658
5,1,39,1,1,12,663,1919,31,11,22,ODIPS|,1930,694
5,1,39,1,1,13,705,1919,52,11,96,ENDING,1930,757
5,1,39,1,1,14,763,1920,49,11,96,INVENT,1931,812
5,1,39,1,1,15,858,1920,68,11,72,PRODUCT,1931,926
5,1,39,1,1,16,947,1913,2,2,36,|”,1915,949
5,1,39,1,1,17,1270,1920,55,12,60,BEFORE,1932,1325
5,1,39,1,1,18,1330,1921,51,11,60,INVENT,1932,1381
5,1,39,1,1,19,1397,1921,44,11,79,AFTER,1932,1441
5,1,39,1,1,20,1447,1921,30,11,72,CIPS),1932,1477
5,1,39,1,1,21,1492,1921,52,11,84,ENDING,1932,1544
5,1,39,1,1,22,1549,1921,50,11,4,‘NVENT,1932,1599
4,1,39,1,2,0,77,1928,1510,29,-1,,1957,1587
5,1,39,1,2,1,77,1934,61,11,36,PRODUIT,1945,138
5,1,39,1,2,2,154,1927,13,28,9,—§,1955,167
5,1,39,1,2,3,171,1934,95,12,76,CONTENANCE,1946,266
5,1,39,1,2,4,276,1927,10,28,94,|,1955,286
5,1,39,1,2,5,287,1935,67,11,94,MEASURE,1946,354
5,1,39,1,2,6,360,1927,10,28,96,|,1955,370
5,1,39,1,2,7,378,1936,45,10,43,AVANT,1946,423
5,1,39,1,2,8,428,1936,15,11,43,LE,1947,443
5,1,39,1,2,9,492,1928,85,28,5,INVENTAIRE.,1956,577
5,1,39,1,2,10,719,1929,81,28,87,INVENTAIRE,1957,800
5,1,39,1,2,11,861,1929,61,28,66,PRODUIT,1957,922
5,1,39,1,2,12,1163,1938,46,11,95,AVANT,1949,1209
5,1,39,1,2,13,1214,1938,15,11,95,LE,1949,1229
5,1,39,1,2,14,1284,1938,81,11,91,INVENTAIRE,1949,1365
5,1,39,1,2,15,1382,1930,13,28,90,|,1958,1395
5,1,39,1,2,16,1402,1938,67,11,50,APRESLE,1949,1469
5,1,39,1,2,17,1476,1930,7,28,38,|,1958,1483
5,1,39,1,2,18,1506,1938,81,11,0, INVENTAIRE,1949,1587
4,1,39,1,3,0,168,1945,1397,28,-1,,1973,1565
5,1,39,1,3,1,168,1952,18,10,90,OU,1962,186
5,1,39,1,3,2,192,1952,80,11,89,RESERVIOR,1963,272
5,1,39,1,3,3,375,1952,74,11,78,JAUGEAGE,1963,449
5,1,39,1,3,4,496,1945,75,28,92,JAUGEAGE,1973,571
5,1,39,1,3,5,612,1952,75,12,76,JAUGEAGE,1964,687
5,1,39,1,3,6,712,1968,3,2,49,|,1970,715
5,1,39,1,3,7,735,1953,54,17,0,APRES,1970,789
5,1,39,1,3,8,841,1969,14,2,11,L_,1971,855
5,1,39,1,3,9,1160,1954,75,12,91,JAUGEAGE,1966,1235
5,1,39,1,3,10,1288,1954,75,12,89,JAUGEAGE,1966,1363
5,1,39,1,3,11,1379,1947,15,28,41,|,1975,1394
5,1,39,1,3,12,1396,1954,75,12,88,JAUGEAGE,1966,1471
5,1,39,1,3,13,1518,1955,47,11,91,APRES,1966,1565
2,1,40,0,0,0,1619,145,5,1764,-1,,1909,1624
3,1,40,1,0,0,1619,145,5,1764,-1,,1909,1624
4,1,40,1,1,0,1619,145,5,1764,-1,,1909,1624
5,1,40,1,1,1,1619,145,5,1764,95, ,1909,1624
2,1,41,0,0,0,117,1967,555,2,-1,,1969,672
3,1,41,1,0,0,117,1967,555,2,-1,,1969,672
4,1,41,1,1,0,117,1967,555,2,-1,,1969,672
5,1,41,1,1,1,117,1967,555,2,95, ,1969,672
2,1,42,0,0,0,906,1969,320,2,-1,,1971,1226
3,1,42,1,0,0,906,1969,320,2,-1,,1971,1226
4,1,42,1,1,0,906,1969,320,2,-1,,1971,1226
5,1,42,1,1,1,906,1969,320,2,95, ,1971,1226
2,1,43,0,0,0,1364,1970,253,3,-1,,1973,1617
3,1,43,1,0,0,1364,1970,253,3,-1,,1973,1617
4,1,43,1,1,0,1364,1970,253,3,-1,,1973,1617
5,1,43,1,1,1,1364,1970,253,3,95, ,1973,1617
2,1,44,0,0,0,353,2030,149,1,-1,,2031,502
3,1,44,1,0,0,353,2030,149,1,-1,,2031,502
4,1,44,1,1,0,353,2030,149,1,-1,,2031,502
5,1,44,1,1,1,353,2030,149,1,95, ,2031,502
2,1,45,0,0,0,672,2031,942,2,-1,,2033,1614
3,1,45,1,0,0,672,2031,942,2,-1,,2033,1614
4,1,45,1,1,0,672,2031,942,2,-1,,2033,1614
5,1,45,1,1,1,672,2031,942,2,95, ,2033,1614
2,1,46,0,0,0,1162,2031,452,3,-1,,2034,1614
3,1,46,1,0,0,1162,2031,452,3,-1,,2034,1614
4,1,46,1,1,0,1162,2031,452,3,-1,,2034,1614
5,1,46,1,1,1,1162,2031,452,3,95, ,2034,1614
2,1,47,0,0,0,107,2089,905,5,-1,,2094,1012
3,1,47,1,0,0,107,2089,905,5,-1,,2094,1012
4,1,47,1,1,0,107,2089,905,5,-1,,2094,1012
5,1,47,1,1,1,107,2089,905,5,95, ,2094,1012
2,1,48,0,0,0,1255,2093,320,3,-1,,2096,1575
3,1,48,1,0,0,1255,2093,320,3,-1,,2096,1575
4,1,48,1,1,0,1255,2093,320,3,-1,,2096,1575
5,1,48,1,1,1,1255,2093,320,3,95, ,2096,1575
2,1,49,0,0,0,1478,1914,2,219,-1,,2133,1480
3,1,49,1,0,0,1478,1914,2,219,-1,,2133,1480
4,1,49,1,1,0,1478,1914,2,219,-1,,2133,1480
5,1,49,1,1,1,1478,1914,2,219,95, ,2133,1480
2,1,50,0,0,0,164,1912,2,237,-1,,2149,166
3,1,50,1,0,0,164,1912,2,237,-1,,2149,166
4,1,50,1,1,0,164,1912,2,237,-1,,2149,166
5,1,50,1,1,1,164,1912,2,237,95, ,2149,166
2,1,51,0,0,0,362,1911,3,239,-1,,2150,365
3,1,51,1,0,0,362,1911,3,239,-1,,2150,365
4,1,51,1,1,0,362,1911,3,239,-1,,2150,365
5,1,51,1,1,1,362,1911,3,239,95, ,2150,365
2,1,52,0,0,0,461,1912,4,238,-1,,2150,465
3,1,52,1,0,0,461,1912,4,238,-1,,2150,465
4,1,52,1,1,0,461,1912,4,238,-1,,2150,465
5,1,52,1,1,1,461,1912,4,238,95, ,2150,465
2,1,53,0,0,0,606,1912,1,239,-1,,2151,607
3,1,53,1,0,0,606,1912,1,239,-1,,2151,607
4,1,53,1,1,0,606,1912,1,239,-1,,2151,607
5,1,53,1,1,1,606,1912,1,239,95, ,2151,607
2,1,54,0,0,0,1256,1920,1,232,-1,,2152,1257
3,1,54,1,0,0,1256,1920,1,232,-1,,2152,1257
4,1,54,1,1,0,1256,1920,1,232,-1,,2152,1257
5,1,54,1,1,1,1256,1920,1,232,95, ,2152,1257
2,1,55,0,0,0,1389,1933,1,220,-1,,2153,1390
3,1,55,1,0,0,1389,1933,1,220,-1,,2153,1390
4,1,55,1,1,0,1389,1933,1,220,-1,,2153,1390
5,1,55,1,1,1,1389,1933,1,220,95,,2153,1390
1,1,0,0,0,0,0,0,1700,2200,-1,,2200,1700
2,1,1,0,0,0,908,92,611,23,-1,,115,1519
3,1,1,1,0,0,908,92,611,23,-1,,115,1519
4,1,1,1,1,0,908,92,611,23,-1,,115,1519
5,1,1,1,1,1,908,92,115,21,96,VEHICLE,113,1023
5,1,1,1,1,2,1035,92,121,22,95,LOADING,114,1156
5,1,1,1,1,3,1168,93,113,21,93,REPORT,114,1281
5,1,1,1,1,4,1280,88,13,37,92,-,125,1293
5,1,1,1,1,5,1308,93,55,21,96,BILL,114,1363
5,1,1,1,1,6,1372,93,37,21,93,OF,114,1409
5,1,1,1,1,7,1419,94,100,21,92,LADING,115,1519
2,1,2,0,0,0,187,139,1061,10,-1,,149,1248
3,1,2,1,0,0,187,139,1061,10,-1,,149,1248
4,1,2,1,1,0,187,139,1061,10,-1,,149,1248
5,1,2,1,1,1,187,139,1061,10,95, ,149,1248
2,1,3,0,0,0,475,143,1,98,-1,,241,476
3,1,3,1,0,0,475,143,1,98,-1,,241,476
4,1,3,1,1,0,475,143,1,98,-1,,241,476
5,1,3,1,1,1,475,143,1,98,95, ,241,476
2,1,4,0,0,0,63,235,630,7,-1,,242,693
3,1,4,1,0,0,63,235,630,7,-1,,242,693
4,1,4,1,1,0,63,235,630,7,-1,,242,693
5,1,4,1,1,1,63,235,630,7,95, ,242,693
2,1,5,0,0,0,331,411,416,5,-1,,416,747
3,1,5,1,0,0,331,411,416,5,-1,,416,747
4,1,5,1,1,0,331,411,416,5,-1,,416,747
5,1,5,1,1,1,331,411,416,5,95, ,416,747
2,1,6,0,0,0,847,281,5,170,-1,,451,852
3,1,6,1,0,0,847,281,5,170,-1,,451,852
4,1,6,1,1,0,847,281,5,170,-1,,451,852
5,1,6,1,1,1,847,281,5,170,95, ,451,852
2,1,7,0,0,0,74,477,776,8,-1,,485,850
3,1,7,1,0,0,74,477,776,8,-1,,485,850
4,1,7,1,1,0,74,477,776,8,-1,,485,850
5,1,7,1,1,1,74,477,776,8,95, ,485,850
2,1,8,0,0,0,716,522,799,9,-1,,531,1515
3,1,8,1,0,0,716,522,799,9,-1,,531,1515
4,1,8,1,1,0,716,522,799,9,-1,,531,1515
5,1,8,1,1,1,716,522,799,9,95, ,531,1515
2,1,9,0,0,0,58,142,5,450,-1,,592,63
3,1,9,1,0,0,58,142,5,450,-1,,592,63
4,1,9,1,1,0,58,142,5,450,-1,,592,63
5,1,9,1,1,1,58,142,5,450,95, ,592,63
2,1,10,0,0,0,1096,526,3,152,-1,,678,1099
3,1,10,1,0,0,1096,526,3,152,-1,,678,1099
4,1,10,1,1,0,1096,526,3,152,-1,,678,1099
5,1,10,1,1,1,1096,526,3,152,95, ,678,1099
2,1,11,0,0,0,64,667,1557,15,-1,,682,1621
3,1,11,1,0,0,64,667,1557,15,-1,,682,1621
4,1,11,1,1,0,64,667,1557,15,-1,,682,1621
5,1,11,1,1,1,64,667,1557,15,95, ,682,1621
2,1,12,0,0,0,68,737,1468,13,-1,,750,1536
3,1,12,1,0,0,68,737,1468,13,-1,,750,1536
4,1,12,1,1,0,68,737,1468,13,-1,,750,1536
5,1,12,1,1,1,68,737,1468,13,95, ,750,1536
2,1,13,0,0,0,715,741,821,10,-1,,751,1536
3,1,13,1,0,0,715,741,821,10,-1,,751,1536
4,1,13,1,1,0,715,741,821,10,-1,,751,1536
5,1,13,1,1,1,715,741,821,10,95, ,751,1536
2,1,14,0,0,0,1272,718,10,906,-1,,1624,1282
3,1,14,1,0,0,1272,718,10,906,-1,,1624,1282
4,1,14,1,1,0,1272,718,10,906,-1,,1624,1282
5,1,14,1,1,1,1272,718,10,906,95, ,1624,1282
2,1,15,0,0,0,1410,678,11,1010,-1,,1688,1421
3,1,15,1,0,0,1410,678,11,1010,-1,,1688,1421
4,1,15,1,1,0,1410,678,11,1010,-1,,1688,1421
5,1,15,1,1,1,1410,678,11,1010,95, ,1688,1421
2,1,16,0,0,0,937,676,11,1013,-1,,1689,948
3,1,16,1,0,0,937,676,11,1013,-1,,1689,948
4,1,16,1,1,0,937,676,11,1013,-1,,1689,948
5,1,16,1,1,1,937,676,11,1013,95, ,1689,948
2,1,17,0,0,0,246,672,10,1015,-1,,1687,256
3,1,17,1,0,0,246,672,10,1015,-1,,1687,256
4,1,17,1,1,0,246,672,10,1015,-1,,1687,256
5,1,17,1,1,1,246,672,10,1015,95, ,1687,256
2,1,18,0,0,0,1118,683,11,1008,-1,,1691,1129
3,1,18,1,0,0,1118,683,11,1008,-1,,1691,1129
4,1,18,1,1,0,1118,683,11,1008,-1,,1691,1129
5,1,18,1,1,1,1118,683,11,1008,95, ,1691,1129
2,1,19,0,0,0,1386,1689,236,5,-1,,1694,1622
3,1,19,1,0,0,1386,1689,236,5,-1,,1694,1622
4,1,19,1,1,0,1386,1689,236,5,-1,,1694,1622
5,1,19,1,1,1,1386,1689,236,5,95, ,1694,1622
2,1,20,0,0,0,53,1682,1161,10,-1,,1692,1214
3,1,20,1,0,0,53,1682,1161,10,-1,,1692,1214
4,1,20,1,1,0,53,1682,1161,10,-1,,1692,1214
5,1,20,1,1,1,53,1682,1161,10,95, ,1692,1214
2,1,21,0,0,0,953,1742,669,7,-1,,1749,1622
3,1,21,1,0,0,953,1742,669,7,-1,,1749,1622
4,1,21,1,1,0,953,1742,669,7,-1,,1749,1622
5,1,21,1,1,1,953,1742,669,7,95, ,1749,1622
2,1,22,0,0,0,1493,678,12,1149,-1,,1827,1505
3,1,22,1,0,0,1493,678,12,1149,-1,,1827,1505
4,1,22,1,1,0,1493,678,12,1149,-1,,1827,1505
5,1,22,1,1,1,1493,678,12,1149,95, ,1827,1505
2,1,23,0,0,0,952,1698,3,130,-1,,1828,955
3,1,23,1,0,0,952,1698,3,130,-1,,1828,955
4,1,23,1,1,0,952,1698,3,130,-1,,1828,955
5,1,23,1,1,1,952,1698,3,130,95, ,1828,955
2,1,24,0,0,0,1286,1745,4,85,-1,,1830,1290
3,1,24,1,0,0,1286,1745,4,85,-1,,1830,1290
4,1,24,1,1,0,1286,1745,4,85,-1,,1830,1290
5,1,24,1,1,1,1286,1745,4,85,95, ,1830,1290
2,1,25,0,0,0,884,1824,684,8,-1,,1832,1568
3,1,25,1,0,0,884,1824,684,8,-1,,1832,1568
4,1,25,1,1,0,884,1824,684,8,-1,,1832,1568
5,1,25,1,1,1,884,1824,684,8,95, ,1832,1568
2,1,26,0,0,0,78,1821,637,7,-1,,1828,715
3,1,26,1,0,0,78,1821,637,7,-1,,1828,715
4,1,26,1,1,0,78,1821,637,7,-1,,1828,715
5,1,26,1,1,1,78,1821,637,7,95, ,1828,715
2,1,27,0,0,0,47,1826,1580,336,-1,,2162,1627
3,1,27,1,0,0,47,1826,1580,336,-1,,2162,1627
4,1,27,1,1,0,47,1826,1580,336,-1,,2162,1627
5,1,27,1,1,1,47,1826,1580,336,95,   ,2162,1627
2,1,28,0,0,0,53,120,1572,1790,-1,,1910,1625
3,1,28,1,0,0,53,120,1572,1790,-1,,1910,1625
4,1,28,1,1,0,144,120,1480,28,-1,,148,1624
5,1,28,1,1,1,144,122,75,21,95,Page:,143,219
5,1,28,1,1,2,244,120,11,18,95,1,138,255
5,1,28,1,1,3,476,122,45,18,96,530,140,521
5,1,28,1,1,4,812,120,131,21,96,RAPPORT,141,943
5,1,28,1,1,5,954,120,34,21,93,DE,141,988
5,1,28,1,1,6,998,120,197,22,90,CHARGEMENT,142,1195
5,1,28,1,1,7,1204,132,7,3,91,-,135,1211
5,1,28,1,1,8,1221,120,136,28,88,VEHICULE,148,1357
5,1,28,1,1,9,1369,132,15,16,88,-,148,1384
5,1,28,1,1,10,1384,121,240,27,65,CONNAISSEMENT,148,1624
4,1,28,1,2,0,132,147,537,25,-1,,172,669
5,1,28,1,2,1,132,148,111,16,93,DOCUMENT,164,243
5,1,28,1,2,2,250,150,81,14,92,NUMBER,164,331
5,1,28,1,2,3,360,150,61,18,92,6980,168,421
5,1,28,1,2,4,532,147,35,24,93,DATE,171,567
5,1,28,1,2,5,576,143,93,39,81,DEXPEDITION,182,669
4,1,28,1,3,0,132,167,174,16,-1,,183,306
5,1,28,1,3,1,132,167,23,16,95,No,183,155
5,1,28,1,3,2,162,168,25,15,95,DU,183,187
5,1,28,1,3,3,196,168,110,15,95,DOCUMENT,183,306
4,1,28,1,4,0,519,177,1088,37,-1,,214,1607
5,1,28,1,4,1,519,177,138,37,81,mm/dd/yy,214,657
5,1,28,1,4,2,796,184,29,21,96,24,205,825
5,1,28,1,4,3,836,184,78,22,95,HOUR,206,914
5,1,28,1,4,4,924,184,118,22,90,NUMBER,206,1042
5,1,28,1,4,5,1064,184,206,21,88,(613)996-6666,205,1270
5,1,28,1,4,6,1308,186,137,22,89,-NUMERO,208,1445
5,1,28,1,4,7,1455,187,29,20,89,24,207,1484
5,1,28,1,4,8,1495,186,112,22,93,HEURES,208,1607
4,1,28,1,5,0,144,209,1225,29,-1,,238,1369
5,1,28,1,5,1,144,209,111,19,96,0362704,228,255
5,1,28,1,5,2,276,210,94,20,96,10/007,230,370
5,1,28,1,5,3,525,212,128,20,95,10/08/24,232,653
5,1,28,1,5,4,1046,216,143,27,93,COLLECT,243,1189
5,1,28,1,5,5,1175,206,14,42,93,-,248,1189
5,1,28,1,5,6,1194,210,109,34,90,FRAIS,244,1303
5,1,28,1,5,7,1290,217,79,21,92,VIRES,238,1369
4,1,28,1,6,0,73,238,1548,31,-1,,269,1621
5,1,28,1,6,1,73,241,198,14,72,CONSIGNEE/CUSTOMER,255,271
5,1,28,1,6,2,276,250,5,2,86,-,252,281
5,1,28,1,6,3,287,238,183,18,86,DESTINATAIRE/CLIENT,256,470
5,1,28,1,6,4,598,240,9,1,34,7,241,607
5,1,28,1,6,5,684,240,31,26,13,oD,266,715
5,1,28,1,6,6,717,240,134,27,0,etAsSeenienT,267,851
5,1,28,1,6,7,846,236,9,35,87,|,271,855
5,1,28,1,6,8,853,242,118,17,91,CONSIGNOR,259,971
5,1,28,1,6,9,962,236,10,35,91,-,271,972
5,1,28,1,6,10,977,246,105,13,92,EXPEDITEUR,259,1082
5,1,28,1,6,11,1446,243,175,26,36,eae,269,1621
4,1,28,1,7,0,143,272,1468,33,-1,,305,1611
5,1,28,1,7,1,143,272,80,18,93,PETRO,290,223
5,1,28,1,7,2,241,272,100,18,96,CANADA,290,341
5,1,28,1,7,3,357,274,164,17,96,LUBRICANTS,291,521
5,1,28,1,7,4,542,274,45,18,96,INC,292,587
5,1,28,1,7,5,675,274,162,18,93,0005064508,292,837
5,1,28,1,7,6,858,276,97,17,91,SUNCOR,293,955
5,1,28,1,7,7,974,276,97,18,96,ENERGY,294,1071
5,1,28,1,7,8,1088,276,133,18,96,MONTREAL,294,1221
5,1,28,1,7,9,1445,281,3,24,69,|,305,1448
5,1,28,1,7,10,1474,276,115,29,63,0082041,305,1589
5,1,28,1,7,11,1600,304,11,1,0,_,305,1611
4,1,28,1,8,0,143,301,1110,23,-1,,324,1253
5,1,28,1,8,1,143,302,62,17,88,PCLI,319,205
5,1,28,1,8,2,226,310,12,3,88,-,313,238
5,1,28,1,8,3,258,302,97,21,95,QUEBEC,323,355
5,1,28,1,8,4,375,302,44,18,96,302,320,419
5,1,28,1,8,5,672,301,163,22,88,0009406423,323,835
5,1,28,1,8,6,858,304,77,19,88,11675,323,935
5,1,28,1,8,7,956,310,48,13,96,rue,323,1004
5,1,28,1,8,8,1024,305,164,19,96,Sherbrooke,324,1188
5,1,28,1,8,9,1208,308,45,16,96,est,324,1253
4,1,28,1,9,0,143,332,1343,26,-1,,358,1486
5,1,28,1,9,1,143,332,44,18,96,385,350,187
5,1,28,1,9,2,210,333,146,18,96,SOUTHDOWN,351,356
5,1,28,1,9,3,374,334,64,17,95,ROAD,351,438
5,1,28,1,9,4,855,336,143,20,95,"Montreal,",356,998
5,1,28,1,9,5,1023,337,30,21,91,QC,358,1053
5,1,28,1,9,6,1072,336,49,18,82,H1B,354,1121
5,1,28,1,9,7,1141,336,44,19,24,1C3,355,1185
5,1,28,1,9,8,1280,337,68,21,67,(613),358,1348
5,1,28,1,9,9,1361,337,125,18,67,996-6666,355,1486
4,1,28,1,10,0,140,363,710,20,-1,,383,850
5,1,28,1,10,1,140,363,193,20,95,"MISSISSAUGA,",383,333
5,1,28,1,10,2,357,364,32,17,92,ON,381,389
5,1,28,1,10,3,406,364,49,17,85,L5J,381,455
5,1,28,1,10,4,474,364,45,17,43,2¥3,381,519
5,1,28,1,10,5,848,377,2,3,93,|,380,850
4,1,28,1,11,0,769,394,335,22,-1,,416,1104
5,1,28,1,11,1,769,394,202,22,41,__|Yannick,416,971
5,1,28,1,11,2,988,395,116,20,96,Mercier,415,1104
4,1,28,1,12,0,267,411,574,34,-1,,445,841
5,1,28,1,12,1,267,411,2,34,81,[,445,269
5,1,28,1,12,2,274,416,62,11,92,RELEASE,427,336
5,1,28,1,12,3,342,416,47,13,58,(C-ol-A),429,389
5,1,28,1,12,4,394,416,59,11,48,NUMBER,427,453
5,1,28,1,12,5,564,417,79,11,57,CUSTOMER,428,643
5,1,28,1,12,6,648,418,75,11,43,PURCHASE,429,723
5,1,28,1,12,7,728,418,49,11,96,ORDER,429,777
5,1,28,1,12,8,782,418,59,11,95,NUMBER,429,841
4,1,28,1,13,0,614,432,191,11,-1,,443,805
5,1,28,1,13,1,614,432,17,10,77,No,442,631
5,1,28,1,13,2,636,432,17,10,95,DE,442,653
5,1,28,1,13,3,659,432,68,11,0,DEMANDE,443,727
5,1,28,1,13,4,732,432,19,11,92,DU,443,751
5,1,28,1,13,5,756,432,49,11,92,CLIENT,443,805
4,1,28,1,14,0,59,479,791,25,-1,,504,850
5,1,28,1,14,1,59,479,2,2,92,|,481,61
5,1,28,1,14,2,72,480,225,24,55,CARRIER-TRANSPORTEUR,504,297
5,1,28,1,14,3,402,481,28,2,0,_,483,430
5,1,28,1,14,4,629,482,11,1,0,-,483,640
5,1,28,1,14,5,708,483,4,11,80,],494,712
5,1,28,1,14,6,848,490,2,14,72,|,504,850
4,1,28,1,15,0,141,514,1395,34,-1,,548,1536
5,1,28,1,15,1,141,514,48,18,94,GEO,532,189
5,1,28,1,15,2,206,515,17,17,95,A,532,223
5,1,28,1,15,3,240,515,65,17,96,HALL,532,305
5,1,28,1,15,4,574,516,111,18,93,0101535,534,685
5,1,28,1,15,5,709,523,4,14,32,|,537,713
5,1,28,1,15,6,730,525,70,20,0,Venicte,545,800
5,1,28,1,15,7,813,525,64,21,92,NUMBER,546,877
5,1,28,1,15,8,919,526,70,20,48,LICENSE,546,989
5,1,28,1,15,9,995,533,70,13,95,NUMBER,546,1065
5,1,28,1,15,10,1128,526,79,21,95,ADDRESS,547,1207
5,1,28,1,15,11,1213,527,22,20,96,OF,547,1235
5,1,28,1,15,12,1241,534,56,13,93,METER,547,1297
5,1,28,1,15,13,1304,534,33,13,88,ANO,547,1337
5,1,28,1,15,14,1343,534,68,14,93,TRADER,548,1411
5,1,28,1,15,15,1525,527,11,1,0,-,528,1536
4,1,28,1,16,0,142,544,1333,26,-1,,570,1475
5,1,28,1,16,1,142,544,61,18,92,8800,562,203
5,1,28,1,16,2,226,553,11,2,92,-,555,237
5,1,28,1,16,3,258,544,29,18,91,6E,562,287
5,1,28,1,16,4,306,546,148,18,89,CROISSANT,564,454
5,1,28,1,16,5,733,554,20,12,96,No,566,753
5,1,28,1,16,6,759,554,22,13,70,DU,567,781
5,1,28,1,16,7,788,554,81,14,92,VEHICULE,568,869
5,1,28,1,16,8,919,555,72,13,88,NOMBRE,568,991
5,1,28,1,16,9,998,555,21,13,93,DE,568,1019
5,1,28,1,16,10,1025,555,62,13,43,PERMIS,568,1087
5,1,28,1,16,11,1093,547,12,32,89,|,579,1105
5,1,28,1,16,12,1114,556,91,13,37,L'‘ADRESSE,569,1205
5,1,28,1,16,13,1211,556,22,13,96,DE,569,1233
5,1,28,1,16,14,1238,556,57,13,96,METRE,569,1295
5,1,28,1,16,15,1302,556,20,13,96,ET,569,1322
5,1,28,1,16,16,1328,557,21,12,92,DE,569,1349
5,1,28,1,16,17,1355,556,120,14,92,COMMERCANT,570,1475
4,1,28,1,17,0,136,570,1366,31,-1,,601,1502
5,1,28,1,17,1,136,570,87,31,96,ANJOU,601,223
5,1,28,1,17,2,622,598,85,2,2,|},600,707
5,1,28,1,17,3,723,577,46,19,77,118,596,769
5,1,28,1,17,4,1106,579,79,18,96,11675,597,1185
5,1,28,1,17,5,1206,584,47,13,95,rue,597,1253
5,1,28,1,17,6,1274,579,163,19,96,Sherbrooke,598,1437
5,1,28,1,17,7,1456,582,46,16,96,est,598,1502
4,1,28,1,18,0,140,604,1294,27,-1,,631,1434
5,1,28,1,18,1,140,605,49,18,68,H1g,623,189
5,1,28,1,18,2,208,605,45,17,85,1A1,622,253
5,1,28,1,18,3,483,604,63,25,27,CASE,629,546
5,1,28,1,18,4,555,604,110,26,0,faeeontele,630,665
5,1,28,1,18,5,679,600,14,40,34,=,640,693
5,1,28,1,18,6,705,600,15,40,53,|,640,720
5,1,28,1,18,7,740,607,45,19,93,1068,626,785
5,1,28,1,18,8,1104,609,143,21,95,"Montreal,",630,1247
5,1,28,1,18,9,1272,611,31,20,90,QC,631,1303
5,1,28,1,18,10,1322,610,48,18,89,H1B,628,1370
5,1,28,1,18,11,1390,610,44,18,1,13,628,1434
4,1,28,1,19,0,146,622,1172,52,-1,,674,1318
5,1,28,1,19,1,146,634,69,20,0,(544),654,215
5,1,28,1,19,2,226,634,127,18,0,352-5550,652,353
5,1,28,1,19,3,472,622,1,52,93,|,674,473
5,1,28,1,19,4,1111,638,68,21,91,(613),659,1179
5,1,28,1,19,5,1197,638,121,19,94,996-6666,657,1318
4,1,28,1,20,0,58,670,1453,29,-1,,699,1511
5,1,28,1,20,1,58,670,2,5,94,|,675,60
5,1,28,1,20,2,330,673,11,1,0,-,674,341
5,1,28,1,20,3,576,674,15,1,0,-,675,591
5,1,28,1,20,4,651,675,8,1,0,-,676,659
5,1,28,1,20,5,906,676,26,1,0,i,677,932
5,1,28,1,20,6,1158,686,93,13,91,MEASURED,699,1251
5,1,28,1,20,7,1277,686,1,11,55,|,697,1278
5,1,28,1,20,8,1501,678,10,2,0,T,680,1511
4,1,28,1,21,0,72,692,1521,20,-1,,712,1593
5,1,28,1,21,1,72,692,142,13,76,PROOUCT/METER,705,214
5,1,28,1,21,2,1302,697,105,14,88,CORRECTED,711,1407
5,1,28,1,21,3,1416,688,9,33,88,|,721,1425
5,1,28,1,21,4,1434,698,47,13,95,TEMP,711,1481
5,1,28,1,21,5,1493,688,12,33,96,|,721,1505
5,1,28,1,21,6,1522,698,71,14,96,DENSITY,712,1593
4,1,28,1,22,0,568,705,661,14,-1,,719,1229
5,1,28,1,22,1,568,715,5,2,15,7,717,573
5,1,28,1,22,2,1172,705,57,14,95,LITRES,719,1229
4,1,28,1,23,0,57,707,1565,42,-1,,749,1622
5,1,28,1,23,1,57,740,10,2,55,|,742,67
5,1,28,1,23,2,72,719,135,14,21,PRODUITIMETER,733,207
5,1,28,1,23,3,364,707,198,14,0,siatehidaianniiatibiel,721,562
5,1,28,1,23,4,579,708,112,37,90,DESCRIPTION,745,691
5,1,28,1,23,5,698,709,102,13,0,abinebell,722,800
5,1,28,1,23,6,943,740,2,2,96,|,742,945
5,1,28,1,23,7,1158,725,100,23,90,MESUREES,748,1258
5,1,28,1,23,8,1285,747,3,1,71,|,748,1288
5,1,28,1,23,9,1327,725,62,14,11,TO1SC,739,1389
5,1,28,1,23,10,1424,726,70,13,3,|CELSIUS|,739,1494
5,1,28,1,23,11,1522,726,78,23,86,DENSITE,749,1600
5,1,28,1,23,12,1610,748,12,1,86,|,749,1622
4,1,28,1,24,0,57,747,1527,32,-1,,779,1584
5,1,28,1,24,1,57,747,2,32,88,|,779,59
5,1,28,1,24,2,142,754,93,19,94,103265,773,235
5,1,28,1,24,3,248,750,18,34,94,|,784,266
5,1,28,1,24,4,272,756,48,18,96,NOT,774,320
5,1,28,1,24,5,338,757,148,18,96,REGULATED,775,486
5,1,28,1,24,6,504,758,82,17,96,UNDER,775,586
5,1,28,1,24,7,604,758,49,17,96,TDG,775,653
5,1,28,1,24,8,943,750,1,10,63,|,760,944
5,1,28,1,24,9,972,759,95,19,87,0.9644,778,1067
5,1,28,1,24,10,1172,759,79,19,96,44001,778,1251
5,1,28,1,24,11,1322,760,79,19,92,42435,779,1401
5,1,28,1,24,12,1423,760,62,19,85,|61.4,779,1485
5,1,28,1,24,13,1506,761,78,18,70,910.6,779,1584
4,1,28,1,25,0,57,784,1444,27,-1,,811,1501
5,1,28,1,25,1,57,784,2,19,96,|,803,59
5,1,28,1,25,2,138,785,98,19,91,MTR271,804,236
5,1,28,1,25,3,246,781,15,33,91,|,814,261
5,1,28,1,25,4,272,788,81,17,95,HEAVY,805,353
5,1,28,1,25,5,370,788,101,17,93,VACUUM,805,471
5,1,28,1,25,6,488,788,111,21,80,GASOIL,809,599
5,1,28,1,25,7,594,788,85,21,53,(HVGO),809,679
5,1,28,1,25,8,943,792,1,14,93,|,806,944
5,1,28,1,25,9,970,791,47,17,92,API,808,1017
5,1,28,1,25,10,1039,790,46,18,90,54B,808,1085
5,1,28,1,25,11,1499,803,2,8,80,|,811,1501
4,1,28,1,26,0,415,829,1210,154,-1,,983,1625
5,1,28,1,26,1,415,859,40,124,38,.,983,455
5,1,28,1,26,2,462,829,80,106,11,act,935,542
5,1,28,1,26,3,568,833,43,87,11,=z,920,611
5,1,28,1,26,4,1623,877,2,12,96,|,889,1625
4,1,28,1,27,0,57,865,598,76,-1,,941,655
5,1,28,1,27,1,57,916,2,12,53,1,928,59
5,1,28,1,27,2,250,912,2,7,91,|,919,252
5,1,28,1,27,3,611,865,44,76,55,J,941,655
4,1,28,1,28,0,302,1487,379,25,-1,,1512,681
5,1,28,1,28,1,302,1487,79,19,95,Total,1506,381
5,1,28,1,28,2,402,1487,96,21,96,Litres,1508,498
5,1,28,1,28,3,518,1489,32,23,96,by,1512,550
5,1,28,1,28,4,569,1489,112,19,96,Product,1508,681
4,1,28,1,29,0,270,1519,1127,24,-1,,1543,1397
5,1,28,1,29,1,270,1519,94,19,96,103265,1538,364
5,1,28,1,29,2,468,1521,82,17,96,HEAVY,1538,550
5,1,28,1,29,3,567,1521,100,19,93,VACUUM,1540,667
5,1,28,1,29,4,684,1522,94,18,51,GASOIL,1540,778
5,1,28,1,29,5,791,1517,85,33,51,(HVGO),1550,876
5,1,28,1,29,6,1170,1523,79,19,95,44001,1542,1249
5,1,28,1,29,7,1320,1523,77,19,96,42435,1542,1397
4,1,28,1,30,0,67,1681,1210,39,-1,,1720,1277
5,1,28,1,30,1,67,1697,2,13,62,|,1710,69
5,1,28,1,30,2,76,1697,49,17,79,hereby,1714,125
5,1,28,1,30,3,131,1697,53,13,88,declare,1710,184
5,1,28,1,30,4,190,1681,26,37,96,that,1718,216
5,1,28,1,30,5,222,1697,22,14,96,the,1711,244
5,1,28,1,30,6,246,1681,65,38,94,contents,1719,311
5,1,28,1,30,7,317,1699,12,13,84,of,1712,329
5,1,28,1,30,8,335,1685,25,27,84,this,1712,360
5,1,28,1,30,9,362,1682,96,38,67,consignment,1720,458
5,1,28,1,30,10,465,1703,22,9,96,are,1712,487
5,1,28,1,30,11,493,1699,29,17,83,fully,1716,522
5,1,28,1,30,12,527,1699,26,13,96,and,1712,553
5,1,28,1,30,13,560,1699,74,17,33,accurately,1716,634
5,1,28,1,30,14,640,1700,70,14,65,described,1714,710
5,1,28,1,30,15,717,1701,44,13,96,above,1714,761
5,1,28,1,30,16,767,1701,17,16,96,by,1717,784
5,1,28,1,30,17,789,1701,22,13,96,the,1714,811
5,1,28,1,30,18,817,1704,48,13,96,proper,1717,865
5,1,28,1,30,19,870,1701,61,17,96,shipping,1718,931
5,1,28,1,30,20,952,1688,48,5,0,T,1693,1000
5,1,28,1,30,21,1086,1689,21,2,0,-,1691,1107
5,1,28,1,30,22,1159,1689,4,2,0,;,1691,1163
5,1,28,1,30,23,1237,1687,40,4,19,_,1691,1277
4,1,28,1,31,0,67,1717,878,20,-1,,1737,945
5,1,28,1,31,1,67,1719,43,11,94,"name,",1730,110
5,1,28,1,31,2,117,1720,23,10,96,are,1730,140
5,1,28,1,31,3,146,1717,58,17,96,properly,1734,204
5,1,28,1,31,4,210,1717,67,14,88,classified,1731,277
5,1,28,1,31,5,283,1718,26,13,96,and,1731,309
5,1,28,1,31,6,315,1718,75,17,86,"packaged,",1735,390
5,1,28,1,31,7,397,1718,34,14,93,have,1732,431
5,1,28,1,31,8,437,1719,77,17,89,dangeraus,1736,514
5,1,28,1,31,9,520,1719,44,17,66,goods,1736,564
5,1,28,1,31,10,570,1719,43,17,93,safely,1736,613
5,1,28,1,31,11,619,1719,43,14,93,marks,1733,662
5,1,28,1,31,12,669,1720,59,17,93,properly,1737,728
5,1,28,1,31,13,734,1719,47,15,94,affixed,1734,781
5,1,28,1,31,14,787,1723,14,11,93,or,1734,801
5,1,28,1,31,15,807,1720,69,17,81,disptayed,1737,876
5,1,28,1,31,16,882,1723,17,11,96,on,1734,899
5,1,28,1,31,17,905,1721,40,13,78,"them,",1734,945
4,1,28,1,32,0,66,1737,1514,24,-1,,1761,1580
5,1,28,1,32,1,66,1737,26,12,95,and,1749,92
5,1,28,1,32,2,99,1740,23,10,94,are,1750,122
5,1,28,1,32,3,127,1736,11,13,92,in,1749,138
5,1,28,1,32,4,145,1737,15,13,88,all,1750,160
5,1,28,1,32,5,166,1738,70,15,84,respects,1753,236
5,1,28,1,32,6,233,1741,11,9,87,in,1750,244
5,1,28,1,32,7,251,1740,47,14,96,proper,1754,298
5,1,28,1,32,8,303,1738,65,13,96,condition,1751,368
5,1,28,1,32,9,374,1738,18,13,93,for,1751,392
5,1,28,1,32,10,398,1739,64,15,65,trarsport,1754,462
5,1,28,1,32,11,468,1739,70,16,94,according,1755,538
5,1,28,1,32,12,545,1740,12,12,96,to,1752,557
5,1,28,1,32,13,563,1739,22,13,92,the,1752,585
5,1,28,1,32,14,590,1739,106,17,91,Transportalion,1756,696
5,1,28,1,32,15,703,1740,13,12,96,af,1752,716
5,1,28,1,32,16,722,1740,80,16,72,Dangerous,1756,802
5,1,28,1,32,17,808,1740,48,13,57,Goods,1753,856
5,1,28,1,32,18,862,1740,86,17,56,Regulations,1757,948
5,1,28,1,32,19,957,1729,6,34,56,|,1763,963
5,1,28,1,32,20,986,1748,50,11,16,tye,1759,1036
5,1,28,1,32,21,1128,1749,45,11,79,START,1760,1173
5,1,28,1,32,22,1178,1749,61,11,91,LOADING,1760,1239
5,1,28,1,32,23,1321,1750,44,11,0,FINGH,1761,1365
5,1,28,1,32,24,1370,1750,61,11,0,LOADING,1761,1431
5,1,28,1,32,25,1472,1746,3,1,42,|,1747,1475
5,1,28,1,32,26,1514,1750,33,11,11,TME,1761,1547
5,1,28,1,32,27,1551,1750,29,11,75,GUT,1761,1580
4,1,28,1,33,0,135,1756,1440,29,-1,,1785,1575
5,1,28,1,33,1,135,1756,115,29,96,Yannick,1785,250
5,1,28,1,33,2,267,1763,115,19,94,Mercier,1782,382
5,1,28,1,33,3,986,1762,61,11,90,ARRIVEE,1773,1047
5,1,28,1,33,4,1098,1763,46,10,59,DEBUT,1773,1144
5,1,28,1,33,5,1149,1763,18,10,91,OU,1773,1167
5,1,28,1,33,6,1172,1763,99,11,91,CHARGEMENT,1774,1271
5,1,28,1,33,7,1310,1764,20,10,95,FIN,1774,1330
5,1,28,1,33,8,1336,1764,18,10,91,DU,1774,1354
5,1,28,1,33,9,1360,1764,97,10,91,CHARGEMENT,1774,1457
5,1,28,1,33,10,1520,1760,55,22,96,DEPART,1782,1575
4,1,28,1,34,0,53,1793,1526,33,-1,,1826,1579
5,1,28,1,34,1,53,1797,24,16,50,\~,1813,77
5,1,28,1,34,2,150,1802,56,17,96,Shipper,1819,206
5,1,28,1,34,3,214,1806,34,10,96,name,1816,248
5,1,28,1,34,4,257,1793,49,33,70,(please,1826,306
5,1,28,1,34,5,313,1793,53,33,0,prin),1826,366
5,1,28,1,34,6,471,1800,41,1,0,—,1801,512
5,1,28,1,34,7,969,1796,78,19,96,05:54,1815,1047
5,1,28,1,34,8,1136,1797,77,19,96,05:59,1816,1213
5,1,28,1,34,9,1336,1798,77,18,94,06:23,1816,1413
5,1,28,1,34,10,1502,1798,77,19,95,06:23,1817,1579
4,1,28,1,35,0,53,1821,1511,26,-1,,1847,1564
5,1,28,1,35,1,53,1821,2,16,82,|,1837,55
5,1,28,1,35,2,79,1827,49,14,82,DRIVER,1841,128
5,1,28,1,35,3,134,1828,56,13,90,NAME,1841,190
5,1,28,1,35,4,185,1817,9,34,90,-,1851,194
5,1,28,1,35,5,197,1828,37,13,96,NOM,1841,234
5,1,28,1,35,6,241,1828,21,14,93,DU,1842,262
5,1,28,1,35,7,268,1828,116,14,88,CONDUGTEUR,1842,384
5,1,28,1,35,8,484,1824,57,2,26,a,1826,541
5,1,28,1,35,9,578,1825,7,1,6,a,1826,585
5,1,28,1,35,10,762,1826,17,18,82,DR,1844,779
5,1,28,1,35,11,952,1831,85,14,91,IGNATURE,1845,1037
5,1,28,1,35,12,1044,1832,145,15,48,DUCBNOUCTEUR,1847,1189
5,1,28,1,35,13,1276,1832,53,14,96,TOTAL,1846,1329
5,1,28,1,35,14,1334,1832,83,14,93,QUANTITY,1846,1417
5,1,28,1,35,15,1423,1840,4,2,92,-,1842,1427
5,1,28,1,35,16,1433,1833,61,14,91,QUANT.,1847,1494
5,1,28,1,35,17,1500,1833,64,14,91,TOTALE,1847,1564
4,1,28,1,36,0,853,1858,678,25,-1,,1883,1531
5,1,28,1,36,1,853,1880,3,3,9,.,1883,856
5,1,28,1,36,2,1318,1860,79,18,87,44001,1878,1397
5,1,28,1,36,3,1434,1858,97,21,91,Litres,1879,1531
4,1,28,1,37,0,135,1886,1276,24,-1,,1910,1411
5,1,28,1,37,1,135,1886,132,19,96,GHISLAIN,1905,267
5,1,28,1,37,2,318,1888,114,18,89,LAPRISE,1906,432
5,1,28,1,37,3,1285,1891,79,18,40,38641,1909,1364
5,1,28,1,37,4,1369,1887,3,32,40,_,1919,1372
5,1,28,1,37,5,1384,1891,27,19,93,kg,1910,1411
2,1,29,0,0,0,1616,147,16,1765,-1,,1912,1632
3,1,29,1,0,0,1616,147,16,1765,-1,,1912,1632
4,1,29,1,1,0,1616,147,16,1765,-1,,1912,1632
5,1,29,1,1,1,1616,147,16,1765,95, ,1912,1632
2,1,30,0,0,0,51,995,9,907,-1,,1902,60
3,1,30,1,0,0,51,995,9,907,-1,,1902,60
4,1,30,1,1,0,51,995,9,907,-1,,1902,60
5,1,30,1,1,1,51,995,9,907,95, ,1902,60
2,1,31,0,0,0,75,1918,1524,68,-1,,1986,1599
3,1,31,1,0,0,75,1918,1524,17,-1,,1935,1599
4,1,31,1,1,0,75,1918,1524,17,-1,,1935,1599
5,1,31,1,1,1,75,1918,67,11,88,PRODUCT,1929,142
5,1,31,1,1,2,151,1914,16,23,54,=|,1937,167
5,1,31,1,1,3,168,1918,36,11,54,TANK,1929,204
5,1,31,1,1,4,209,1918,68,12,40,GAPACITY|,1930,277
5,1,31,1,1,5,284,1919,49,11,92,WATER,1930,333
5,1,31,1,1,6,339,1919,21,11,78,DIP|,1930,360
5,1,31,1,1,7,613,1920,45,11,91,AFTER,1931,658
5,1,31,1,1,8,664,1920,30,12,24,DIPS),1932,694
5,1,31,1,1,9,706,1920,52,12,96,ENDING,1932,758
5,1,31,1,1,10,763,1921,50,11,88,INVENT,1932,813
5,1,31,1,1,11,858,1921,69,12,96,PRODUCT,1933,927
5,1,31,1,1,12,1154,1922,55,12,91,BEFORE,1934,1209
5,1,31,1,1,13,1214,1922,31,12,91,DIPS,1934,1245
5,1,31,1,1,14,1254,1918,8,24,96,|,1942,1262
5,1,31,1,1,15,1270,1922,56,12,96,BEFORE,1934,1326
5,1,31,1,1,16,1332,1923,49,11,96,INVENT,1934,1381
5,1,31,1,1,17,1386,1918,8,24,96,|,1942,1394
5,1,31,1,1,18,1398,1924,44,10,96,AFTER,1934,1442
5,1,31,1,1,19,1448,1924,30,10,72,DIPS,1934,1478
5,1,31,1,1,20,1492,1924,53,10,94,ENDING,1934,1545
5,1,31,1,1,21,1550,1924,49,11,95,INVENT,1935,1599
3,1,31,2,0,0,78,1930,1509,27,-1,,1957,1587
4,1,31,2,1,0,78,1930,1509,27,-1,,1957,1587
5,1,31,2,1,1,78,1930,60,24,94,PRODUIT,1954,138
5,1,31,2,1,2,171,1935,96,12,91,CONTENANCE,1947,267
5,1,31,2,1,3,275,1931,10,24,93,|,1955,285
5,1,31,2,1,4,287,1936,67,11,88,MEASURE,1947,354
5,1,31,2,1,5,361,1931,6,24,88,|,1955,367
5,1,31,2,1,6,378,1936,46,11,15,AVANT,1947,424
5,1,31,2,1,7,429,1936,15,11,15,LE,1947,444
5,1,31,2,1,8,492,1937,82,11,80,INVENTAIRE,1948,574
5,1,31,2,1,9,594,1939,2,2,2,~,1941,596
5,1,31,2,1,10,604,1933,9,23,92,|,1956,613
5,1,31,2,1,11,619,1937,46,11,91,APRES,1948,665
5,1,31,2,1,12,670,1938,16,10,95,LE,1948,686
5,1,31,2,1,13,719,1934,82,23,23,INVENTAIRE,1957,801
5,1,31,2,1,14,862,1938,61,11,90,PRODUIT,1949,923
5,1,31,2,1,15,1164,1939,46,11,96,AVANT,1950,1210
5,1,31,2,1,16,1215,1940,16,10,57,LE,1950,1231
5,1,31,2,1,17,1284,1940,82,11,16,INVENTAIRE,1951,1366
5,1,31,2,1,18,1403,1940,46,11,92,APRES,1951,1449
5,1,31,2,1,19,1454,1940,16,11,95,LE,1951,1470
5,1,31,2,1,20,1506,1940,81,12,92,INVENTAIRE,1952,1587
3,1,31,3,0,0,169,1950,1396,36,-1,,1986,1565
4,1,31,3,1,0,169,1950,1396,24,-1,,1974,1565
5,1,31,3,1,1,169,1952,17,11,79,DU,1963,186
5,1,31,3,1,2,192,1952,80,11,58,RESERVIOR:,1963,272
5,1,31,3,1,3,375,1952,74,12,66,JAUGEAGE,1964,449
5,1,31,3,1,4,496,1954,75,11,89,JAUGEAGE,1965,571
5,1,31,3,1,5,613,1954,75,11,88,JAUGEAGE,1965,688
5,1,31,3,1,6,736,1950,50,24,17,APRES:,1974,786
5,1,31,3,1,7,1161,1956,75,11,89,JAUGEAGE,1967,1236
5,1,31,3,1,8,1289,1956,75,12,87,JAUGEAGE,1968,1364
5,1,31,3,1,9,1390,1957,1,12,66,|,1969,1391
5,1,31,3,1,10,1397,1956,75,12,89,JAUGEAGE,1968,1472
5,1,31,3,1,11,1520,1957,45,11,90,APRES,1968,1565
4,1,31,3,2,0,534,1968,858,18,-1,,1986,1392
5,1,31,3,2,1,534,1969,43,1,61,AGE,1970,577
5,1,31,3,2,2,605,1968,9,9,63,|,1977,614
5,1,31,3,2,3,632,1969,6,2,41,AU,1971,638
5,1,31,3,2,4,1250,1972,3,1,0,;,1973,1253
5,1,31,3,2,5,1389,1973,3,13,82,1,1986,1392
2,1,32,0,0,0,586,1965,1025,11,-1,,1976,1611
3,1,32,1,0,0,586,1965,1025,11,-1,,1976,1611
4,1,32,1,1,0,586,1965,1025,11,-1,,1976,1611
5,1,32,1,1,1,586,1965,1025,11,95, ,1976,1611
2,1,33,0,0,0,64,1961,1547,17,-1,,1978,1611
3,1,33,1,0,0,64,1961,1547,17,-1,,1978,1611
4,1,33,1,1,0,64,1961,1547,17,-1,,1978,1611
5,1,33,1,1,1,64,1961,1547,17,95, ,1978,1611
2,1,34,0,0,0,651,2027,967,10,-1,,2037,1618
3,1,34,1,0,0,651,2027,967,10,-1,,2037,1618
4,1,34,1,1,0,651,2027,967,10,-1,,2037,1618
5,1,34,1,1,1,651,2027,967,10,95, ,2037,1618
2,1,35,0,0,0,74,2026,431,6,-1,,2032,505
3,1,35,1,0,0,74,2026,431,6,-1,,2032,505
4,1,35,1,1,0,74,2026,431,6,-1,,2032,505
5,1,35,1,1,1,74,2026,431,6,95, ,2032,505
2,1,36,0,0,0,1129,2091,313,6,-1,,2097,1442
3,1,36,1,0,0,1129,2091,313,6,-1,,2097,1442
4,1,36,1,1,0,1129,2091,313,6,-1,,2097,1442
5,1,36,1,1,1,1129,2091,313,6,95, ,2097,1442
2,1,37,0,0,0,106,2086,837,10,-1,,2096,943
3,1,37,1,0,0,106,2086,837,10,-1,,2096,943
4,1,37,1,1,0,106,2086,837,10,-1,,2096,943
5,1,37,1,1,1,106,2086,837,10,95, ,2096,943
2,1,38,0,0,0,163,1911,3,202,-1,,2113,166
3,1,38,1,0,0,163,1911,3,202,-1,,2113,166
4,1,38,1,1,0,163,1911,3,202,-1,,2113,166
5,1,38,1,1,1,163,1911,3,202,95, ,2113,166
2,1,39,0,0,0,1143,1916,5,236,-1,,2152,1148
3,1,39,1,0,0,1143,1916,5,236,-1,,2152,1148
4,1,39,1,1,0,1143,1916,5,236,-1,,2152,1148
5,1,39,1,1,1,1143,1916,5,236,95, ,2152,1148
2,1,40,0,0,0,361,1912,5,237,-1,,2149,366
3,1,40,1,0,0,361,1912,5,237,-1,,2149,366
4,1,40,1,1,0,361,1912,5,237,-1,,2149,366
5,1,40,1,1,1,361,1912,5,237,95, ,2149,366
2,1,41,0,0,0,693,1916,6,234,-1,,2150,699
3,1,41,1,0,0,693,1916,6,234,-1,,2150,699
4,1,41,1,1,0,693,1916,6,234,-1,,2150,699
5,1,41,1,1,1,693,1916,6,234,95,,2150,699
1,1,0,0,0,0,0,0,1700,2200,-1,,2200,1700
2,1,1,0,0,0,907,88,611,22,-1,,110,1518
3,1,1,1,0,0,907,88,611,22,-1,,110,1518
4,1,1,1,1,0,907,88,611,22,-1,,110,1518
5,1,1,1,1,1,907,89,116,21,96,VEHICLE,110,1023
5,1,1,1,1,2,1034,89,121,21,96,LOADING,110,1155
5,1,1,1,1,3,1168,89,113,21,93,REPORT,110,1281
5,1,1,1,1,4,1290,101,7,2,92,-,103,1297
5,1,1,1,1,5,1308,89,55,21,94,BILL,110,1363
5,1,1,1,1,6,1372,89,37,21,93,OF,110,1409
5,1,1,1,1,7,1419,88,99,22,90,LADING,110,1518
2,1,2,0,0,0,64,136,1397,15,-1,,151,1461
3,1,2,1,0,0,64,136,1397,15,-1,,151,1461
4,1,2,1,1,0,64,136,1397,15,-1,,151,1461
5,1,2,1,1,1,64,136,1397,15,95, ,151,1461
2,1,3,0,0,0,1061,239,567,7,-1,,246,1628
3,1,3,1,0,0,1061,239,567,7,-1,,246,1628
4,1,3,1,1,0,1061,239,567,7,-1,,246,1628
5,1,3,1,1,1,1061,239,567,7,95, ,246,1628
2,1,4,0,0,0,59,236,613,7,-1,,243,672
3,1,4,1,0,0,59,236,613,7,-1,,243,672
4,1,4,1,1,0,59,236,613,7,-1,,243,672
5,1,4,1,1,1,59,236,613,7,95, ,243,672
2,1,5,0,0,0,341,238,331,4,-1,,242,672
3,1,5,1,0,0,341,238,331,4,-1,,242,672
4,1,5,1,1,0,341,238,331,4,-1,,242,672
5,1,5,1,1,1,341,238,331,4,95, ,242,672
2,1,6,0,0,0,667,241,2,44,-1,,285,669
3,1,6,1,0,0,667,241,2,44,-1,,285,669
4,1,6,1,1,0,667,241,2,44,-1,,285,669
5,1,6,1,1,1,667,241,2,44,95, ,285,669
2,1,7,0,0,0,848,240,3,58,-1,,298,851
3,1,7,1,0,0,848,240,3,58,-1,,298,851
4,1,7,1,1,0,848,240,3,58,-1,,298,851
5,1,7,1,1,1,848,240,3,58,95, ,298,851
2,1,8,0,0,0,267,409,580,5,-1,,414,847
3,1,8,1,0,0,267,409,580,5,-1,,414,847
4,1,8,1,1,0,267,409,580,5,-1,,414,847
5,1,8,1,1,1,267,409,580,5,95, ,414,847
2,1,9,0,0,0,163,479,83,2,-1,,481,246
3,1,9,1,0,0,163,479,83,2,-1,,481,246
4,1,9,1,1,0,163,479,83,2,-1,,481,246
5,1,9,1,1,1,163,479,83,2,95, ,481,246
2,1,10,0,0,0,401,479,449,5,-1,,484,850
3,1,10,1,0,0,401,479,449,5,-1,,484,850
4,1,10,1,1,0,401,479,449,5,-1,,484,850
5,1,10,1,1,1,401,479,449,5,95, ,484,850
2,1,11,0,0,0,709,520,699,8,-1,,528,1408
3,1,11,1,0,0,709,520,699,8,-1,,528,1408
4,1,11,1,1,0,709,520,699,8,-1,,528,1408
5,1,11,1,1,1,709,520,699,8,95, ,528,1408
2,1,12,0,0,0,57,164,6,481,-1,,645,63
3,1,12,1,0,0,57,164,6,481,-1,,645,63
4,1,12,1,1,0,57,164,6,481,-1,,645,63
5,1,12,1,1,1,57,164,6,481,95, ,645,63
2,1,13,0,0,0,708,481,4,195,-1,,676,712
3,1,13,1,0,0,708,481,4,195,-1,,676,712
4,1,13,1,1,0,708,481,4,195,-1,,676,712
5,1,13,1,1,1,708,481,4,195,95, ,676,712
2,1,14,0,0,0,1397,677,230,3,-1,,680,1627
3,1,14,1,0,0,1397,677,230,3,-1,,680,1627
4,1,14,1,1,0,1397,677,230,3,-1,,680,1627
5,1,14,1,1,1,1397,677,230,3,95, ,680,1627
2,1,15,0,0,0,959,673,668,9,-1,,682,1627
3,1,15,1,0,0,959,673,668,9,-1,,682,1627
4,1,15,1,1,0,959,673,668,9,-1,,682,1627
5,1,15,1,1,1,959,673,668,9,95, ,682,1627
2,1,16,0,0,0,58,671,722,7,-1,,678,780
3,1,16,1,0,0,58,671,722,7,-1,,678,780
4,1,16,1,1,0,58,671,722,7,-1,,678,780
5,1,16,1,1,1,58,671,722,7,95, ,678,780
2,1,17,0,0,0,57,739,1569,11,-1,,750,1626
3,1,17,1,0,0,57,739,1569,11,-1,,750,1626
4,1,17,1,1,0,57,739,1569,11,-1,,750,1626
5,1,17,1,1,1,57,739,1569,11,95, ,750,1626
2,1,18,0,0,0,534,741,1092,10,-1,,751,1626
3,1,18,1,0,0,534,741,1092,10,-1,,751,1626
4,1,18,1,1,0,534,741,1092,10,-1,,751,1626
5,1,18,1,1,1,534,741,1092,10,95, ,751,1626
2,1,19,0,0,0,1277,676,3,334,-1,,1010,1280
3,1,19,1,0,0,1277,676,3,334,-1,,1010,1280
4,1,19,1,1,0,1277,676,3,334,-1,,1010,1280
5,1,19,1,1,1,1277,676,3,334,95, ,1010,1280
2,1,20,0,0,0,941,686,5,692,-1,,1378,946
3,1,20,1,0,0,941,686,5,692,-1,,1378,946
4,1,20,1,1,0,941,686,5,692,-1,,1378,946
5,1,20,1,1,1,941,686,5,692,95, ,1378,946
2,1,21,0,0,0,1274,676,8,862,-1,,1538,1282
3,1,21,1,0,0,1274,676,8,862,-1,,1538,1282
4,1,21,1,1,0,1274,676,8,862,-1,,1538,1282
5,1,21,1,1,1,1274,676,8,862,95, ,1538,1282
2,1,22,0,0,0,247,674,8,1002,-1,,1676,255
3,1,22,1,0,0,247,674,8,1002,-1,,1676,255
4,1,22,1,1,0,247,674,8,1002,-1,,1676,255
5,1,22,1,1,1,247,674,8,1002,95, ,1676,255
2,1,23,0,0,0,1412,677,9,1014,-1,,1691,1421
3,1,23,1,0,0,1412,677,9,1014,-1,,1691,1421
4,1,23,1,1,0,1412,677,9,1014,-1,,1691,1421
5,1,23,1,1,1,1412,677,9,1014,95, ,1691,1421
2,1,24,0,0,0,1120,676,8,1014,-1,,1690,1128
3,1,24,1,0,0,1120,676,8,1014,-1,,1690,1128
4,1,24,1,1,0,1120,676,8,1014,-1,,1690,1128
5,1,24,1,1,1,1120,676,8,1014,95, ,1690,1128
2,1,25,0,0,0,57,1683,338,4,-1,,1687,395
3,1,25,1,0,0,57,1683,338,4,-1,,1687,395
4,1,25,1,1,0,57,1683,338,4,-1,,1687,395
5,1,25,1,1,1,57,1683,338,4,95, ,1687,395
2,1,26,0,0,0,551,1686,562,4,-1,,1690,1113
3,1,26,1,0,0,551,1686,562,4,-1,,1690,1113
4,1,26,1,1,0,551,1686,562,4,-1,,1690,1113
5,1,26,1,1,1,551,1686,562,4,95, ,1690,1113
2,1,27,0,0,0,954,1742,549,6,-1,,1748,1503
3,1,27,1,0,0,954,1742,549,6,-1,,1748,1503
4,1,27,1,1,0,954,1742,549,6,-1,,1748,1503
5,1,27,1,1,1,954,1742,549,6,95, ,1748,1503
2,1,28,0,0,0,1495,678,9,1152,-1,,1830,1504
3,1,28,1,0,0,1495,678,9,1152,-1,,1830,1504
4,1,28,1,1,0,1495,678,9,1152,-1,,1830,1504
5,1,28,1,1,1,1495,678,9,1152,95, ,1830,1504
2,1,29,0,0,0,954,1688,2,140,-1,,1828,956
3,1,29,1,0,0,954,1688,2,140,-1,,1828,956
4,1,29,1,1,0,954,1688,2,140,-1,,1828,956
5,1,29,1,1,1,954,1688,2,140,95, ,1828,956
2,1,30,0,0,0,1079,1744,2,84,-1,,1828,1081
3,1,30,1,0,0,1079,1744,2,84,-1,,1828,1081
4,1,30,1,1,0,1079,1744,2,84,-1,,1828,1081
5,1,30,1,1,1,1079,1744,2,84,95, ,1828,1081
2,1,31,0,0,0,927,1824,696,8,-1,,1832,1623
3,1,31,1,0,0,927,1824,696,8,-1,,1832,1623
4,1,31,1,1,0,927,1824,696,8,-1,,1832,1623
5,1,31,1,1,1,927,1824,696,8,95, ,1832,1623
2,1,32,0,0,0,54,1821,399,5,-1,,1826,453
3,1,32,1,0,0,54,1821,399,5,-1,,1826,453
4,1,32,1,1,0,54,1821,399,5,-1,,1826,453
5,1,32,1,1,1,54,1821,399,5,95, ,1826,453
2,1,33,0,0,0,1617,142,16,1751,-1,,1893,1633
3,1,33,1,0,0,1617,142,16,1751,-1,,1893,1633
4,1,33,1,1,0,1617,142,16,1751,-1,,1893,1633
5,1,33,1,1,1,1617,142,16,1751,95, ,1893,1633
2,1,34,0,0,0,930,1861,699,67,-1,,1928,1629
3,1,34,1,0,0,930,1861,699,67,-1,,1928,1629
4,1,34,1,1,0,930,1861,699,27,-1,,1888,1629
5,1,34,1,1,1,930,1861,390,27,95, ,1888,1320
5,1,34,1,1,2,1532,1861,97,27,95, ,1888,1629
4,1,34,1,2,0,930,1888,699,40,-1,,1928,1629
5,1,34,1,2,1,930,1888,699,40,95, ,1928,1629
2,1,35,0,0,0,55,116,1572,1798,-1,,1914,1627
3,1,35,1,0,0,55,116,1572,1792,-1,,1908,1627
4,1,35,1,1,0,143,116,1481,28,-1,,144,1624
5,1,35,1,1,1,143,123,74,21,95,Page:,144,217
5,1,35,1,1,2,242,120,12,19,94,1,139,254
5,1,35,1,1,3,475,121,44,19,96,530,140,519
5,1,35,1,1,4,810,117,132,22,95,RAPPORT,139,942
5,1,35,1,1,5,952,117,35,21,91,DE,138,987
5,1,35,1,1,6,998,117,196,22,82,CHARGEMENT,139,1194
5,1,35,1,1,7,1204,129,6,3,92,-,132,1210
5,1,35,1,1,8,1220,117,137,22,90,VEHICULE,139,1357
5,1,35,1,1,9,1368,129,6,2,91,-,131,1374
5,1,35,1,1,10,1384,116,240,28,57,CONNAISSEMENT,144,1624
4,1,35,1,2,0,132,143,621,40,-1,,183,753
5,1,35,1,2,1,132,151,109,15,95,DOCUMENT,166,241
5,1,35,1,2,2,248,151,81,15,77,NUMBER,166,329
5,1,35,1,2,3,359,151,61,19,77,6934,170,420
5,1,35,1,2,4,532,147,36,25,63,ORE,172,568
5,1,35,1,2,5,574,143,93,40,0,DEXSEDITION,183,667
4,1,35,1,3,0,162,170,143,15,-1,,185,305
5,1,35,1,3,1,162,170,11,15,81,DU,185,173
5,1,35,1,3,2,252,170,53,15,94,DOCUMENT,185,305
4,1,35,1,4,0,131,169,1475,37,-1,,206,1606
5,1,35,1,4,1,131,169,23,16,68,No,185,154
5,1,35,1,4,2,176,169,73,17,12,DUDOCY,186,249
5,1,35,1,4,3,474,185,1,10,50,|,195,475
5,1,35,1,4,4,522,182,133,22,54,mm/ad/yy,204,655
5,1,35,1,4,5,751,174,2,23,78,|,197,753
5,1,35,1,4,6,796,185,28,20,78,24,205,824
5,1,35,1,4,7,836,184,77,22,87,HOUR,206,913
5,1,35,1,4,8,924,184,117,22,69,NUMBER,206,1041
5,1,35,1,4,9,1062,182,207,22,50,_(613)996-6666,204,1269
5,1,35,1,4,10,1287,169,27,48,13,_-,217,1314
5,1,35,1,4,11,1324,184,121,22,96,NUMERO,206,1445
5,1,35,1,4,12,1455,184,29,22,96,24,206,1484
5,1,35,1,4,13,1494,184,112,22,95,HEURES,206,1606
4,1,35,1,5,0,144,206,1483,34,-1,,240,1627
5,1,35,1,5,1,144,212,109,17,96,0362682,229,253
5,1,35,1,5,2,276,212,93,19,96,10/007,231,369
5,1,35,1,5,3,474,206,1,34,39,|,240,475
5,1,35,1,5,4,524,212,129,19,39,10/08/24,231,653
5,1,35,1,5,5,1046,214,232,22,93,COLLECT,236,1278
5,1,35,1,5,6,1175,208,14,42,93,-,250,1189
5,1,35,1,5,7,1203,214,74,22,92,FRAIS,236,1277
5,1,35,1,5,8,1288,214,81,22,91,VIRES,236,1369
5,1,35,1,5,9,1626,235,1,4,59,|,239,1627
4,1,35,1,6,0,72,240,1538,26,-1,,266,1610
5,1,35,1,6,1,72,243,197,14,65,CONSIGNEE/CUSTOMER,257,269
5,1,35,1,6,2,276,251,4,2,88,-,253,280
5,1,35,1,6,3,286,243,183,14,92,DESTINATAIRE/CLIENT,257,469
5,1,35,1,6,4,684,234,68,36,26,LOCATION,270,752
5,1,35,1,6,5,761,234,72,36,0,WuuETEyr,270,833
5,1,35,1,6,6,842,241,1,1,49,|,242,843
5,1,35,1,6,7,858,244,101,13,53,CONSIGNOA,257,959
5,1,35,1,6,8,966,252,4,1,90,-,253,970
5,1,35,1,6,9,976,245,105,12,88,EXPEDITEUR,257,1081
5,1,35,1,6,10,1172,242,65,1,20,a,243,1237
5,1,35,1,6,11,1461,237,18,37,73,No,274,1479
5,1,35,1,6,12,1471,241,139,25,18,DETASLISSEMENT,266,1610
4,1,35,1,7,0,142,273,1443,29,-1,,302,1585
5,1,35,1,7,1,142,274,80,17,92,PETRO,291,222
5,1,35,1,7,2,240,274,99,17,96,CANADA,291,339
5,1,35,1,7,3,356,274,163,17,96,LUBRICANTS,291,519
5,1,35,1,7,4,540,274,47,17,96,INC,291,587
5,1,35,1,7,5,667,273,168,29,39,(0005064508,302,835
5,1,35,1,7,6,856,274,98,17,92,SUNCOR,291,954
5,1,35,1,7,7,972,274,99,18,96,ENERGY,292,1071
5,1,35,1,7,8,1088,274,133,17,96,MONTREAL,291,1221
5,1,35,1,7,9,1474,273,111,18,95,0082041,291,1585
4,1,35,1,8,0,142,299,1329,24,-1,,323,1471
5,1,35,1,8,1,142,304,62,17,91,PCLI,321,204
5,1,35,1,8,2,226,311,11,2,91,-,313,237
5,1,35,1,8,3,258,304,96,19,95,QUEBEC,323,354
5,1,35,1,8,4,374,303,45,18,96,302,321,419
5,1,35,1,8,5,672,302,163,19,95,0009406423,321,835
5,1,35,1,8,6,848,299,87,22,7,11675,321,935
5,1,35,1,8,7,956,308,47,13,96,rue,321,1003
5,1,35,1,8,8,1024,303,163,18,96,Sherbrooke,321,1187
5,1,35,1,8,9,1207,305,46,16,96,est,321,1253
5,1,35,1,8,10,1448,302,23,1,0,i,303,1471
4,1,35,1,9,0,142,332,1344,22,-1,,354,1486
5,1,35,1,9,1,142,332,45,18,96,385,350,187
5,1,35,1,9,2,209,333,146,17,95,SOUTHDOWN,350,355
5,1,35,1,9,3,373,333,64,17,96,ROAD,350,437
5,1,35,1,9,4,854,333,143,21,95,"Montreal,",354,997
5,1,35,1,9,5,1022,334,31,20,62,QC,354,1053
5,1,35,1,9,6,1072,333,49,18,87,H1B,351,1121
5,1,35,1,9,7,1141,333,44,19,71,1C3,352,1185
5,1,35,1,9,8,1280,333,68,21,91,(613),354,1348
5,1,35,1,9,9,1361,333,125,19,91,996-6666,352,1486
4,1,35,1,10,0,140,362,378,20,-1,,382,518
5,1,35,1,10,1,140,363,192,19,95,"MISSISSAUGA,",382,332
5,1,35,1,10,2,357,363,32,17,92,ON,380,389
5,1,35,1,10,3,406,362,49,18,0,L5d,380,455
5,1,35,1,10,4,474,362,44,18,84,2¥3,380,518
4,1,35,1,11,0,555,391,549,23,-1,,414,1104
5,1,35,1,11,1,555,411,4,3,0,.,414,559
5,1,35,1,11,2,634,412,7,1,55,_,413,641
5,1,35,1,11,3,855,391,116,21,96,Yannick,412,971
5,1,35,1,11,4,988,392,116,20,95,Mercier,412,1104
4,1,35,1,12,0,59,409,782,31,-1,,440,841
5,1,35,1,12,1,59,409,1,11,49,},420,60
5,1,35,1,12,2,267,415,1,25,93,|,440,268
5,1,35,1,12,3,274,414,62,12,93,RELEASE,426,336
5,1,35,1,12,4,342,414,47,14,44,(C-cl-A),428,389
5,1,35,1,12,5,394,415,59,11,95,NUMBER,426,453
5,1,35,1,12,6,564,415,79,11,92,CUSTOMER,426,643
5,1,35,1,12,7,648,415,75,12,95,PURCHASE,427,723
5,1,35,1,12,8,728,415,49,12,45,ORDER,427,777
5,1,35,1,12,9,783,416,58,11,96,NUMBER,427,841
4,1,35,1,13,0,59,427,746,14,-1,,441,805
5,1,35,1,13,1,59,427,1,14,92,|,441,60
5,1,35,1,13,2,614,429,17,11,94,No,440,631
5,1,35,1,13,3,636,429,18,11,96,DE,440,654
5,1,35,1,13,4,659,429,68,11,95,DEMANDE,440,727
5,1,35,1,13,5,732,429,19,11,95,DU,440,751
5,1,35,1,13,6,756,429,49,11,71,CLIENT,440,805
4,1,35,1,14,0,267,451,1,25,-1,,476,268
5,1,35,1,14,1,267,451,1,25,86,|,476,268
4,1,35,1,15,0,72,480,778,36,-1,,516,850
5,1,35,1,15,1,72,480,225,23,71,CARRIER-TRANSPORTEUR,503,297
5,1,35,1,15,2,565,481,11,1,41,7,482,576
5,1,35,1,15,3,674,482,7,1,0,-,483,681
4,1,35,1,16,0,141,513,1484,32,-1,,545,1625
5,1,35,1,16,1,141,513,48,18,91,GEO,531,189
5,1,35,1,16,2,206,514,17,17,96,A,531,223
5,1,35,1,16,3,240,515,65,16,96,HALL,531,305
5,1,35,1,16,4,574,514,111,18,82,0101535,532,685
5,1,35,1,16,5,702,510,11,44,10,|,554,713
5,1,35,1,16,6,730,529,71,15,0,~Veniclé,544,801
5,1,35,1,16,7,806,518,71,26,8,NUMBER,544,877
5,1,35,1,16,8,920,523,69,21,62,LICENSE,544,989
5,1,35,1,16,9,999,524,67,20,78,NUWBER,544,1066
5,1,35,1,16,10,1097,526,1,11,72,|,537,1098
5,1,35,1,16,11,1128,531,79,13,16,ADDRESS,544,1207
5,1,35,1,16,12,1214,531,21,13,95,OF,544,1235
5,1,35,1,16,13,1242,531,56,13,95,METER,544,1298
5,1,35,1,16,14,1304,531,34,13,95,AND,544,1338
5,1,35,1,16,15,1344,531,67,14,62,TRADER,545,1411
5,1,35,1,16,16,1568,526,57,1,26,|,527,1625
4,1,35,1,17,0,142,543,1333,24,-1,,567,1475
5,1,35,1,17,1,142,543,62,18,92,8800,561,204
5,1,35,1,17,2,226,552,11,2,92,-,554,237
5,1,35,1,17,3,258,543,30,19,85,6E,562,288
5,1,35,1,17,4,306,544,148,18,91,CROISSANT,562,454
5,1,35,1,17,5,709,552,2,5,73,|,557,711
5,1,35,1,17,6,734,552,19,13,73,No,565,753
5,1,35,1,17,7,760,552,21,14,91,DU,566,781
5,1,35,1,17,8,788,552,81,14,90,VEHICULE,566,869
5,1,35,1,17,9,919,553,72,13,96,NOMBRE,566,991
5,1,35,1,17,10,998,553,21,13,91,DE,566,1019
5,1,35,1,17,11,1026,553,61,13,90,PERMIS,566,1087
5,1,35,1,17,12,1095,545,12,31,89,|,576,1107
5,1,35,1,17,13,1114,553,91,13,86,L'ADRESSE,566,1205
5,1,35,1,17,14,1211,553,22,14,96,DE,567,1233
5,1,35,1,17,15,1239,553,56,14,96,METRE,567,1295
5,1,35,1,17,16,1302,553,20,14,96,ET,567,1322
5,1,35,1,17,17,1328,553,21,14,93,DE,567,1349
5,1,35,1,17,18,1356,553,119,14,91,COMMERCANT,567,1475
4,1,35,1,18,0,140,569,1363,33,-1,,602,1503
5,1,35,1,18,1,140,569,83,33,96,ANJOU,602,223
5,1,35,1,18,2,724,575,61,19,72,1111,594,785
5,1,35,1,18,3,1107,577,78,18,93,11675,595,1185
5,1,35,1,18,4,1206,582,48,14,95,rue,596,1254
5,1,35,1,18,5,1274,577,163,19,96,Sherbrooke,596,1437
5,1,35,1,18,6,1456,579,47,17,96,est,596,1503
4,1,35,1,19,0,140,604,1295,26,-1,,630,1435
5,1,35,1,19,1,140,604,49,19,20,H1J,623,189
5,1,35,1,19,2,208,604,45,19,38,1A1,623,253
5,1,35,1,19,3,483,604,87,25,2,EE,629,570
5,1,35,1,19,4,589,604,77,25,16,aces,629,666
5,1,35,1,19,5,723,606,62,19,96,1096,625,785
5,1,35,1,19,6,1104,608,143,21,96,"Montreal,",629,1247
5,1,35,1,19,7,1272,609,31,21,92,QC,630,1303
5,1,35,1,19,8,1322,608,49,18,84,H1B,626,1371
5,1,35,1,19,9,1390,608,45,19,33,1c3,627,1435
4,1,35,1,20,0,59,634,1260,25,-1,,659,1319
5,1,35,1,20,1,59,648,1,5,87,|,653,60
5,1,35,1,20,2,147,634,206,21,56,(514)352-5550,655,353
5,1,35,1,20,3,1112,638,68,21,44,(613),659,1180
5,1,35,1,20,4,1190,638,129,18,44,996-6666,656,1319
4,1,35,1,21,0,107,673,1240,27,-1,,700,1347
5,1,35,1,21,1,107,673,64,2,24,a,675,171
5,1,35,1,21,2,792,675,114,2,22,rn,677,906
5,1,35,1,21,3,939,676,10,7,73,|,683,949
5,1,35,1,21,4,1158,686,93,14,82,MEASURED,700,1251
5,1,35,1,21,5,1329,677,18,1,6,-,678,1347
4,1,35,1,22,0,72,694,1521,25,-1,,719,1593
5,1,35,1,22,1,72,694,143,13,89,PRODUCT/METER,707,215
5,1,35,1,22,2,1172,706,57,13,68,LITRES,719,1229
5,1,35,1,22,3,1302,698,105,13,81,CORRECTED,711,1407
5,1,35,1,22,4,1414,687,12,34,71,|,721,1426
5,1,35,1,22,5,1435,698,46,13,94,TEMP,711,1481
5,1,35,1,22,6,1493,687,12,34,94,|,721,1505
5,1,35,1,22,7,1522,698,71,14,94,DENSITY,712,1593
4,1,35,1,23,0,72,708,1520,36,-1,,744,1592
5,1,35,1,23,1,72,721,132,14,76,PRODUIT/METER,735,204
5,1,35,1,23,2,212,743,7,1,0,_,744,219
5,1,35,1,23,3,364,708,81,14,0,BOpwET,722,445
5,1,35,1,23,4,451,709,112,13,10,DESCAIBTION=,722,563
5,1,35,1,23,5,580,709,111,14,18,DESCRIPTION,723,691
5,1,35,1,23,6,698,710,21,13,55,DU,723,719
5,1,35,1,23,7,726,710,75,13,58,PRODUIT,723,801
5,1,35,1,23,8,1158,726,92,13,92,MESUREES,739,1250
5,1,35,1,23,9,1327,726,62,13,14,TO1sC,739,1389
5,1,35,1,23,10,1424,726,71,13,45,|CELSIUS|,739,1495
5,1,35,1,23,11,1522,726,70,14,68,DENSITE,740,1592
4,1,35,1,24,0,57,756,1527,27,-1,,783,1584
5,1,35,1,24,1,57,771,1,12,96,|,783,58
5,1,35,1,24,2,142,756,93,19,93,103265,775,235
5,1,35,1,24,3,248,752,17,33,93,|,785,265
5,1,35,1,24,4,272,758,49,18,95,NOT,776,321
5,1,35,1,24,5,338,758,148,18,95,REGULATED,776,486
5,1,35,1,24,6,504,760,83,16,96,UNDER,776,587
5,1,35,1,24,7,604,759,49,18,96,TDG,777,653
5,1,35,1,24,8,973,759,94,19,96,0.9645,778,1067
5,1,35,1,24,9,1172,760,79,19,95,44001,779,1251
5,1,35,1,24,10,1323,760,78,19,91,42439,779,1401
5,1,35,1,24,11,1424,760,60,19,87,|61.3,779,1484
5,1,35,1,24,12,1506,761,78,18,87,|910.6,779,1584
4,1,35,1,25,0,139,788,947,22,-1,,810,1086
5,1,35,1,25,1,139,788,96,18,90,MTR271,806,235
5,1,35,1,25,2,247,784,14,32,78,|,816,261
5,1,35,1,25,3,272,789,82,17,95,HEAVY,806,354
5,1,35,1,25,4,370,789,101,18,93,VACUUM,807,471
5,1,35,1,25,5,488,790,97,17,84,GASOIL,807,585
5,1,35,1,25,6,594,789,85,21,53,(HVGO),810,679
5,1,35,1,25,7,970,792,47,16,90,API,808,1017
5,1,35,1,25,8,1039,790,47,19,76,54B,809,1086
4,1,35,1,26,0,258,944,473,44,-1,,988,731
5,1,35,1,26,1,258,944,131,44,19,[2-55,988,389
5,1,35,1,26,2,457,952,274,34,0," O8F-10-Z0&""",986,731
4,1,35,1,27,0,250,999,514,49,-1,,1048,764
5,1,35,1,27,1,250,1010,125,38,0,/300,1048,375
5,1,35,1,27,2,456,999,109,49,2,WVGO,1048,565
5,1,35,1,27,3,594,1005,170,42,9,F7YRT,1047,764
4,1,35,1,28,0,56,1048,585,63,-1,,1111,641
5,1,35,1,28,1,56,1048,1,6,91,|,1054,57
5,1,35,1,28,2,258,1054,147,57,59,[3520,1111,405
5,1,35,1,28,3,458,1056,123,39,0,Breck,1095,581
5,1,35,1,28,4,602,1062,39,33,93,2,1095,641
4,1,35,1,29,0,1497,1379,2,10,-1,,1389,1499
5,1,35,1,29,1,1497,1379,2,10,90,|,1389,1499
4,1,35,1,30,0,304,1487,379,24,-1,,1511,683
5,1,35,1,30,1,304,1488,79,18,94,Total,1506,383
5,1,35,1,30,2,403,1487,96,20,96,Litres,1507,499
5,1,35,1,30,3,519,1488,32,23,96,by,1511,551
5,1,35,1,30,4,570,1488,113,19,96,Product,1507,683
4,1,35,1,31,0,271,1518,1128,24,-1,,1542,1399
5,1,35,1,31,1,271,1518,95,19,95,103265,1537,366
5,1,35,1,31,2,468,1521,83,17,84,HEAVY,1538,551
5,1,35,1,31,3,568,1520,101,19,93,VACUUM,1539,669
5,1,35,1,31,4,686,1521,90,18,88,GASOIL,1539,776
5,1,35,1,31,5,792,1520,85,22,90,(HVGO),1542,877
5,1,35,1,31,6,1170,1521,79,20,95,44001,1541,1249
5,1,35,1,31,7,1320,1522,79,19,95,42439,1541,1399
4,1,35,1,32,0,248,1672,1375,24,-1,,1696,1623
5,1,35,1,32,1,248,1677,3,8,37,1,1685,251
5,1,35,1,32,2,437,1686,110,2,7,—_—,1688,547
5,1,35,1,32,3,752,1687,24,1,62,—,1688,776
5,1,35,1,32,4,1280,1689,38,1,0,oe,1690,1318
5,1,35,1,32,5,1415,1689,35,2,51,—,1691,1450
5,1,35,1,32,6,1515,1690,10,1,46,_,1691,1525
5,1,35,1,32,7,1621,1672,2,24,85,|,1696,1623
4,1,35,1,33,0,68,1697,1555,21,-1,,1718,1623
5,1,35,1,33,1,68,1697,3,13,60,I,1710,71
5,1,35,1,33,2,78,1698,49,16,87,hereby,1714,127
5,1,35,1,33,3,132,1698,54,13,83,declare,1711,186
5,1,35,1,33,4,192,1698,26,13,56,that,1711,218
5,1,35,1,33,5,224,1698,22,13,96,the,1711,246
5,1,35,1,33,6,252,1700,61,11,96,contents,1711,313
5,1,35,1,33,7,318,1698,13,13,91,of,1711,331
5,1,35,1,33,8,337,1699,24,13,91,this,1712,361
5,1,35,1,33,9,368,1699,93,16,93,consignment,1715,461
5,1,35,1,33,10,466,1702,23,10,96,are,1712,489
5,1,35,1,33,11,494,1700,29,16,92,fully,1716,523
5,1,35,1,33,12,528,1700,27,12,92,and,1712,555
5,1,35,1,33,13,561,1700,75,16,87,accurately,1716,636
5,1,35,1,33,14,642,1700,71,13,89,described,1713,713
5,1,35,1,33,15,719,1701,44,12,86,abave,1713,763
5,1,35,1,33,16,768,1700,17,17,96,by,1717,785
5,1,35,1,33,17,790,1701,23,13,96,the,1714,813
5,1,35,1,33,18,818,1704,48,13,96,proper,1717,866
5,1,35,1,33,19,871,1701,60,17,87,shipping,1718,931
5,1,35,1,33,20,1621,1698,2,3,95,|,1701,1623
4,1,35,1,34,0,68,1718,878,19,-1,,1737,946
5,1,35,1,34,1,68,1720,44,12,93,"name,",1732,112
5,1,35,1,34,2,118,1720,23,10,94,are,1730,141
5,1,35,1,34,3,148,1718,58,16,68,properly,1734,206
5,1,35,1,34,4,212,1718,67,13,95,classified,1731,279
5,1,35,1,34,5,284,1718,27,13,96,and,1731,311
5,1,35,1,34,6,316,1718,75,17,96,"packaged,",1735,391
5,1,35,1,34,7,398,1718,35,14,96,have,1732,433
5,1,35,1,34,8,438,1719,77,16,96,dangerous,1735,515
5,1,35,1,34,9,522,1719,43,16,96,goods,1735,565
5,1,35,1,34,10,572,1720,43,16,96,safety,1736,615
5,1,35,1,34,11,621,1720,43,13,96,marks,1733,664
5,1,35,1,34,12,670,1720,59,16,96,properly,1736,729
5,1,35,1,34,13,736,1720,47,13,96,affixed,1733,783
5,1,35,1,34,14,788,1724,15,9,97,or,1733,803
5,1,35,1,34,15,808,1720,69,17,94,displayed,1737,877
5,1,35,1,34,16,883,1724,17,10,91,on,1734,900
5,1,35,1,34,17,906,1721,40,15,96,"them,",1736,946
4,1,35,1,35,0,68,1736,1553,25,-1,,1761,1621
5,1,35,1,35,1,68,1736,26,13,96,and,1749,94
5,1,35,1,35,2,100,1740,23,9,95,ara,1749,123
5,1,35,1,35,3,129,1736,11,13,96,in,1749,140
5,1,35,1,35,4,146,1737,15,13,86,ail,1750,161
5,1,35,1,35,5,168,1739,61,14,96,respects,1753,229
5,1,35,1,35,6,235,1737,11,13,89,in,1750,246
5,1,35,1,35,7,252,1740,47,13,96,proper,1753,299
5,1,35,1,35,8,304,1738,65,13,31,condition,1751,369
5,1,35,1,35,9,376,1738,18,13,89,for,1751,394
5,1,35,1,35,10,400,1739,64,15,82,iransport,1754,464
5,1,35,1,35,11,470,1739,70,16,86,according,1755,540
5,1,35,1,35,12,546,1740,13,12,91,to,1752,559
5,1,35,1,35,13,564,1739,23,13,95,the,1752,587
5,1,35,1,35,14,592,1739,107,16,95,Transportation,1755,699
5,1,35,1,35,15,704,1740,13,12,96,of,1752,717
5,1,35,1,35,16,724,1740,79,16,96,Dangerous,1756,803
5,1,35,1,35,17,809,1740,48,13,94,Goods,1753,857
5,1,35,1,35,18,864,1740,85,16,27,Regulations,1756,949
5,1,35,1,35,19,957,1730,9,33,27,|,1763,966
5,1,35,1,35,20,987,1748,32,11,0,—7yge,1759,1019
5,1,35,1,35,21,1025,1748,12,11,19,qn,1759,1037
5,1,35,1,35,22,1130,1748,44,12,94,START,1760,1174
5,1,35,1,35,23,1180,1748,60,12,91,LOADING,1760,1240
5,1,35,1,35,24,1311,1734,55,31,50,FINISH,1765,1366
5,1,35,1,35,25,1374,1734,58,31,52,LOADING,1765,1432
5,1,35,1,35,26,1515,1746,66,15,53,TiMeouT,1761,1581
4,1,35,1,36,0,136,1762,1441,20,-1,,1782,1577
5,1,35,1,36,1,136,1762,116,19,96,Yannick,1781,252
5,1,35,1,36,2,268,1764,65,18,93,Mere,1782,333
5,1,35,1,36,3,338,1763,11,18,84,L,1781,349
5,1,35,1,36,4,354,1768,29,14,95,er,1782,383
5,1,35,1,36,5,987,1762,60,11,83,ARRIVEE,1773,1047
5,1,35,1,36,6,1099,1762,46,11,85,OEBUT,1773,1145
5,1,35,1,36,7,1150,1762,19,11,91,DU,1773,1169
5,1,35,1,36,8,1174,1762,98,12,72,CHARGEMENT,1774,1272
5,1,35,1,36,9,1311,1763,20,11,96,FIN,1774,1331
5,1,35,1,36,10,1337,1764,18,10,89,DU,1774,1355
5,1,35,1,36,11,1360,1763,99,11,40,CHARGEMENT,1774,1459
5,1,35,1,36,12,1522,1764,55,10,81,DEPART,1774,1577
4,1,35,1,37,0,55,1795,1526,30,-1,,1825,1581
5,1,35,1,37,1,55,1811,1,5,89,|,1816,56
5,1,35,1,37,2,151,1795,56,30,95,Shipper,1825,207
5,1,35,1,37,3,214,1795,33,30,94,name,1825,247
5,1,35,1,37,4,259,1795,48,30,96,(please,1825,307
5,1,35,1,37,5,315,1795,38,30,96,print),1825,353
5,1,35,1,37,6,492,1800,37,2,44,—,1802,529
5,1,35,1,37,7,970,1797,78,18,95,04:16,1815,1048
5,1,35,1,37,8,1137,1798,78,17,96,04:24,1815,1215
5,1,35,1,37,9,1338,1798,77,18,96,04:50,1816,1415
5,1,35,1,37,10,1504,1799,77,18,96,04:50,1817,1581
4,1,35,1,38,0,68,1824,1497,22,-1,,1846,1565
5,1,35,1,38,1,68,1827,61,13,90,ORIVER,1840,129
5,1,35,1,38,2,136,1828,45,13,92,NAME,1841,181
5,1,35,1,38,3,188,1835,3,2,92,-,1837,191
5,1,35,1,38,4,198,1828,37,13,96,NOM,1841,235
5,1,35,1,38,5,242,1824,25,17,89,DU,1841,267
5,1,35,1,38,6,270,1828,116,14,90,CONDUCTEUR,1842,386
5,1,35,1,38,7,588,1825,61,18,86,DRIVER,1843,649
5,1,35,1,38,8,656,1825,70,18,78,NUMBER,1843,726
5,1,35,1,38,9,738,1821,14,33,68,|,1854,752
5,1,35,1,38,10,764,1830,59,13,95,DRIVER,1843,823
5,1,35,1,38,11,830,1827,95,17,92,SIGNATURE,1844,925
5,1,35,1,38,12,932,1838,4,2,92,-,1840,936
5,1,35,1,38,13,942,1831,96,13,60,SBNATURE,1844,1038
5,1,35,1,38,14,1044,1832,23,13,75,DU,1845,1067
5,1,35,1,38,15,1073,1832,117,13,75,CONDUCTEUR,1845,1190
5,1,35,1,38,16,1230,1827,29,4,56,|‘,1831,1259
5,1,35,1,38,17,1276,1827,53,18,58,TOTAL,1845,1329
5,1,35,1,38,18,1336,1832,83,14,0,QUANTITY,1846,1419
5,1,35,1,38,19,1424,1840,5,2,0,-,1842,1429
5,1,35,1,38,20,1434,1832,61,14,93,QUANT.,1846,1495
5,1,35,1,38,21,1502,1832,63,14,93,TOTALE,1846,1565
4,1,35,1,39,0,574,1844,887,18,-1,,1862,1461
5,1,35,1,39,1,574,1844,19,13,96,No,1857,593
5,1,35,1,39,2,600,1844,22,13,91,DU,1857,622
5,1,35,1,39,3,628,1844,117,14,66,GONBUSTEUA,1858,745
5,1,35,1,39,4,1458,1858,3,4,48,:,1862,1461
4,1,35,1,40,0,780,1852,752,56,-1,,1908,1532
5,1,35,1,40,1,780,1852,150,56,20,CPEA,1908,930
5,1,35,1,40,2,982,1853,39,51,27,FZ,1904,1021
5,1,35,1,40,3,1039,1871,56,17,56,—2,1888,1095
5,1,35,1,40,4,1320,1858,79,19,84,44001,1877,1399
5,1,35,1,40,5,1435,1860,97,18,91,Litres,1878,1532
4,1,35,1,41,0,138,1882,1274,32,-1,,1914,1412
5,1,35,1,41,1,138,1882,113,31,90,OSBALDO,1913,251
5,1,35,1,41,2,304,1883,181,31,89,QUINTANILLA,1914,485
5,1,35,1,41,3,604,1887,127,19,75,00026113,1906,731
5,1,35,1,41,4,1286,1889,79,19,66,38645,1908,1365
5,1,35,1,41,5,1386,1889,26,19,66,kg,1908,1412
2,1,36,0,0,0,52,1070,9,835,-1,,1905,61
3,1,36,1,0,0,52,1070,9,835,-1,,1905,61
4,1,36,1,1,0,52,1070,9,835,-1,,1905,61
5,1,36,1,1,1,52,1070,9,835,95, ,1905,61
2,1,37,0,0,0,951,1916,193,49,-1,,1965,1144
3,1,37,1,0,0,951,1916,193,49,-1,,1965,1144
4,1,37,1,1,0,951,1916,193,16,-1,,1932,1144
5,1,37,1,1,1,951,1921,36,10,95,TANK,1931,987
5,1,37,1,1,2,992,1916,72,16,74,CAPACITY,1932,1064
5,1,37,1,1,3,1068,1921,49,11,74,WATER,1932,1117
5,1,37,1,1,4,1122,1921,22,11,89,DIP|,1932,1144
4,1,37,1,2,0,954,1937,185,12,-1,,1949,1139
5,1,37,1,2,1,954,1937,97,11,50,CONTENANGE,1948,1051
5,1,37,1,2,2,1057,1928,11,30,92,|,1958,1068
5,1,37,1,2,3,1072,1938,67,11,92,MEASURE,1949,1139
4,1,37,1,3,0,952,1954,167,11,-1,,1965,1119
5,1,37,1,3,1,952,1954,104,11,90,DURESERVIOR,1965,1056
5,1,37,1,3,2,1061,1944,9,31,73,|,1975,1070
5,1,37,1,3,3,1082,1954,37,11,21,_DEAU,1965,1119
2,1,38,0,0,0,860,1920,67,28,-1,,1948,927
3,1,38,1,0,0,860,1920,67,28,-1,,1948,927
4,1,38,1,1,0,860,1920,67,11,-1,,1931,927
5,1,38,1,1,1,860,1920,67,11,69,PRODUCT,1931,927
4,1,38,1,2,0,863,1937,61,11,-1,,1948,924
5,1,38,1,2,1,863,1937,61,11,95,PRODUIT,1948,924
2,1,39,0,0,0,1155,1922,92,44,-1,,1966,1247
3,1,39,1,0,0,1155,1922,92,44,-1,,1966,1247
4,1,39,1,1,0,1155,1922,92,10,-1,,1932,1247
5,1,39,1,1,1,1155,1922,56,10,93,BEFORE,1932,1211
5,1,39,1,1,2,1216,1922,31,10,71,DIFS,1932,1247
4,1,39,1,2,0,1166,1938,66,11,-1,,1949,1232
5,1,39,1,2,1,1166,1938,45,11,95,AVANT,1949,1211
5,1,39,1,2,2,1216,1938,16,11,95,LE,1949,1232
4,1,39,1,3,0,1162,1954,76,12,-1,,1966,1238
5,1,39,1,3,1,1162,1954,76,12,12,JAUGEAGE,1966,1238
2,1,40,0,0,0,1269,1922,332,50,-1,,1972,1601
3,1,40,1,0,0,1269,1922,332,50,-1,,1972,1601
4,1,40,1,1,0,1272,1922,329,11,-1,,1933,1601
5,1,40,1,1,1,1272,1922,55,11,70,BEFORE,1933,1327
5,1,40,1,1,2,1332,1922,51,11,93,INVENT,1933,1383
5,1,40,1,1,3,1386,1913,7,31,82,|,1944,1393
5,1,40,1,1,4,1399,1922,44,11,89,AFTER,1933,1443
5,1,40,1,1,5,1449,1922,30,11,87,DIPS|,1933,1479
5,1,40,1,1,6,1494,1922,51,11,94,ENDING,1933,1545
5,1,40,1,1,7,1552,1913,49,31,38,INVENT,1944,1601
4,1,40,1,2,0,1286,1938,303,12,-1,,1950,1589
5,1,40,1,2,1,1286,1938,82,11,75,INVENTAIRE,1949,1368
5,1,40,1,2,2,1387,1930,10,30,88,|,1960,1397
5,1,40,1,2,3,1405,1938,66,12,92,APRESLE,1950,1471
5,1,40,1,2,4,1479,1930,8,30,70,|,1960,1487
5,1,40,1,2,5,1494,1930,8,30,18,—,1960,1502
5,1,40,1,2,6,1508,1939,81,11,52,INVENTAIRE,1950,1589
4,1,40,1,3,0,1269,1955,298,17,-1,,1972,1567
5,1,40,1,3,1,1269,1955,96,16,63,__JAUGEAGE,1971,1365
5,1,40,1,3,2,1372,1947,23,30,66,_|,1977,1395
5,1,40,1,3,3,1397,1955,77,17,79,JAUSEAGE,1972,1474
5,1,40,1,3,4,1522,1956,45,10,91,APRES,1966,1567
2,1,41,0,0,0,49,1861,1580,300,-1,,2161,1629
3,1,41,1,0,0,49,1861,1580,300,-1,,2161,1629
4,1,41,1,1,0,49,1861,1580,300,-1,,2161,1629
5,1,41,1,1,1,49,1861,1580,300,95,  ,2161,1629
2,1,42,0,0,0,77,1916,67,29,-1,,1945,144
3,1,42,1,0,0,77,1916,67,29,-1,,1945,144
4,1,42,1,1,0,77,1916,67,12,-1,,1928,144
5,1,42,1,1,1,77,1916,67,12,96,PRODUCT,1928,144
4,1,42,1,2,0,80,1934,61,11,-1,,1945,141
5,1,42,1,2,1,80,1934,61,11,82,PROOUIT,1945,141
2,1,43,0,0,0,170,1917,109,45,-1,,1962,279
3,1,43,1,0,0,170,1917,109,45,-1,,1962,279
4,1,43,1,1,0,170,1917,109,12,-1,,1929,279
5,1,43,1,1,1,170,1918,36,10,95,TANK,1928,206
5,1,43,1,1,2,211,1917,68,12,86,CAPACITY),1929,279
4,1,43,1,2,0,173,1934,96,11,-1,,1945,269
5,1,43,1,2,1,173,1934,96,11,91,CONTENANCE,1945,269
4,1,43,1,3,0,170,1951,104,11,-1,,1962,274
5,1,43,1,3,1,170,1951,19,11,80,OU,1962,189
5,1,43,1,3,2,194,1951,80,11,90,RESERVIOR,1962,274
2,1,44,0,0,0,286,1918,175,45,-1,,1963,461
3,1,44,1,0,0,286,1918,175,45,-1,,1963,461
4,1,44,1,1,0,286,1918,175,12,-1,,1930,461
5,1,44,1,1,1,286,1918,49,11,75,WATER,1929,335
5,1,44,1,1,2,340,1918,21,11,91,DIP|,1929,361
5,1,44,1,1,3,370,1918,55,11,96,BEFORE,1929,425
5,1,44,1,1,4,430,1918,31,12,50,DIPS.,1930,461
4,1,44,1,2,0,380,1936,65,10,-1,,1946,445
5,1,44,1,2,1,380,1936,45,10,95,AVANT,1946,425
5,1,44,1,2,2,430,1936,15,10,96,LE,1946,445
4,1,44,1,3,0,377,1952,74,11,-1,,1963,451
5,1,44,1,3,1,377,1952,74,11,84,JAUGEAGE,1963,451
2,1,45,0,0,0,480,1919,111,45,-1,,1964,591
3,1,45,1,0,0,480,1919,111,45,-1,,1964,591
4,1,45,1,1,0,480,1919,111,11,-1,,1930,591
5,1,45,1,1,1,480,1919,55,11,91,BEFORE,1930,535
5,1,45,1,1,2,540,1919,51,11,88,INVENT,1930,591
4,1,45,1,2,0,494,1936,81,11,-1,,1947,575
5,1,45,1,2,1,494,1936,81,11,70,INVENTAIRE,1947,575
4,1,45,1,3,0,498,1952,75,12,-1,,1964,573
5,1,45,1,3,1,498,1952,75,12,90,JAUGEAGE,1964,573
2,1,46,0,0,0,615,1919,200,45,-1,,1964,815
3,1,46,1,0,0,615,1919,200,45,-1,,1964,815
4,1,46,1,1,0,615,1919,200,12,-1,,1931,815
5,1,46,1,1,1,615,1919,45,11,90,AFTER,1930,660
5,1,46,1,1,2,666,1920,21,10,69,"DIPS,",1930,687
5,1,46,1,1,3,708,1920,51,11,95,ENDING,1931,759
5,1,46,1,1,4,765,1920,50,11,92,INVENT,1931,815
4,1,46,1,2,0,621,1936,182,12,-1,,1948,803
5,1,46,1,2,1,621,1936,66,11,70,APRESLE,1947,687
5,1,46,1,2,2,696,1929,12,28,59,|,1957,708
5,1,46,1,2,3,721,1936,82,12,86,INVENTAIRE,1948,803
4,1,46,1,3,0,615,1952,168,12,-1,,1964,783
5,1,46,1,3,1,615,1952,75,12,56,JAUGEAGE,1964,690
5,1,46,1,3,2,738,1953,45,11,92,APRES,1964,783
2,1,47,0,0,0,906,1966,347,6,-1,,1972,1253
3,1,47,1,0,0,906,1966,347,6,-1,,1972,1253
4,1,47,1,1,0,906,1966,347,6,-1,,1972,1253
5,1,47,1,1,1,906,1966,347,6,95, ,1972,1253
2,1,48,0,0,0,58,1964,721,7,-1,,1971,779
3,1,48,1,0,0,58,1964,721,7,-1,,1971,779
4,1,48,1,1,0,58,1964,721,7,-1,,1971,779
5,1,48,1,1,1,58,1964,721,7,95, ,1971,779
2,1,49,0,0,0,114,2026,496,4,-1,,2030,610
3,1,49,1,0,0,114,2026,496,4,-1,,2030,610
4,1,49,1,1,0,114,2026,496,4,-1,,2030,610
5,1,49,1,1,1,114,2026,496,4,95, ,2030,610
2,1,50,0,0,0,747,2027,871,8,-1,,2035,1618
3,1,50,1,0,0,747,2027,871,8,-1,,2035,1618
4,1,50,1,1,0,747,2027,871,8,-1,,2035,1618
5,1,50,1,1,1,747,2027,871,8,95, ,2035,1618
2,1,51,0,0,0,147,2085,1303,10,-1,,2095,1450
3,1,51,1,0,0,147,2085,1303,10,-1,,2095,1450
4,1,51,1,1,0,147,2085,1303,10,-1,,2095,1450
5,1,51,1,1,1,147,2085,1303,10,95, ,2095,1450
2,1,52,0,0,0,747,2087,703,8,-1,,2095,1450
3,1,52,1,0,0,747,2087,703,8,-1,,2095,1450
4,1,52,1,1,0,747,2087,703,8,-1,,2095,1450
5,1,52,1,1,1,747,2087,703,8,95, ,2095,1450
2,1,53,0,0,0,463,1912,3,193,-1,,2105,466
3,1,53,1,0,0,463,1912,3,193,-1,,2105,466
4,1,53,1,1,0,463,1912,3,193,-1,,2105,466
5,1,53,1,1,1,463,1912,3,193,95, ,2105,466
2,1,54,0,0,0,164,1910,4,238,-1,,2148,168
3,1,54,1,0,0,164,1910,4,238,-1,,2148,168
4,1,54,1,1,0,164,1910,4,238,-1,,2148,168
5,1,54,1,1,1,164,1910,4,238,95, ,2148,168
2,1,55,0,0,0,607,1912,4,238,-1,,2150,611
3,1,55,1,0,0,607,1912,4,238,-1,,2150,611
4,1,55,1,1,0,607,1912,4,238,-1,,2150,611
5,1,55,1,1,1,607,1912,4,238,95, ,2150,611
2,1,56,0,0,0,1145,1914,4,238,-1,,2152,1149
3,1,56,1,0,0,1145,1914,4,238,-1,,2152,1149
4,1,56,1,1,0,1145,1914,4,238,-1,,2152,1149
5,1,56,1,1,1,1145,1914,4,238,95, ,2152,1149
2,1,57,0,0,0,280,1911,4,237,-1,,2148,284
3,1,57,1,0,0,280,1911,4,237,-1,,2148,284
4,1,57,1,1,0,280,1911,4,237,-1,,2148,284
5,1,57,1,1,1,280,1911,4,237,95, ,2148,284
2,1,58,0,0,0,1062,1933,3,219,-1,,2152,1065
3,1,58,1,0,0,1062,1933,3,219,-1,,2152,1065
4,1,58,1,1,0,1062,1933,3,219,-1,,2152,1065
5,1,58,1,1,1,1062,1933,3,219,95,,2152,1065
1,1,0,0,0,0,0,0,1700,2200,-1,,2200,1700
2,1,1,0,0,0,911,90,611,24,-1,,114,1522
3,1,1,1,0,0,911,90,611,24,-1,,114,1522
4,1,1,1,1,0,911,90,611,24,-1,,114,1522
5,1,1,1,1,1,911,90,116,22,96,VEHICLE,112,1027
5,1,1,1,1,2,1039,91,121,22,96,LOADING,113,1160
5,1,1,1,1,3,1172,91,112,22,93,REPORT,113,1284
5,1,1,1,1,4,1280,86,14,38,92,-,124,1294
5,1,1,1,1,5,1312,92,54,21,95,BILL,113,1366
5,1,1,1,1,6,1376,92,36,22,93,OF,114,1412
5,1,1,1,1,7,1423,92,99,22,91,LADING,114,1522
2,1,2,0,0,0,1280,144,331,5,-1,,149,1611
3,1,2,1,0,0,1280,144,331,5,-1,,149,1611
4,1,2,1,1,0,1280,144,331,5,-1,,149,1611
5,1,2,1,1,1,1280,144,331,5,95, ,149,1611
2,1,3,0,0,0,499,138,610,11,-1,,149,1109
3,1,3,1,0,0,499,138,610,11,-1,,149,1109
4,1,3,1,1,0,499,138,610,11,-1,,149,1109
5,1,3,1,1,1,499,138,610,11,95, ,149,1109
2,1,4,0,0,0,217,136,892,14,-1,,150,1109
3,1,4,1,0,0,217,136,892,14,-1,,150,1109
4,1,4,1,1,0,217,136,892,14,-1,,150,1109
5,1,4,1,1,1,217,136,892,14,95, ,150,1109
2,1,5,0,0,0,277,235,420,8,-1,,243,697
3,1,5,1,0,0,277,235,420,8,-1,,243,697
4,1,5,1,1,0,277,235,420,8,-1,,243,697
5,1,5,1,1,1,277,235,420,8,95, ,243,697
2,1,6,0,0,0,63,476,342,6,-1,,482,405
3,1,6,1,0,0,63,476,342,6,-1,,482,405
4,1,6,1,1,0,63,476,342,6,-1,,482,405
5,1,6,1,1,1,63,476,342,6,95, ,482,405
2,1,7,0,0,0,715,518,910,13,-1,,531,1625
3,1,7,1,0,0,715,518,910,13,-1,,531,1625
4,1,7,1,1,0,715,518,910,13,-1,,531,1625
5,1,7,1,1,1,715,518,910,13,95, ,531,1625
2,1,8,0,0,0,1002,520,623,11,-1,,531,1625
3,1,8,1,0,0,1002,520,623,11,-1,,531,1625
4,1,8,1,1,0,1002,520,623,11,-1,,531,1625
5,1,8,1,1,1,1002,520,623,11,95, ,531,1625
2,1,9,0,0,0,1145,675,306,7,-1,,682,1451
3,1,9,1,0,0,1145,675,306,7,-1,,682,1451
4,1,9,1,1,0,1145,675,306,7,-1,,682,1451
5,1,9,1,1,1,1145,675,306,7,95, ,682,1451
2,1,10,0,0,0,619,674,74,3,-1,,677,693
3,1,10,1,0,0,619,674,74,3,-1,,677,693
4,1,10,1,1,0,619,674,74,3,-1,,677,693
5,1,10,1,1,1,619,674,74,3,95, ,677,693
2,1,11,0,0,0,906,673,545,10,-1,,683,1451
3,1,11,1,0,0,906,673,545,10,-1,,683,1451
4,1,11,1,1,0,906,673,545,10,-1,,683,1451
5,1,11,1,1,1,906,673,545,10,95, ,683,1451
2,1,12,0,0,0,522,740,845,13,-1,,753,1367
3,1,12,1,0,0,522,740,845,13,-1,,753,1367
4,1,12,1,1,0,522,740,845,13,-1,,753,1367
5,1,12,1,1,1,522,740,845,13,95, ,753,1367
2,1,13,0,0,0,67,741,318,4,-1,,745,385
3,1,13,1,0,0,67,741,318,4,-1,,745,385
4,1,13,1,1,0,67,741,318,4,-1,,745,385
5,1,13,1,1,1,67,741,318,4,95, ,745,385
2,1,14,0,0,0,941,685,10,534,-1,,1219,951
3,1,14,1,0,0,941,685,10,534,-1,,1219,951
4,1,14,1,1,0,941,685,10,534,-1,,1219,951
5,1,14,1,1,1,941,685,10,534,95, ,1219,951
2,1,15,0,0,0,57,568,8,717,-1,,1285,65
3,1,15,1,0,0,57,568,8,717,-1,,1285,65
4,1,15,1,1,0,57,568,8,717,-1,,1285,65
5,1,15,1,1,1,57,568,8,717,95, ,1285,65
2,1,16,0,0,0,1275,677,11,666,-1,,1343,1286
3,1,16,1,0,0,1275,677,11,666,-1,,1343,1286
4,1,16,1,1,0,1275,677,11,666,-1,,1343,1286
5,1,16,1,1,1,1275,677,11,666,95, ,1343,1286
2,1,17,0,0,0,244,514,19,1172,-1,,1686,263
3,1,17,1,0,0,244,514,19,1172,-1,,1686,263
4,1,17,1,1,0,244,514,19,1172,-1,,1686,263
5,1,17,1,1,1,244,514,19,1172,95, ,1686,263
2,1,18,0,0,0,1411,678,16,1014,-1,,1692,1427
3,1,18,1,0,0,1411,678,16,1014,-1,,1692,1427
4,1,18,1,1,0,1411,678,16,1014,-1,,1692,1427
5,1,18,1,1,1,1411,678,16,1014,95, ,1692,1427
2,1,19,0,0,0,1119,677,15,1011,-1,,1688,1134
3,1,19,1,0,0,1119,677,15,1011,-1,,1688,1134
4,1,19,1,1,0,1119,677,15,1011,-1,,1688,1134
5,1,19,1,1,1,1119,677,15,1011,95, ,1688,1134
2,1,20,0,0,0,810,1685,498,7,-1,,1692,1308
3,1,20,1,0,0,810,1685,498,7,-1,,1692,1308
4,1,20,1,1,0,810,1685,498,7,-1,,1692,1308
5,1,20,1,1,1,810,1685,498,7,95, ,1692,1308
2,1,21,0,0,0,533,1682,775,12,-1,,1694,1308
3,1,21,1,0,0,533,1682,775,12,-1,,1694,1308
4,1,21,1,1,0,533,1682,775,12,-1,,1694,1308
5,1,21,1,1,1,533,1682,775,12,95, ,1694,1308
2,1,22,0,0,0,61,1681,324,6,-1,,1687,385
3,1,22,1,0,0,61,1681,324,6,-1,,1687,385
4,1,22,1,1,0,61,1681,324,6,-1,,1687,385
5,1,22,1,1,1,61,1681,324,6,95, ,1687,385
2,1,23,0,0,0,50,1689,933,292,-1,,1981,983
3,1,23,1,0,0,50,1689,933,292,-1,,1981,983
4,1,23,1,1,0,934,1689,49,40,-1,,1729,983
5,1,23,1,1,1,934,1689,49,40,95, ,1729,983
4,1,23,1,2,0,837,1733,88,60,-1,,1793,925
5,1,23,1,2,1,837,1733,88,60,95,    ,1793,925
4,1,23,1,3,0,564,1793,344,17,-1,,1810,908
5,1,23,1,3,1,564,1793,344,17,95, ,1810,908
4,1,23,1,4,0,564,1810,338,21,-1,,1831,902
5,1,23,1,4,1,564,1810,338,21,95, ,1831,902
4,1,23,1,5,0,564,1831,314,21,-1,,1852,878
5,1,23,1,5,1,564,1831,314,21,95, ,1852,878
4,1,23,1,6,0,564,1852,361,15,-1,,1867,925
5,1,23,1,6,1,564,1852,361,15,95, ,1867,925
4,1,23,1,7,0,52,1867,873,10,-1,,1877,925
5,1,23,1,7,1,52,1867,873,10,95, ,1877,925
4,1,23,1,8,0,51,1877,89,40,-1,,1917,140
5,1,23,1,8,1,51,1877,89,40,95,    ,1917,140
4,1,23,1,9,0,51,1917,13,22,-1,,1939,64
5,1,23,1,9,1,51,1917,13,22,95,     ,1939,64
4,1,23,1,10,0,51,1939,14,17,-1,,1956,65
5,1,23,1,10,1,51,1939,14,17,95,      ,1956,65
4,1,23,1,11,0,50,1956,559,25,-1,,1981,609
5,1,23,1,11,1,50,1956,559,25,95,  ,1981,609
2,1,24,0,0,0,969,1741,652,9,-1,,1750,1621
3,1,24,1,0,0,969,1741,652,9,-1,,1750,1621
4,1,24,1,1,0,969,1741,652,9,-1,,1750,1621
5,1,24,1,1,1,969,1741,652,9,95, ,1750,1621
2,1,25,0,0,0,288,1799,75,3,-1,,1802,363
3,1,25,1,0,0,288,1799,75,3,-1,,1802,363
4,1,25,1,1,0,288,1799,75,3,-1,,1802,363
5,1,25,1,1,1,288,1799,75,3,95, ,1802,363
2,1,26,0,0,0,1493,678,18,1142,-1,,1820,1511
3,1,26,1,0,0,1493,678,18,1142,-1,,1820,1511
4,1,26,1,1,0,1493,678,18,1142,-1,,1820,1511
5,1,26,1,1,1,1493,678,18,1142,95, ,1820,1511
2,1,27,0,0,0,1019,1793,238,112,-1,,1905,1257
3,1,27,1,0,0,1019,1793,238,112,-1,,1905,1257
4,1,27,1,1,0,1233,1793,24,32,-1,,1825,1257
5,1,27,1,1,1,1233,1793,24,32,95, ,1825,1257
4,1,27,1,2,0,1233,1825,24,31,-1,,1856,1257
5,1,27,1,2,1,1233,1825,24,31,95,  ,1856,1257
4,1,27,1,3,0,1019,1856,238,49,-1,,1905,1257
5,1,27,1,3,1,1019,1856,238,49,95,   ,1905,1257
2,1,28,0,0,0,608,1821,853,14,-1,,1835,1461
3,1,28,1,0,0,608,1821,853,14,-1,,1835,1461
4,1,28,1,1,0,608,1821,853,14,-1,,1835,1461
5,1,28,1,1,1,608,1821,853,14,95, ,1835,1461
2,1,29,0,0,0,57,118,1579,1790,-1,,1908,1636
3,1,29,1,0,0,56,118,1576,1790,-1,,1908,1632
4,1,29,1,1,0,147,118,1481,28,-1,,146,1628
5,1,29,1,1,1,147,121,74,21,96,Page:,142,221
5,1,29,1,1,2,246,120,12,18,95,1,138,258
5,1,29,1,1,3,375,121,148,25,0,530,146,523
5,1,29,1,1,4,815,118,131,22,96,RAPPORT,140,946
5,1,29,1,1,5,957,119,34,21,92,DE,140,991
5,1,29,1,1,6,1002,119,212,27,90,CHARGEMENT,146,1214
5,1,29,1,1,7,1199,114,16,37,92,-,151,1215
5,1,29,1,1,8,1224,120,136,22,91,VEHICULE,142,1360
5,1,29,1,1,9,1371,132,7,2,93,-,134,1378
5,1,29,1,1,10,1388,120,240,22,78,CONNAISSEMENT,142,1628
4,1,29,1,2,0,64,140,607,42,-1,,182,671
5,1,29,1,2,1,64,140,10,17,32,[,157,74
5,1,29,1,2,2,135,141,113,45,56,DOCUMENT,186,248
5,1,29,1,2,3,254,150,79,32,56,NUMBER,182,333
5,1,29,1,2,4,362,150,61,18,84,6966,168,423
5,1,29,1,2,5,478,152,1,4,66,|,156,479
5,1,29,1,2,6,517,141,56,45,45,pie,186,573
5,1,29,1,2,7,577,141,94,45,1,neutesition,186,671
4,1,29,1,3,0,522,175,1088,37,-1,,212,1610
5,1,29,1,3,1,522,175,137,37,94,mm/dd/yy,212,659
5,1,29,1,3,2,799,183,30,20,94,24,203,829
5,1,29,1,3,3,839,183,78,21,94,HOUR,204,917
5,1,29,1,3,4,928,183,118,22,89,NUMBER,205,1046
5,1,29,1,3,5,1067,182,206,20,88,(613)996-6666,202,1273
5,1,29,1,3,6,1311,184,137,22,88,-NUMERO,206,1448
5,1,29,1,3,7,1459,185,29,20,96,24,205,1488
5,1,29,1,3,8,1498,185,112,22,96,HEURES,207,1610
4,1,29,1,4,0,148,194,1224,45,-1,,239,1372
5,1,29,1,4,1,148,208,108,19,95,0362697,227,256
5,1,29,1,4,2,279,209,94,20,95,10/007,229,373
5,1,29,1,4,3,465,194,15,45,94,|,239,480
5,1,29,1,4,4,528,210,128,20,96,10/08/24,230,656
5,1,29,1,4,5,1049,214,232,22,88,COLLECT,236,1281
5,1,29,1,4,6,1179,210,15,35,88,-,245,1194
5,1,29,1,4,7,1208,214,71,22,91,FRAIS,236,1279
5,1,29,1,4,8,1292,215,80,21,90,VIRES,236,1372
4,1,29,1,5,0,70,235,1566,37,-1,,272,1636
5,1,29,1,5,1,70,235,203,18,44,“CONSIGNEE/CUSTOMER,253,273
5,1,29,1,5,2,279,248,4,2,89,-,250,283
5,1,29,1,5,3,290,241,182,14,56,DESTINATAIRE/CLIENT,255,472
5,1,29,1,5,4,687,247,28,17,19,ROB,264,715
5,1,29,1,5,5,725,245,29,19,0,ena,264,754
5,1,29,1,5,6,758,239,78,26,0,UegeueNT,265,836
5,1,29,1,5,7,847,235,12,34,92,|,269,859
5,1,29,1,5,8,862,240,101,17,91,CONSIGNOR,257,963
5,1,29,1,5,9,970,251,4,2,91,-,253,974
5,1,29,1,5,10,980,244,106,13,40,EXPEDITEUR,257,1086
5,1,29,1,5,11,1307,241,5,2,43,7,243,1312
5,1,29,1,5,12,1465,237,139,35,19,TEN,272,1604
5,1,29,1,5,13,1618,237,18,35,45,||,272,1636
4,1,29,1,6,0,147,269,1442,23,-1,,292,1589
5,1,29,1,6,1,147,270,79,18,91,PETRO,288,226
5,1,29,1,6,2,244,271,99,17,96,CANADA,288,343
5,1,29,1,6,3,360,271,164,19,96,LUBRICANTS,290,524
5,1,29,1,6,4,544,272,46,18,96,INC,290,590
5,1,29,1,6,5,678,271,161,19,77,0005064508,290,839
5,1,29,1,6,6,861,273,97,18,77,|SUNCOR,291,958
5,1,29,1,6,7,977,274,98,18,96,ENERGY,292,1075
5,1,29,1,6,8,1093,274,131,18,96,MONTREAL,292,1224
5,1,29,1,6,9,1449,269,1,11,84,|,280,1450
5,1,29,1,6,10,1478,274,111,18,93,0082041,292,1589
4,1,29,1,7,0,147,299,1474,23,-1,,322,1621
5,1,29,1,7,1,147,301,61,17,91,PCLI,318,208
5,1,29,1,7,2,229,309,11,2,91,-,311,240
5,1,29,1,7,3,260,301,97,21,96,QUEBEC,322,357
5,1,29,1,7,4,378,301,44,18,96,302,319,422
5,1,29,1,7,5,672,299,166,21,74,0009406423,320,838
5,1,29,1,7,6,857,300,82,21,83,11675,321,939
5,1,29,1,7,7,960,308,48,14,95,rue,322,1008
5,1,29,1,7,8,1028,303,162,19,95,Sherbrooke,322,1190
5,1,29,1,7,9,1210,305,46,17,96,est,322,1256
5,1,29,1,7,10,1460,302,161,2,18,a,304,1621
4,1,29,1,8,0,147,330,1342,26,-1,,356,1489
5,1,29,1,8,1,147,330,44,18,96,385,348,191
5,1,29,1,8,2,213,331,145,18,96,SOUTHDOWN,349,358
5,1,29,1,8,3,376,333,64,17,96,ROAD,350,440
5,1,29,1,8,4,851,333,150,21,69,"|Montreal,",354,1001
5,1,29,1,8,5,1027,335,30,21,87,QC,356,1057
5,1,29,1,8,6,1076,335,48,17,87,H1B,352,1124
5,1,29,1,8,7,1145,335,43,17,84,1C3,352,1188
5,1,29,1,8,8,1282,335,69,20,22,(613),355,1351
5,1,29,1,8,9,1363,335,126,18,22,996-6666,353,1489
4,1,29,1,9,0,143,361,378,21,-1,,382,521
5,1,29,1,9,1,143,361,191,21,96,"MISSISSAUGA,",382,334
5,1,29,1,9,2,360,362,31,18,91,ON,380,391
5,1,29,1,9,3,410,361,48,19,88,L5J,380,458
5,1,29,1,9,4,477,361,44,19,30,2¥3,380,521
4,1,29,1,10,0,269,387,838,27,-1,,414,1107
5,1,29,1,10,1,269,411,293,3,26,HY,414,562
5,1,29,1,10,2,630,412,32,2,52,_,414,662
5,1,29,1,10,3,672,387,303,27,55,Yannick,414,975
5,1,29,1,10,4,991,393,116,19,94,Mercier,412,1107
4,1,29,1,11,0,269,413,576,17,-1,,430,845
5,1,29,1,11,1,269,417,2,3,95,|,420,271
5,1,29,1,11,2,276,413,62,11,93,RELEASE,424,338
5,1,29,1,11,3,344,414,48,14,72,(C-of-A),428,392
5,1,29,1,11,4,397,414,59,12,95,NUMBER,426,456
5,1,29,1,11,5,560,419,1,11,81,|,430,561
5,1,29,1,11,6,567,415,78,11,95,CUSTOMER,426,645
5,1,29,1,11,7,651,415,76,11,96,PURCHASE,426,727
5,1,29,1,11,8,731,415,49,11,96,ORDER,426,780
5,1,29,1,11,9,786,416,59,11,48,NUMBER:,427,845
4,1,29,1,12,0,617,429,190,11,-1,,440,807
5,1,29,1,12,1,617,429,16,11,96,No,440,633
5,1,29,1,12,2,639,429,17,11,96,DE,440,656
5,1,29,1,12,3,662,429,68,11,96,DEMANDE,440,730
5,1,29,1,12,4,736,429,17,11,96,DU,440,753
5,1,29,1,12,5,759,429,48,11,95,CLIENT,440,807
4,1,29,1,13,0,75,478,737,24,-1,,502,812
5,1,29,1,13,1,75,478,73,23,93,CARRIER,501,148
5,1,29,1,13,2,155,496,4,2,91,-,498,159
5,1,29,1,13,3,164,479,136,23,87,TRANSPORTEUR,502,300
5,1,29,1,13,4,362,479,12,1,25,7,480,374
5,1,29,1,13,5,758,482,21,1,0,a,483,779
4,1,29,1,14,0,145,513,1269,33,-1,,546,1414
5,1,29,1,14,1,145,513,47,18,95,GEO,531,192
5,1,29,1,14,2,209,514,17,16,94,A,530,226
5,1,29,1,14,3,242,514,65,17,96,HALL,531,307
5,1,29,1,14,4,577,514,111,19,95,0101535,533,688
5,1,29,1,14,5,705,510,19,44,0,|,554,724
5,1,29,1,14,6,733,523,152,21,0,VenicleNUMBER,544,885
5,1,29,1,14,7,909,523,160,22,11, LICENSENUMBER,545,1069
5,1,29,1,14,8,1101,526,1,10,51,|,536,1102
5,1,29,1,14,9,1131,532,78,13,77,ADDRESS,545,1209
5,1,29,1,14,10,1216,532,21,13,96,OF,545,1237
5,1,29,1,14,11,1244,532,56,13,96,METER,545,1300
5,1,29,1,14,12,1306,532,34,13,94,AND,545,1340
5,1,29,1,14,13,1346,532,68,14,94,TRADER,546,1414
4,1,29,1,15,0,147,542,1331,26,-1,,568,1478
5,1,29,1,15,1,147,542,60,19,91,8800,561,207
5,1,29,1,15,2,228,552,11,2,91,-,554,239
5,1,29,1,15,3,261,543,29,18,40,6&,561,290
5,1,29,1,15,4,309,544,147,18,92,CROISSANT,562,456
5,1,29,1,15,5,736,552,137,14,72,NoDUVEHICULE,566,873
5,1,29,1,15,6,897,544,17,33,31,=,577,914
5,1,29,1,15,7,922,554,72,13,36,NOMBRE,567,994
5,1,29,1,15,8,1000,554,22,13,36,DE,567,1022
5,1,29,1,15,9,1029,554,62,13,51,PERMIS,567,1091
5,1,29,1,15,10,1118,554,89,14,62, L'ADRESSE,568,1207
5,1,29,1,15,11,1214,554,21,14,96,DE,568,1235
5,1,29,1,15,12,1242,554,56,14,96,METRE,568,1298
5,1,29,1,15,13,1305,555,19,13,96,ET,568,1324
5,1,29,1,15,14,1331,555,21,13,91,OE,568,1352
5,1,29,1,15,15,1358,555,120,13,54,COMMEACANT,568,1478
4,1,29,1,16,0,143,569,1362,33,-1,,602,1505
5,1,29,1,16,1,143,569,81,33,96,ANJOU,602,224
5,1,29,1,16,2,726,576,61,19,69,1139,595,787
5,1,29,1,16,3,1111,578,76,18,96,11675,596,1187
5,1,29,1,16,4,1208,583,48,13,96,rue,596,1256
5,1,29,1,16,5,1276,578,164,19,96,Sherbrooke,597,1440
5,1,29,1,16,6,1459,581,46,16,96,est,597,1505
4,1,29,1,17,0,143,597,1294,37,-1,,634,1437
5,1,29,1,17,1,143,604,49,19,22,H1d,623,192
5,1,29,1,17,2,211,604,44,18,87,1Ai,622,255
5,1,29,1,17,3,476,601,1,21,82,|,622,477
5,1,29,1,17,4,490,597,62,37,65,GARRIER,634,552
5,1,29,1,17,5,561,597,100,37,17,CERTIFIOATION,634,661
5,1,29,1,17,6,726,607,61,18,95,1085,625,787
5,1,29,1,17,7,1107,608,143,22,95,"Montreal,",630,1250
5,1,29,1,17,8,1275,610,30,20,89,QC,630,1305
5,1,29,1,17,9,1324,609,49,18,85,H1B,627,1373
5,1,29,1,17,10,1393,610,44,18,63,1C3,628,1437
4,1,29,1,18,0,151,632,1170,27,-1,,659,1321
5,1,29,1,18,1,151,634,66,21,11,(514),655,217
5,1,29,1,18,2,227,635,128,19,11,352-5550,654,355
5,1,29,1,18,3,476,632,1,22,88,|,654,477
5,1,29,1,18,4,1115,639,67,20,91,(613),659,1182
5,1,29,1,18,5,1196,639,125,19,91,996-6666,658,1321
4,1,29,1,19,0,63,664,1565,16,-1,,680,1628
5,1,29,1,19,1,63,672,129,2,0,———oee,674,192
5,1,29,1,19,2,246,674,9,1,25,a,675,255
5,1,29,1,19,3,256,674,202,1,20,Ree,675,458
5,1,29,1,19,4,540,675,75,1,21,——,676,615
5,1,29,1,19,5,710,664,4,13,0,[,677,714
5,1,29,1,19,6,853,676,96,2,16,a,678,949
5,1,29,1,19,7,1047,677,4,1,3,-,678,1051
5,1,29,1,19,8,1455,678,54,1,0,a,679,1509
5,1,29,1,19,9,1589,679,39,1,79,__|,680,1628
4,1,29,1,20,0,1160,687,93,14,-1,,701,1253
5,1,29,1,20,1,1160,687,93,14,96,MEASURED,701,1253
4,1,29,1,21,0,75,693,1519,20,-1,,713,1594
5,1,29,1,21,1,75,693,141,14,89,PRODUCT/METER,707,216
5,1,29,1,21,2,1304,699,105,13,95,CORRECTED,712,1409
5,1,29,1,21,3,1418,689,12,33,95,|,722,1430
5,1,29,1,21,4,1438,699,45,13,95,TEMP,712,1483
5,1,29,1,21,5,1495,689,12,33,91,|,722,1507
5,1,29,1,21,6,1525,700,69,13,91,DENSITY,713,1594
4,1,29,1,22,0,571,707,711,13,-1,,720,1282
5,1,29,1,22,1,571,717,4,2,15,.,719,575
5,1,29,1,22,2,1174,707,108,13,54,LITRES,720,1282
4,1,29,1,23,0,75,709,1547,45,-1,,754,1622
5,1,29,1,23,1,75,721,135,22,47,PACDUITIMETER,743,210
5,1,29,1,23,2,229,742,5,1,3,;,743,234
5,1,29,1,23,3,366,709,82,36,66,PRODUCT,745,448
5,1,29,1,23,4,453,709,111,13,93,DESCRIPTION,722,564
5,1,29,1,23,5,567,705,12,25,91,-,730,579
5,1,29,1,23,6,582,710,111,13,82,DESCRIPTION,723,693
5,1,29,1,23,7,700,711,25,35,50,pu,746,725
5,1,29,1,23,8,730,711,73,12,87,PRODUIT,723,803
5,1,29,1,23,9,1160,725,92,14,91,MESUREES,739,1252
5,1,29,1,23,10,1330,726,22,13,91,To,739,1352
5,1,29,1,23,11,1359,726,32,22,60,isc,748,1391
5,1,29,1,23,12,1427,710,69,43,33,ceLsius,753,1496
5,1,29,1,23,13,1525,711,69,43,53,DENSITE,754,1594
5,1,29,1,23,14,1599,748,23,2,0,_,750,1622
4,1,29,1,24,0,145,755,1441,25,-1,,780,1586
5,1,29,1,24,1,145,755,92,18,95,103265,773,237
5,1,29,1,24,2,253,751,15,33,95,|,784,268
5,1,29,1,24,3,274,757,48,18,96,NOT,775,322
5,1,29,1,24,4,341,757,147,18,96,REGULATED,775,488
5,1,29,1,24,5,507,759,81,16,96,UNDER,775,588
5,1,29,1,24,6,607,759,48,17,96,TDG,776,655
5,1,29,1,24,7,976,759,95,19,95,0.9644,778,1071
5,1,29,1,24,8,1175,760,78,19,96,43999,779,1253
5,1,29,1,24,9,1325,760,77,19,94,42433,779,1402
5,1,29,1,24,10,1426,761,61,18,65,61.4,779,1487
5,1,29,1,24,11,1509,761,77,19,64,910.6,780,1586
4,1,29,1,25,0,142,786,947,23,-1,,809,1089
5,1,29,1,25,1,142,786,96,18,88,MTR271,804,238
5,1,29,1,25,2,252,782,14,32,94,|,814,266
5,1,29,1,25,3,274,788,82,17,95,HEAVY,805,356
5,1,29,1,25,4,373,788,101,17,93,VACUUM,805,474
5,1,29,1,25,5,490,788,98,18,88,GASOIL,806,588
5,1,29,1,25,6,597,788,85,21,85,(HVGO),809,682
5,1,29,1,25,7,972,791,49,16,87,API,807,1021
5,1,29,1,25,8,1043,790,46,17,76,54B,807,1089
4,1,29,1,26,0,456,890,346,75,-1,,965,802
5,1,29,1,26,1,456,920,85,43,92,at.,963,541
5,1,29,1,26,2,615,932,37,10,0,>,942,652
5,1,29,1,26,3,679,925,70,32,10,Le,957,749
5,1,29,1,26,4,754,890,48,70,66,J,960,802
4,1,29,1,27,0,418,970,381,73,-1,,1043,799
5,1,29,1,27,1,418,981,70,60,75,Rac,1041,488
5,1,29,1,27,2,503,981,36,60,66,ke,1041,539
5,1,29,1,27,3,551,985,71,45,52,#93,1030,622
5,1,29,1,27,4,652,970,142,73,21,itor,1043,794
5,1,29,1,27,5,794,1011,5,5,10,.,1016,799
4,1,29,1,28,0,1625,1042,2,8,-1,,1050,1627
5,1,29,1,28,1,1625,1042,2,8,96,|,1050,1627
4,1,29,1,29,0,497,1069,4,8,-1,,1077,501
5,1,29,1,29,1,497,1069,4,8,34,‘,1077,501
4,1,29,1,30,0,414,1055,866,57,-1,,1112,1280
5,1,29,1,30,1,414,1069,107,43,67,Siahe,1112,521
5,1,29,1,30,2,648,1055,117,43,36,10:5,1098,765
5,1,29,1,30,3,1278,1093,2,5,72,|,1098,1280
4,1,29,1,31,0,563,1128,11,11,-1,,1139,574
5,1,29,1,31,1,563,1128,11,11,58,=,1139,574
4,1,29,1,32,0,370,1128,366,61,-1,,1189,736
5,1,29,1,32,1,370,1128,129,61,0,tal,1189,499
5,1,29,1,32,2,519,1133,79,37,45,Fl,1170,598
5,1,29,1,32,3,634,1138,102,35,67,18:20,1173,736
4,1,29,1,33,0,390,1184,368,62,-1,,1246,758
5,1,29,1,33,1,390,1204,107,42,55,"Trike,",1246,497
5,1,29,1,33,2,526,1184,78,52,46,"abl,",1236,604
5,1,29,1,33,3,632,1199,126,36,43,(2:95,1235,758
4,1,29,1,34,0,305,1488,973,24,-1,,1512,1278
5,1,29,1,34,1,305,1488,80,19,96,Total,1507,385
5,1,29,1,34,2,405,1488,96,20,95,Litres,1508,501
5,1,29,1,34,3,520,1489,33,23,96,by,1512,553
5,1,29,1,34,4,572,1489,113,19,96,Product,1508,685
5,1,29,1,34,5,1277,1509,1,3,95,|,1512,1278
4,1,29,1,35,0,274,1519,1126,24,-1,,1543,1400
5,1,29,1,35,1,274,1519,94,19,96,103265,1538,368
5,1,29,1,35,2,470,1521,83,17,96,HEAVY,1538,553
5,1,29,1,35,3,570,1521,101,19,93,VACUUM,1540,671
5,1,29,1,35,4,688,1522,93,18,84,GASOIL,1540,781
5,1,29,1,35,5,794,1521,85,22,84,(HVGO),1543,879
5,1,29,1,35,6,1173,1523,77,19,96,43999,1542,1250
5,1,29,1,35,7,1322,1523,78,19,92,42433,1542,1400
4,1,29,1,36,0,943,1559,1,12,-1,,1571,944
5,1,29,1,36,1,943,1559,1,12,73,|,1571,944
4,1,29,1,37,0,57,1680,1440,44,-1,,1724,1497
5,1,29,1,37,1,57,1680,2,34,83,|,1714,59
5,1,29,1,37,2,71,1697,1,13,96,|,1710,72
5,1,29,1,37,3,80,1697,49,17,93,hereby,1714,129
5,1,29,1,37,4,134,1698,54,13,88,dectare,1711,188
5,1,29,1,37,5,194,1698,26,13,96,that,1711,220
5,1,29,1,37,6,226,1698,22,13,96,the,1711,248
5,1,29,1,37,7,254,1700,61,11,96,contents,1711,315
5,1,29,1,37,8,320,1699,14,13,96,of,1712,334
5,1,29,1,37,9,339,1699,25,13,95,this,1712,364
5,1,29,1,37,10,370,1681,93,38,93,consignment,1719,463
5,1,29,1,37,11,468,1702,23,10,94,are,1712,491
5,1,29,1,37,12,493,1682,32,38,63,fully,1720,525
5,1,29,1,37,13,531,1700,26,13,96,and,1713,557
5,1,29,1,37,14,563,1701,75,15,96,accurately,1716,638
5,1,29,1,37,15,644,1700,71,13,96,described,1713,715
5,1,29,1,37,16,721,1701,44,13,89,above,1714,765
5,1,29,1,37,17,769,1688,18,29,95,by,1717,787
5,1,29,1,37,18,793,1688,22,26,94,the,1714,815
5,1,29,1,37,19,820,1704,48,13,95,proper,1717,868
5,1,29,1,37,20,874,1702,60,16,95,shipping,1718,934
5,1,29,1,37,21,1323,1690,20,1,0,-,1691,1343
5,1,29,1,37,22,1451,1687,46,37,0,—_,1724,1497
4,1,29,1,38,0,57,1715,879,23,-1,,1738,936
5,1,29,1,38,1,57,1715,1,15,93,|,1730,58
5,1,29,1,38,2,70,1720,44,12,93,"name,",1732,114
5,1,29,1,38,3,120,1720,23,10,96,are,1730,143
5,1,29,1,38,4,150,1718,58,16,96,properly,1734,208
5,1,29,1,38,5,214,1718,67,13,29,classified,1731,281
5,1,29,1,38,6,287,1718,26,14,97,and,1732,313
5,1,29,1,38,7,318,1718,75,17,84,packaged.,1735,393
5,1,29,1,38,8,400,1718,35,14,96,have,1732,435
5,1,29,1,38,9,440,1718,77,18,96,dangerous,1736,517
5,1,29,1,38,10,524,1720,43,16,96,goods,1736,567
5,1,29,1,38,11,574,1720,43,16,95,safety,1736,617
5,1,29,1,38,12,623,1720,44,13,96,marks,1733,667
5,1,29,1,38,13,672,1720,59,17,73,properly,1737,731
5,1,29,1,38,14,738,1720,47,14,96,affixed,1734,785
5,1,29,1,38,15,791,1724,14,10,87,or,1734,805
5,1,29,1,38,16,810,1720,70,18,96,displayed,1738,880
5,1,29,1,38,17,886,1724,17,10,96,on,1734,903
5,1,29,1,38,18,909,1722,27,12,50,thee,1734,936
4,1,29,1,39,0,57,1737,1525,26,-1,,1763,1582
5,1,29,1,39,1,57,1742,1,15,73,|,1757,58
5,1,29,1,39,2,70,1737,26,13,73,and,1750,96
5,1,29,1,39,3,102,1740,23,10,96,are,1750,125
5,1,29,1,39,4,131,1738,11,12,96,in,1750,142
5,1,29,1,39,5,148,1737,15,13,96,all,1750,163
5,1,29,1,39,6,170,1739,61,15,96,respects,1754,231
5,1,29,1,39,7,237,1738,11,12,96,in,1750,248
5,1,29,1,39,8,254,1741,47,13,94,proper,1754,301
5,1,29,1,39,9,307,1738,64,13,96,condition,1751,371
5,1,29,1,39,10,378,1739,19,13,96,for,1752,397
5,1,29,1,39,11,402,1739,65,16,96,transport,1755,467
5,1,29,1,39,12,472,1739,70,17,91,according,1756,542
5,1,29,1,39,13,549,1741,12,11,81,to,1752,561
5,1,29,1,39,14,567,1740,22,12,95,the,1752,589
5,1,29,1,39,15,594,1739,107,17,69,Transportation,1756,701
5,1,29,1,39,16,706,1740,13,13,96,of,1753,719
5,1,29,1,39,17,726,1740,79,16,96,Dangerous,1756,805
5,1,29,1,39,18,811,1740,48,14,96,Goods,1754,859
5,1,29,1,39,19,866,1741,46,16,38,Regu,1757,912
5,1,29,1,39,20,990,1744,49,16,11,TiIMEIN,1760,1039
5,1,29,1,39,21,1120,1745,8,1,29,~,1746,1128
5,1,29,1,39,22,1131,1745,46,15,29,START,1760,1177
5,1,29,1,39,23,1182,1749,59,12,96,LOADING,1761,1241
5,1,29,1,39,24,1297,1746,70,16,55,FINISH,1762,1367
5,1,29,1,39,25,1373,1750,60,12,93,LOADING,1762,1433
5,1,29,1,39,26,1499,1749,1,14,75,|,1763,1500
5,1,29,1,39,27,1517,1751,32,11,60,TIME,1762,1549
5,1,29,1,39,28,1554,1751,28,11,95,OUT,1762,1582
4,1,29,1,40,0,139,1763,1439,20,-1,,1783,1578
5,1,29,1,40,1,139,1763,115,19,96,Yannick,1782,254
5,1,29,1,40,2,270,1763,115,20,96,Mercier,1783,385
5,1,29,1,40,3,990,1763,60,11,39,ARQIVEE,1774,1050
5,1,29,1,40,4,1101,1763,70,11,92,DEBUT,1774,1171
5,1,29,1,40,5,1154,1759,18,23,88,DU,1782,1172
5,1,29,1,40,6,1176,1763,97,11,80,CHARGEMENT,1774,1273
5,1,29,1,40,7,1312,1764,21,11,93,FIN,1775,1333
5,1,29,1,40,8,1342,1764,15,11,86,OU,1775,1357
5,1,29,1,40,9,1365,1764,95,12,86,CHARGEMENT,1776,1460
5,1,29,1,40,10,1523,1765,55,11,90,DEPART,1776,1578
4,1,29,1,41,0,57,1777,1525,54,-1,,1831,1582
5,1,29,1,41,1,57,1795,1,10,76,|,1805,58
5,1,29,1,41,2,153,1798,202,22,52,Shipper,1820,355
5,1,29,1,41,3,217,1791,34,33,95,name,1824,251
5,1,29,1,41,4,259,1798,53,22,95,(please,1820,312
5,1,29,1,41,5,319,1791,42,33,52,print),1824,361
5,1,29,1,41,6,973,1797,77,18,0,O6¥:10,1815,1050
5,1,29,1,41,7,1081,1777,2,51,64,|,1828,1083
5,1,29,1,41,8,1139,1798,79,18,94,05:18,1816,1218
5,1,29,1,41,9,1339,1799,77,18,95,05:42,1817,1416
5,1,29,1,41,10,1498,1799,84,32,40,[05:42,1831,1582
4,1,29,1,42,0,57,1822,1509,25,-1,,1847,1566
5,1,29,1,42,1,57,1822,74,19,72,DRIVER,1841,131
5,1,29,1,42,2,138,1824,363,18,0,NAME-NOMDUGONDUGTEUR—S—=~S~S*,1842,501
5,1,29,1,42,3,908,1835,5,4,26,Bt,1839,913
5,1,29,1,42,4,937,1822,14,33,42,A,1855,951
5,1,29,1,42,5,985,1832,55,13,42,QRATURE,1845,1040
5,1,29,1,42,6,1047,1832,21,13,91,DU,1845,1068
5,1,29,1,42,7,1075,1832,117,14,80,CONDUCTEUR,1846,1192
5,1,29,1,42,8,1278,1825,52,31,96,TOTAL,1856,1330
5,1,29,1,42,9,1338,1829,79,18,93,QUANTITY,1847,1417
5,1,29,1,42,10,1426,1840,4,3,91,-,1843,1430
5,1,29,1,42,11,1436,1829,60,18,93,"QUANT,",1847,1496
5,1,29,1,42,12,1503,1834,63,13,92,TOTALE,1847,1566
4,1,29,1,43,0,1322,1859,211,19,-1,,1878,1533
5,1,29,1,43,1,1322,1859,77,19,80,43999,1878,1399
5,1,29,1,43,2,1436,1859,97,19,80,Litres,1878,1533
4,1,29,1,44,0,140,1886,1274,22,-1,,1908,1414
5,1,29,1,44,1,140,1886,81,18,78,SIMON,1904,221
5,1,29,1,44,2,272,1887,81,17,90,JOBIN,1904,353
5,1,29,1,44,3,1288,1890,78,18,57,38639,1908,1366
5,1,29,1,44,4,1387,1890,27,18,57,kg,1908,1414
2,1,30,0,0,0,1615,146,26,1764,-1,,1910,1641
3,1,30,1,0,0,1615,146,26,1764,-1,,1910,1641
4,1,30,1,1,0,1615,146,26,1764,-1,,1910,1641
5,1,30,1,1,1,1615,146,26,1764,95, ,1910,1641
2,1,31,0,0,0,1414,1887,216,28,-1,,1915,1630
3,1,31,1,0,0,1414,1887,216,28,-1,,1915,1630
4,1,31,1,1,0,1414,1887,216,28,-1,,1915,1630
5,1,31,1,1,1,1414,1887,216,25,95,  ,1912,1630
5,1,31,1,1,2,1598,1912,32,3,95,  ,1915,1630
2,1,32,0,0,0,353,1877,1277,59,-1,,1936,1630
3,1,32,1,0,0,353,1877,1277,59,-1,,1936,1630
4,1,32,1,1,0,564,1877,361,28,-1,,1905,925
5,1,32,1,1,1,564,1877,361,28,95, ,1905,925
4,1,32,1,2,0,353,1905,1277,31,-1,,1936,1630
5,1,32,1,2,1,353,1905,935,8,95,   ,1913,1288
5,1,32,1,2,2,1602,1915,28,21,95,     ,1936,1630
2,1,33,0,0,0,1482,1916,2,20,-1,,1936,1484
3,1,33,1,0,0,1482,1916,2,20,-1,,1936,1484
4,1,33,1,1,0,1482,1916,2,20,-1,,1936,1484
5,1,33,1,1,1,1482,1916,2,20,95,    ,1936,1484
2,1,34,0,0,0,221,1905,1067,73,-1,,1978,1288
3,1,34,1,0,0,221,1905,1067,73,-1,,1978,1288
4,1,34,1,1,0,221,1905,1067,34,-1,,1939,1288
5,1,34,1,1,1,221,1905,51,6,95, ,1911,272
5,1,34,1,1,2,694,1913,594,26,95,        ,1939,1288
4,1,34,1,2,0,693,1945,259,22,-1,,1967,952
5,1,34,1,2,1,693,1945,259,22,95,       ,1967,952
4,1,34,1,3,0,692,1967,262,11,-1,,1978,954
5,1,34,1,3,1,692,1967,262,11,95,  ,1978,954
2,1,35,0,0,0,463,1912,607,22,-1,,1934,1070
3,1,35,1,0,0,463,1912,607,22,-1,,1934,1070
4,1,35,1,1,0,463,1912,607,22,-1,,1934,1070
5,1,35,1,1,1,463,1912,19,22,95,   ,1934,482
5,1,35,1,1,2,593,1912,17,1,95, ,1913,610
5,1,35,1,1,3,1063,1916,7,18,95,  ,1934,1070
2,1,36,0,0,0,146,1913,464,21,-1,,1934,610
3,1,36,1,0,0,146,1913,464,21,-1,,1934,610
4,1,36,1,1,0,146,1913,464,21,-1,,1934,610
5,1,36,1,1,1,146,1913,26,21,95,  ,1934,172
5,1,36,1,1,2,593,1913,17,21,95,  ,1934,610
2,1,37,0,0,0,1070,1921,532,50,-1,,1971,1602
3,1,37,1,0,0,1070,1921,532,50,-1,,1971,1602
4,1,37,1,1,0,1070,1921,532,12,-1,,1933,1602
5,1,37,1,1,1,1070,1921,49,11,96,WATER,1932,1119
5,1,37,1,1,2,1125,1921,21,11,64,DIP),1932,1146
5,1,37,1,1,3,1157,1921,56,11,96,BEFORE,1932,1213
5,1,37,1,1,4,1219,1921,29,11,87,DIPS,1932,1248
5,1,37,1,1,5,1257,1913,10,28,89,|,1941,1267
5,1,37,1,1,6,1273,1921,56,11,73,BEFORE,1932,1329
5,1,37,1,1,7,1334,1921,50,11,73,INVENT,1932,1384
5,1,37,1,1,8,1388,1913,7,28,96,|,1941,1395
5,1,37,1,1,9,1400,1921,45,11,96,AFTER,1932,1445
5,1,37,1,1,10,1450,1921,31,11,26,DIPS),1932,1481
5,1,37,1,1,11,1496,1921,49,11,93,ENDING,1932,1545
5,1,37,1,1,12,1553,1922,49,11,93,INVENT,1933,1602
4,1,37,1,2,0,1167,1937,423,13,-1,,1950,1590
5,1,37,1,2,1,1167,1937,47,11,96,AVANT,1948,1214
5,1,37,1,2,2,1219,1937,14,11,96,LE,1948,1233
5,1,37,1,2,3,1287,1937,82,12,59,INVENTAIRE,1949,1369
5,1,37,1,2,4,1383,1931,15,28,58,=|,1959,1398
5,1,37,1,2,5,1406,1937,66,13,91,APRESLE,1950,1472
5,1,37,1,2,6,1481,1931,15,28,23,|,1959,1496
5,1,37,1,2,7,1509,1938,81,12,61,INVENTAIRE,1950,1590
4,1,37,1,3,0,1165,1953,403,18,-1,,1971,1568
5,1,37,1,3,1,1165,1953,74,12,71,JAUGEAGE,1965,1239
5,1,37,1,3,2,1292,1954,75,17,78,JAUGEAGE,1971,1367
5,1,37,1,3,3,1383,1947,15,28,53,|,1975,1398
5,1,37,1,3,4,1400,1955,75,11,19,JAUGEAGE.,1966,1475
5,1,37,1,3,5,1522,1955,46,11,55,APRES,1966,1568
2,1,38,0,0,0,953,1920,188,50,-1,,1970,1141
3,1,38,1,0,0,953,1920,188,50,-1,,1970,1141
4,1,38,1,1,0,953,1920,110,11,-1,,1931,1063
5,1,38,1,1,1,953,1920,36,11,91,TANK,1931,989
5,1,38,1,1,2,995,1920,68,11,87,CAPACITY|,1931,1063
4,1,38,1,2,0,957,1936,184,12,-1,,1948,1141
5,1,38,1,2,1,957,1936,96,12,74,CONTENANCE,1948,1053
5,1,38,1,2,2,1060,1929,10,28,95,|,1957,1070
5,1,38,1,2,3,1073,1937,68,11,95,MEASURE,1948,1141
4,1,38,1,3,0,954,1953,168,17,-1,,1970,1122
5,1,38,1,3,1,954,1953,104,17,90,DURESERVIOR,1970,1058
5,1,38,1,3,2,1063,1945,8,29,67,|,1974,1071
5,1,38,1,3,3,1085,1953,37,11,67,DEAU,1964,1122
2,1,39,0,0,0,78,1916,620,39,-1,,1955,698
3,1,39,1,0,0,78,1916,620,30,-1,,1946,698
4,1,39,1,1,0,78,1916,620,14,-1,,1930,698
5,1,39,1,1,1,78,1916,68,12,93,PRODUCT,1928,146
5,1,39,1,1,2,158,1909,12,28,66,|,1937,170
5,1,39,1,1,3,172,1917,36,11,91,TANK,1928,208
5,1,39,1,1,4,212,1917,69,11,7,CAPACITY],1928,281
5,1,39,1,1,5,288,1917,49,11,91,WATER,1928,337
5,1,39,1,1,6,342,1917,21,11,89,DIP|,1928,363
5,1,39,1,1,7,372,1917,55,11,95,BEFORE,1928,427
5,1,39,1,1,8,432,1917,31,12,0,"DIPS,",1929,463
5,1,39,1,1,9,610,1918,1,3,84,|,1921,611
5,1,39,1,1,10,617,1919,44,11,88,AFTER,1930,661
5,1,39,1,1,11,667,1919,31,11,46,OlPS|,1930,698
4,1,39,1,2,0,81,1927,608,28,-1,,1955,689
5,1,39,1,2,1,81,1932,61,12,85,PRODUIT,1944,142
5,1,39,1,2,2,161,1926,10,28,89,|,1954,171
5,1,39,1,2,3,174,1933,97,11,82,CONTENANGE,1944,271
5,1,39,1,2,4,280,1926,10,28,92,|,1954,290
5,1,39,1,2,5,291,1933,67,12,88,MEASURE,1945,358
5,1,39,1,2,6,366,1926,5,28,88,|,1954,371
5,1,39,1,2,7,382,1934,45,11,66,AVANT,1945,427
5,1,39,1,2,8,432,1934,15,12,66,LE,1946,447
5,1,39,1,2,9,496,1927,81,28,74,INVENTAIRE,1955,577
5,1,39,1,2,10,622,1935,47,11,90,APRES,1946,669
5,1,39,1,2,11,674,1935,15,11,95,LE,1946,689
2,1,40,0,0,0,172,1949,520,22,-1,,1971,692
3,1,40,1,0,0,172,1949,520,22,-1,,1971,692
4,1,40,1,1,0,172,1949,520,22,-1,,1971,692
5,1,40,1,1,1,172,1949,107,18,84,DURESERVIOR,1967,279
5,1,40,1,1,2,290,1966,2,1,78,|,1967,292
5,1,40,1,1,3,297,1951,42,16,78,DEAU,1967,339
5,1,40,1,1,4,354,1943,17,28,71,|,1971,371
5,1,40,1,1,5,378,1951,75,11,82,JAUGEAGE,1962,453
5,1,40,1,1,6,500,1951,75,11,48,JAUGEAGE,1962,575
5,1,40,1,1,7,609,1965,4,6,46,|,1971,613
5,1,40,1,1,8,617,1951,75,12,87,JAUGEAGE,1963,692
2,1,41,0,0,0,482,1918,111,12,-1,,1930,593
3,1,41,1,0,0,482,1918,111,12,-1,,1930,593
4,1,41,1,1,0,482,1918,111,12,-1,,1930,593
5,1,41,1,1,1,482,1918,55,11,92,BEFORE,1929,537
5,1,41,1,1,2,542,1919,51,11,87,INVENT,1930,593
2,1,42,0,0,0,1568,1936,62,35,-1,,1971,1630
3,1,42,1,0,0,1568,1936,62,35,-1,,1971,1630
4,1,42,1,1,0,1617,1936,13,19,-1,,1955,1630
5,1,42,1,1,1,1617,1936,13,19,95,        ,1955,1630
4,1,42,1,2,0,1568,1955,62,16,-1,,1971,1630
5,1,42,1,2,1,1568,1955,62,16,95,   ,1971,1630
2,1,43,0,0,0,1387,1937,13,34,-1,,1971,1400
3,1,43,1,0,0,1387,1937,13,34,-1,,1971,1400
4,1,43,1,1,0,1388,1937,11,18,-1,,1955,1399
5,1,43,1,1,1,1388,1937,11,18,95,       ,1955,1399
4,1,43,1,2,0,1387,1955,13,16,-1,,1971,1400
5,1,43,1,2,1,1387,1955,13,16,95,   ,1971,1400
2,1,44,0,0,0,1143,1937,12,34,-1,,1971,1155
3,1,44,1,0,0,1143,1937,12,34,-1,,1971,1155
4,1,44,1,1,0,1143,1937,12,18,-1,,1955,1155
5,1,44,1,1,1,1143,1937,12,18,95,       ,1955,1155
4,1,44,1,2,0,1143,1955,12,16,-1,,1971,1155
5,1,44,1,2,1,1143,1955,12,16,95,   ,1971,1155
2,1,45,0,0,0,339,1935,37,41,-1,,1976,376
3,1,45,1,0,0,339,1935,37,41,-1,,1976,376
4,1,45,1,1,0,360,1935,15,21,-1,,1956,375
5,1,45,1,1,1,360,1935,15,21,95,         ,1956,375
4,1,45,1,2,0,339,1956,37,20,-1,,1976,376
5,1,45,1,2,1,339,1956,37,20,95,  ,1976,376
2,1,46,0,0,0,1475,1966,47,6,-1,,1972,1522
3,1,46,1,0,0,1475,1966,47,6,-1,,1972,1522
4,1,46,1,1,0,1475,1966,47,6,-1,,1972,1522
5,1,46,1,1,1,1475,1966,47,6,95, ,1972,1522
2,1,47,0,0,0,182,1958,1436,21,-1,,1979,1618
3,1,47,1,0,0,182,1958,1436,21,-1,,1979,1618
4,1,47,1,1,0,182,1958,1436,21,-1,,1979,1618
5,1,47,1,1,1,182,1958,1436,21,95, ,1979,1618
2,1,48,0,0,0,50,1978,1580,185,-1,,2163,1630
3,1,48,1,0,0,50,1978,1580,185,-1,,2163,1630
4,1,48,1,1,0,50,1978,1580,185,-1,,2163,1630
5,1,48,1,1,1,50,1978,1580,185,95,    ,2163,1630
2,1,49,0,0,0,1237,2029,331,7,-1,,2036,1568
3,1,49,1,0,0,1237,2029,331,7,-1,,2036,1568
4,1,49,1,1,0,1237,2029,331,7,-1,,2036,1568
5,1,49,1,1,1,1237,2029,331,7,95, ,2036,1568
2,1,50,0,0,0,622,2023,946,16,-1,,2039,1568
3,1,50,1,0,0,622,2023,946,16,-1,,2039,1568
4,1,50,1,1,0,622,2023,946,16,-1,,2039,1568
5,1,50,1,1,1,622,2023,946,16,95, ,2039,1568
2,1,51,0,0,0,69,2025,391,6,-1,,2031,460
3,1,51,1,0,0,69,2025,391,6,-1,,2031,460
4,1,51,1,1,0,69,2025,391,6,-1,,2031,460
5,1,51,1,1,1,69,2025,391,6,95, ,2031,460
2,1,52,0,0,0,1146,2090,475,9,-1,,2099,1621
3,1,52,1,0,0,1146,2090,475,9,-1,,2099,1621
4,1,52,1,1,0,1146,2090,475,9,-1,,2099,1621
5,1,52,1,1,1,1146,2090,475,9,95, ,2099,1621
2,1,53,0,0,0,210,2086,782,11,-1,,2097,992
3,1,53,1,0,0,210,2086,782,11,-1,,2097,992
4,1,53,1,1,0,210,2086,782,11,-1,,2097,992
5,1,53,1,1,1,210,2086,782,11,95, ,2097,992
2,1,54,0,0,0,1481,1917,4,209,-1,,2126,1485
3,1,54,1,0,0,1481,1917,4,209,-1,,2126,1485
4,1,54,1,1,0,1481,1917,4,209,-1,,2126,1485
5,1,54,1,1,1,1481,1917,4,209,95, ,2126,1485
2,1,55,0,0,0,1258,1917,5,234,-1,,2151,1263
3,1,55,1,0,0,1258,1917,5,234,-1,,2151,1263
4,1,55,1,1,0,1258,1917,5,234,-1,,2151,1263
5,1,55,1,1,1,1258,1917,5,234,95, ,2151,1263
2,1,56,0,0,0,1063,1914,5,239,-1,,2153,1068
3,1,56,1,0,0,1063,1914,5,239,-1,,2153,1068
4,1,56,1,1,0,1063,1914,5,239,-1,,2153,1068
5,1,56,1,1,1,1063,1914,5,239,95, ,2153,1068
2,1,57,0,0,0,463,1912,6,238,-1,,2150,469
3,1,57,1,0,0,463,1912,6,238,-1,,2150,469
4,1,57,1,1,0,463,1912,6,238,-1,,2150,469
5,1,57,1,1,1,463,1912,6,238,95,,2150,469
