level,page_num,block_num,par_num,line_num,word_num,left,top,width,height,conf,text,bottom,right
1,1,0,0,0,0,0,0,1700,2200,-1,,2200,1700
2,1,1,0,0,0,799,24,228,50,-1,,74,1027
3,1,1,1,0,0,799,24,228,50,-1,,74,1027
4,1,1,1,1,0,799,24,228,50,-1,,74,1027
5,1,1,1,1,1,799,24,228,50,0,Q4oJowo,74,1027
2,1,2,0,0,0,908,79,612,23,-1,,102,1520
3,1,2,1,0,0,908,79,612,23,-1,,102,1520
4,1,2,1,1,0,908,79,612,23,-1,,102,1520
5,1,2,1,1,1,908,79,117,22,96,VEHICLE,101,1025
5,1,2,1,1,2,1036,80,122,22,96,LOADING,102,1158
5,1,2,1,1,3,1169,81,114,21,93,REPORT,102,1283
5,1,2,1,1,4,1292,93,8,3,91,-,96,1300
5,1,2,1,1,5,1310,81,54,21,95,BILL,102,1364
5,1,2,1,1,6,1374,81,35,21,93,OF,102,1409
5,1,2,1,1,7,1420,81,100,21,92,LADING,102,1520
2,1,3,0,0,0,63,125,1567,13,-1,,138,1630
3,1,3,1,0,0,63,125,1567,13,-1,,138,1630
4,1,3,1,1,0,63,125,1567,13,-1,,138,1630
5,1,3,1,1,1,63,125,1567,13,95, ,138,1630
2,1,4,0,0,0,475,131,3,97,-1,,228,478
3,1,4,1,0,0,475,131,3,97,-1,,228,478
4,1,4,1,1,0,475,131,3,97,-1,,228,478
5,1,4,1,1,1,475,131,3,97,95, ,228,478
2,1,5,0,0,0,62,223,633,6,-1,,229,695
3,1,5,1,0,0,62,223,633,6,-1,,229,695
4,1,5,1,1,0,62,223,633,6,-1,,229,695
5,1,5,1,1,1,62,223,633,6,95, ,229,695
2,1,6,0,0,0,670,227,1,62,-1,,289,671
3,1,6,1,0,0,670,227,1,62,-1,,289,671
4,1,6,1,1,0,670,227,1,62,-1,,289,671
5,1,6,1,1,1,670,227,1,62,95, ,289,671
2,1,7,0,0,0,676,289,179,102,-1,,391,855
3,1,7,1,0,0,676,289,179,102,-1,,391,855
4,1,7,1,1,0,676,289,179,102,-1,,391,855
5,1,7,1,1,1,676,289,179,102,95, ,391,855
2,1,8,0,0,0,752,132,4,99,-1,,231,756
3,1,8,1,0,0,752,132,4,99,-1,,231,756
4,1,8,1,1,0,752,132,4,99,-1,,231,756
5,1,8,1,1,1,752,132,4,99,95, ,231,756
2,1,9,0,0,0,818,226,808,6,-1,,232,1626
3,1,9,1,0,0,818,226,808,6,-1,,232,1626
4,1,9,1,1,0,818,226,808,6,-1,,232,1626
5,1,9,1,1,1,818,226,808,6,95, ,232,1626
2,1,10,0,0,0,310,399,541,5,-1,,404,851
3,1,10,1,0,0,310,399,541,5,-1,,404,851
4,1,10,1,1,0,310,399,541,5,-1,,404,851
5,1,10,1,1,1,310,399,541,5,95, ,404,851
2,1,11,0,0,0,1448,229,1,63,-1,,292,1449
3,1,11,1,0,0,1448,229,1,63,-1,,292,1449
4,1,11,1,1,0,1448,229,1,63,-1,,292,1449
5,1,11,1,1,1,1448,229,1,63,95, ,292,1449
2,1,12,0,0,0,1448,291,181,1,-1,,292,1629
3,1,12,1,0,0,1448,291,181,1,-1,,292,1629
4,1,12,1,1,0,1448,291,181,1,-1,,292,1629
5,1,12,1,1,1,1448,291,181,1,95, ,292,1629
2,1,13,0,0,0,61,464,1565,12,-1,,476,1626
3,1,13,1,0,0,61,464,1565,12,-1,,476,1626
4,1,13,1,1,0,61,464,1565,12,-1,,476,1626
5,1,13,1,1,1,61,464,1565,12,95, ,476,1626
2,1,14,0,0,0,475,585,237,3,-1,,588,712
3,1,14,1,0,0,475,585,237,3,-1,,588,712
4,1,14,1,1,0,475,585,237,3,-1,,588,712
5,1,14,1,1,1,475,585,237,3,95, ,588,712
2,1,15,0,0,0,475,586,1,80,-1,,666,476
3,1,15,1,0,0,475,586,1,80,-1,,666,476
4,1,15,1,1,0,475,586,1,80,-1,,666,476
5,1,15,1,1,1,475,586,1,80,95, ,666,476
2,1,16,0,0,0,711,469,1,195,-1,,664,712
3,1,16,1,0,0,711,469,1,195,-1,,664,712
4,1,16,1,1,0,711,469,1,195,-1,,664,712
5,1,16,1,1,1,711,469,1,195,95, ,664,712
2,1,17,0,0,0,1099,471,2,197,-1,,668,1101
3,1,17,1,0,0,1099,471,2,197,-1,,668,1101
4,1,17,1,1,0,1099,471,2,197,-1,,668,1101
5,1,17,1,1,1,1099,471,2,197,95, ,668,1101
2,1,18,0,0,0,64,659,1564,12,-1,,671,1628
3,1,18,1,0,0,64,659,1564,12,-1,,671,1628
4,1,18,1,1,0,64,659,1564,12,-1,,671,1628
5,1,18,1,1,1,64,659,1564,12,95, ,671,1628
2,1,19,0,0,0,64,730,1564,11,-1,,741,1628
3,1,19,1,0,0,64,730,1564,11,-1,,741,1628
4,1,19,1,1,0,64,730,1564,11,-1,,741,1628
5,1,19,1,1,1,64,730,1564,11,95, ,741,1628
2,1,20,0,0,0,252,663,5,1069,-1,,1732,257
3,1,20,1,0,0,252,663,5,1069,-1,,1732,257
4,1,20,1,1,0,252,663,5,1069,-1,,1732,257
5,1,20,1,1,1,252,663,5,1069,95, ,1732,257
2,1,21,0,0,0,931,666,4,1054,-1,,1720,935
3,1,21,1,0,0,931,666,4,1054,-1,,1720,935
4,1,21,1,1,0,931,666,4,1054,-1,,1720,935
5,1,21,1,1,1,931,666,4,1054,95, ,1720,935
2,1,22,0,0,0,1278,667,5,1065,-1,,1732,1283
3,1,22,1,0,0,1278,667,5,1065,-1,,1732,1283
4,1,22,1,1,0,1278,667,5,1065,-1,,1732,1283
5,1,22,1,1,1,1278,667,5,1065,95, ,1732,1283
2,1,23,0,0,0,1124,673,6,1064,-1,,1737,1130
3,1,23,1,0,0,1124,673,6,1064,-1,,1737,1130
4,1,23,1,1,0,1124,673,6,1064,-1,,1737,1130
5,1,23,1,1,1,1124,673,6,1064,95, ,1737,1130
2,1,24,0,0,0,1431,667,5,1072,-1,,1739,1436
3,1,24,1,0,0,1431,667,5,1072,-1,,1739,1436
4,1,24,1,1,0,1431,667,5,1072,-1,,1739,1436
5,1,24,1,1,1,1431,667,5,1072,95, ,1739,1436
2,1,25,0,0,0,1513,739,7,1000,-1,,1739,1520
3,1,25,1,0,0,1513,739,7,1000,-1,,1739,1520
4,1,25,1,1,0,1513,739,7,1000,-1,,1739,1520
5,1,25,1,1,1,1513,739,7,1000,95, ,1739,1520
2,1,26,0,0,0,60,1729,1567,12,-1,,1741,1627
3,1,26,1,0,0,60,1729,1567,12,-1,,1741,1627
4,1,26,1,1,0,60,1729,1567,12,-1,,1741,1627
5,1,26,1,1,1,60,1729,1567,12,95, ,1741,1627
2,1,27,0,0,0,999,1735,4,85,-1,,1820,1003
3,1,27,1,0,0,999,1735,4,85,-1,,1820,1003
4,1,27,1,1,0,999,1735,4,85,-1,,1820,1003
5,1,27,1,1,1,999,1735,4,85,95, ,1820,1003
2,1,28,0,0,0,1208,1736,4,86,-1,,1822,1212
3,1,28,1,0,0,1208,1736,4,86,-1,,1822,1212
4,1,28,1,1,0,1208,1736,4,86,-1,,1822,1212
5,1,28,1,1,1,1208,1736,4,86,95, ,1822,1212
2,1,29,0,0,0,80,1813,1547,11,-1,,1824,1627
3,1,29,1,0,0,80,1813,1547,11,-1,,1824,1627
4,1,29,1,1,0,80,1813,1547,11,-1,,1824,1627
5,1,29,1,1,1,80,1813,1547,11,95, ,1824,1627
2,1,30,0,0,0,73,107,1552,1794,-1,,1901,1625
3,1,30,1,0,0,73,107,1552,1794,-1,,1901,1625
4,1,30,1,1,0,111,107,1514,24,-1,,131,1625
5,1,30,1,1,1,111,129,5,1,79,_,130,116
5,1,30,1,1,2,146,108,74,23,92,Page:,131,220
5,1,30,1,1,3,245,107,12,19,96,1,126,257
5,1,30,1,1,4,477,109,45,19,96,530,128,522
5,1,30,1,1,5,812,107,133,21,95,RAPPORT,128,945
5,1,30,1,1,6,954,107,35,21,91,DE,128,989
5,1,30,1,1,7,1000,108,213,21,91,CHARGEMENT,129,1213
5,1,30,1,1,8,1198,103,15,36,89,-,139,1213
5,1,30,1,1,9,1222,109,137,20,91,VEHICULE,129,1359
5,1,30,1,1,10,1369,121,7,3,91,-,124,1376
5,1,30,1,1,11,1386,109,239,20,91,CONNAISSEMENT,129,1625
4,1,30,1,2,0,134,134,535,25,-1,,159,669
5,1,30,1,2,1,134,136,110,15,65,DOCUMENT,151,244
5,1,30,1,2,2,250,137,82,15,65,NUMBER,152,332
5,1,30,1,2,3,360,138,62,18,87,1655,156,422
5,1,30,1,2,4,533,130,33,40,1,DBPL,170,566
5,1,30,1,2,5,561,134,108,25,0,DERBEDITION,159,669
4,1,30,1,3,0,133,155,173,16,-1,,171,306
5,1,30,1,3,1,133,155,12,14,96,No,169,145
5,1,30,1,3,2,164,156,24,14,96,DU,170,188
5,1,30,1,3,3,197,156,109,15,96,DOCUMENT,171,306
4,1,30,1,4,0,147,159,1460,42,-1,,201,1607
5,1,30,1,4,1,147,159,9,11,92,Â°,170,156
5,1,30,1,4,2,520,164,137,37,92,mm/dd/yy,201,657
5,1,30,1,4,3,767,178,3,6,4,*,184,770
5,1,30,1,4,4,796,171,119,21,88,24HOUR,192,915
5,1,30,1,4,5,926,172,117,21,96,NUMBER,193,1043
5,1,30,1,4,6,1064,170,69,21,0,(403),191,1133
5,1,30,1,4,7,1143,170,129,19,0,296-3000,189,1272
5,1,30,1,4,8,1309,173,137,21,80,-NUMERO,194,1446
5,1,30,1,4,9,1456,173,28,20,96,24,193,1484
5,1,30,1,4,10,1496,173,111,21,96,HEURES,194,1607
4,1,30,1,5,0,146,196,1224,27,-1,,223,1370
5,1,30,1,5,1,146,196,110,19,95,0114749,215,256
5,1,30,1,5,2,278,197,93,20,96,10/002,217,371
5,1,30,1,5,3,526,198,129,20,96,10/07/24,218,655
5,1,30,1,5,4,1047,202,233,21,93,COLLECT,223,1280
5,1,30,1,5,5,1179,198,14,32,91,-,230,1193
5,1,30,1,5,6,1205,202,75,21,91,FRAIS,223,1280
5,1,30,1,5,7,1289,203,81,20,91,VIRES,223,1370
4,1,30,1,6,0,75,227,1536,29,-1,,256,1611
5,1,30,1,6,1,75,229,197,14,90,CONSIGNEE/CUSTOMER,243,272
5,1,30,1,6,2,278,237,4,2,92,-,239,282
5,1,30,1,6,3,288,229,183,15,87,DESTINATAIRE/CLIENT,244,471
5,1,30,1,6,4,685,223,69,35,4,ROR,258,754
5,1,30,1,6,5,768,223,67,35,0,Seeieir,258,835
5,1,30,1,6,6,847,223,12,35,88,|,258,859
5,1,30,1,6,7,860,231,103,15,89,CONSIGNOR,246,963
5,1,30,1,6,8,968,239,5,3,89,-,242,973
5,1,30,1,6,9,978,232,105,14,92,EXPEDITEUR,246,1083
5,1,30,1,6,10,1463,225,52,35,11,RT,260,1515
5,1,30,1,6,11,1561,225,50,35,22,chr,260,1611
4,1,30,1,7,0,143,257,1426,27,-1,,284,1569
5,1,30,1,7,1,143,257,181,25,96,Mississauga,282,324
5,1,30,1,7,2,342,259,80,19,95,Lubes,278,422
5,1,30,1,7,3,442,260,98,18,96,Center,278,540
5,1,30,1,7,4,676,259,161,20,96,0000081523,279,837
5,1,30,1,7,5,856,259,184,25,90,Mississauga,284,1040
5,1,30,1,7,6,1058,261,80,19,96,Lubes,280,1138
5,1,30,1,7,7,1158,263,99,17,96,Center,280,1257
5,1,30,1,7,8,1459,263,110,19,96,0081523,282,1569
4,1,30,1,8,0,145,289,1012,22,-1,,311,1157
5,1,30,1,8,1,145,289,45,19,96,385,308,190
5,1,30,1,8,2,211,289,146,19,96,Southdown,308,357
5,1,30,1,8,3,375,289,65,19,96,Road,308,440
5,1,30,1,8,4,859,291,45,19,96,385,310,904
5,1,30,1,8,5,926,291,147,20,96,Southdown,311,1073
5,1,30,1,8,6,1091,292,66,19,96,Road,311,1157
4,1,30,1,9,0,143,318,1061,28,-1,,346,1204
5,1,30,1,9,1,143,318,175,25,91,"Missisauga,",343,318
5,1,30,1,9,2,343,321,31,19,93,ON,340,374
5,1,30,1,9,3,392,321,95,19,52,L5d2Y2,340,487
5,1,30,1,9,4,856,321,177,25,92,"Missisauga,",346,1033
5,1,30,1,9,5,1058,324,32,18,93,ON,342,1090
5,1,30,1,9,6,1108,323,96,19,45,L5J2Y2,342,1204
4,1,30,1,10,0,1461,366,48,25,-1,,391,1509
5,1,30,1,10,1,1461,366,48,25,18,~~,391,1509
4,1,30,1,11,0,276,403,567,15,-1,,418,843
5,1,30,1,11,1,276,403,62,11,93,RELEASE,414,338
5,1,30,1,11,2,343,403,48,15,92,(C-of-A),418,391
5,1,30,1,11,3,396,403,59,12,95,NUMBER,415,455
5,1,30,1,11,4,566,404,79,12,94,CUSTOMER,416,645
5,1,30,1,11,5,650,405,75,11,96,PURCHASE,416,725
5,1,30,1,11,6,730,405,49,11,96,ORDER,416,779
5,1,30,1,11,7,784,405,59,11,90,NUMBER,416,843
4,1,30,1,12,0,616,418,191,12,-1,,430,807
5,1,30,1,12,1,616,418,17,11,96,No,429,633
5,1,30,1,12,2,638,419,17,11,96,DE,430,655
5,1,30,1,12,3,660,419,69,11,96,DEMANDE,430,729
5,1,30,1,12,4,734,418,19,12,96,DU,430,753
5,1,30,1,12,5,758,419,49,11,94,CLIENT,430,807
4,1,30,1,13,0,74,469,1339,23,-1,,492,1413
5,1,30,1,13,1,74,477,74,13,93,CARRIER,490,148
5,1,30,1,13,2,153,484,5,3,92,-,487,158
5,1,30,1,13,3,162,478,137,13,92,TRANSPORTEUR,491,299
5,1,30,1,13,4,528,469,6,2,0,-,471,534
5,1,30,1,13,5,732,477,147,14,92,VEHICLENUMBER,491,879
5,1,30,1,13,6,921,478,70,13,46,LICENSE,491,991
5,1,30,1,13,7,998,478,70,13,96,NUMBER,491,1068
5,1,30,1,13,8,1129,478,80,14,96,ADDRESS,492,1209
5,1,30,1,13,9,1215,478,22,14,96,OF,492,1237
5,1,30,1,13,10,1243,478,58,14,95,METER,492,1301
5,1,30,1,13,11,1305,479,35,13,95,AND,492,1340
5,1,30,1,13,12,1345,479,68,13,96,TRADER,492,1413
4,1,30,1,14,0,144,500,1333,21,-1,,521,1477
5,1,30,1,14,1,144,502,114,17,96,PREMIER,519,258
5,1,30,1,14,2,276,503,64,17,96,BULK,520,340
5,1,30,1,14,3,359,503,113,18,95,SYSTEMS,521,472
5,1,30,1,14,4,575,503,112,18,95,5000234,521,687
5,1,30,1,14,5,703,489,15,36,93,|,525,718
5,1,30,1,14,6,736,500,135,13,42,NeOUVEHICULE,513,871
5,1,30,1,14,7,898,489,12,36,44,=,525,910
5,1,30,1,14,8,922,500,71,13,0,NOMBRE,513,993
5,1,30,1,14,9,999,500,22,13,0,OE,513,1021
5,1,30,1,14,10,1027,500,62,14,66,PERMIS,514,1089
5,1,30,1,14,11,1096,489,9,36,91,|,525,1105
5,1,30,1,14,12,1116,500,91,14,53,L'ADRESSE,514,1207
5,1,30,1,14,13,1214,501,21,13,96,DE,514,1235
5,1,30,1,14,14,1241,501,58,13,95,METRE,514,1299
5,1,30,1,14,15,1305,502,20,12,94,ET,514,1325
5,1,30,1,14,16,1331,502,21,12,93,DE,514,1352
5,1,30,1,14,17,1358,502,119,13,91,COMMERCANT,515,1477
4,1,30,1,15,0,144,531,1326,27,-1,,558,1470
5,1,30,1,15,1,144,531,28,19,96,25,550,172
5,1,30,1,15,2,193,532,115,22,96,Gormley,554,308
5,1,30,1,15,3,326,531,161,20,95,Industrial,551,487
5,1,30,1,15,4,507,534,31,17,96,Dr,551,538
5,1,30,1,15,5,725,534,94,18,96,919322,552,819
5,1,30,1,15,6,1108,536,98,18,96,Suncor,554,1206
5,1,30,1,15,7,1225,536,99,22,96,Energy,558,1324
5,1,30,1,15,8,1343,536,127,18,96,Products,554,1470
4,1,30,1,16,0,143,558,1278,32,-1,,590,1421
5,1,30,1,16,1,143,558,115,32,96,GORMLEY,590,258
5,1,30,1,16,2,726,564,77,19,96,51202,583,803
5,1,30,1,16,3,1108,566,63,18,96,3275,584,1171
5,1,30,1,16,4,1191,566,116,19,96,Rebecca,585,1307
5,1,30,1,16,5,1326,567,95,18,95,Street,585,1421
4,1,30,1,17,0,143,592,526,26,-1,,618,669
5,1,30,1,17,1,143,593,96,19,47,LOH1G0,612,239
5,1,30,1,17,2,485,592,34,25,10,Cee,617,519
5,1,30,1,17,3,532,592,18,26,57,DU,618,550
5,1,30,1,17,4,554,592,115,26,31,TRANSPORTEOR,618,669
4,1,30,1,18,0,149,623,205,21,-1,,644,354
5,1,30,1,18,1,149,623,205,21,90,(226)338-5962,644,354
4,1,30,1,19,0,985,676,617,15,-1,,691,1602
5,1,30,1,19,1,985,676,67,14,96,FACTOR,690,1052
5,1,30,1,19,2,1161,677,92,13,83,MEASURED,690,1253
5,1,30,1,19,3,1273,666,12,34,83,|,700,1285
5,1,30,1,19,4,1305,677,32,13,39,NET,690,1337
5,1,30,1,19,5,1343,677,56,13,39,LITRES,690,1399
5,1,30,1,19,6,1532,678,70,13,96,DENSITY,691,1602
4,1,30,1,20,0,74,683,1528,36,-1,,719,1602
5,1,30,1,20,1,74,684,143,14,81,PROOUCTIMETER,698,217
5,1,30,1,20,2,570,707,5,3,53,.,710,575
5,1,30,1,20,3,985,683,78,36,88,FACTEUR,719,1063
5,1,30,1,20,4,1175,696,56,14,96,LITRES,710,1231
5,1,30,1,20,5,1305,697,103,13,14,correctep,710,1408
5,1,30,1,20,6,1436,689,63,13,69,|TEMPC,702,1499
5,1,30,1,20,7,1508,684,9,36,92,|,720,1517
5,1,30,1,20,8,1532,697,70,13,30,pensite,710,1602
4,1,30,1,21,0,74,699,1514,36,-1,,735,1588
5,1,30,1,21,1,74,701,136,34,77,PRODUIT/METER,735,210
5,1,30,1,21,2,367,699,80,13,2,PRODUCT,712,447
5,1,30,1,21,3,453,700,111,13,23,DESORIPTION=,713,564
5,1,30,1,21,4,581,700,112,14,0,DESEHIFTION,714,693
5,1,30,1,21,5,700,701,21,13,44,DU,714,721
5,1,30,1,21,6,729,700,73,14,44,FRODUIT,714,802
5,1,30,1,21,7,984,715,25,13,79,API,728,1009
5,1,30,1,21,8,1015,715,52,13,92,TABLE,728,1067
5,1,30,1,21,9,1161,716,92,13,89,MESUREES,729,1253
5,1,30,1,21,10,1329,716,61,14,88,TO15C,730,1390
5,1,30,1,21,11,1437,716,70,14,13,[CELSIUS,730,1507
5,1,30,1,21,12,1512,706,9,34,70,Â¢,740,1521
5,1,30,1,21,13,1532,717,56,17,20,kg/cum,734,1588
4,1,30,1,22,0,144,746,1424,24,-1,,770,1568
5,1,30,1,22,1,144,746,94,20,94,103265,766,238
5,1,30,1,22,2,252,742,15,33,94,|,775,267
5,1,30,1,22,3,274,748,49,18,95,NOT,766,323
5,1,30,1,22,4,341,748,147,18,95,REGULATED,766,488
5,1,30,1,22,5,506,750,82,16,96,UNDER,766,588
5,1,30,1,22,6,606,750,50,17,95,TDG,767,656
5,1,30,1,22,7,975,750,95,18,95,0.9599,768,1070
5,1,30,1,22,8,1159,750,79,18,96,23500,768,1238
5,1,30,1,22,9,1309,751,78,18,96,22558,769,1387
5,1,30,1,22,10,1442,751,61,18,69,67.4,769,1503
5,1,30,1,22,11,1524,751,44,19,58,|913,770,1568
4,1,30,1,23,0,141,777,930,20,-1,,797,1071
5,1,30,1,23,1,141,777,97,18,92,MTR221,795,238
5,1,30,1,23,2,250,773,17,31,93,|,804,267
5,1,30,1,23,3,274,779,66,17,91,HVGO,796,340
5,1,30,1,23,4,956,782,47,15,93,API,797,1003
5,1,30,1,23,5,1025,780,46,17,89,54B,797,1071
4,1,30,1,24,0,144,837,1424,23,-1,,860,1568
5,1,30,1,24,1,144,837,94,18,92,103265,855,238
5,1,30,1,24,2,252,833,15,33,92,|,866,267
5,1,30,1,24,3,274,839,48,18,95,NOT,857,322
5,1,30,1,24,4,341,839,147,18,96,REGULATED,857,488
5,1,30,1,24,5,506,840,82,17,96,UNDER,857,588
5,1,30,1,24,6,606,840,49,17,96,TDG,857,655
5,1,30,1,24,7,975,840,94,19,95,0.9595,859,1069
5,1,30,1,24,8,1159,840,78,19,96,24499,859,1237
5,1,30,1,24,9,1309,841,77,18,96,23507,859,1386
5,1,30,1,24,10,1442,841,60,18,77,67.9,859,1502
5,1,30,1,24,11,1524,841,44,19,62,|913,860,1568
4,1,30,1,25,0,141,868,930,21,-1,,889,1071
5,1,30,1,25,1,141,868,97,18,91,MTR222,886,238
5,1,30,1,25,2,251,864,14,32,91,|,896,265
5,1,30,1,25,3,274,870,65,18,92,HVGO,888,339
5,1,30,1,25,4,956,872,47,17,92,API,889,1003
5,1,30,1,25,5,1025,871,46,18,91,54B,889,1071
4,1,30,1,26,0,310,883,177,91,-1,,974,487
5,1,30,1,26,1,310,883,177,91,0,onaly,974,487
4,1,30,1,27,0,340,1058,93,14,-1,,1072,433
5,1,30,1,27,1,340,1064,19,8,29,a,1072,359
5,1,30,1,27,2,427,1058,6,11,48,1,1069,433
4,1,30,1,28,0,290,1042,258,58,-1,,1100,548
5,1,30,1,28,1,290,1042,49,38,0,Uh-,1080,339
5,1,30,1,28,2,373,1049,93,45,72,Joye,1094,466
5,1,30,1,28,3,490,1064,58,36,79,pm,1100,548
4,1,30,1,29,0,264,1120,147,49,-1,,1169,411
5,1,30,1,29,1,264,1120,46,49,45,ow,1169,310
5,1,30,1,29,2,407,1140,4,9,20,â,1149,411
4,1,30,1,30,0,312,1131,223,55,-1,,1186,535
5,1,30,1,30,1,312,1131,30,31,35,E,1162,342
5,1,30,1,30,2,358,1137,100,45,75,10.30,1182,458
5,1,30,1,30,3,482,1148,53,38,85,pr,1186,535
4,1,30,1,31,0,308,1419,379,23,-1,,1442,687
5,1,30,1,31,1,308,1420,79,18,95,Total,1438,387
5,1,30,1,31,2,406,1419,97,19,96,Litres,1438,503
5,1,30,1,31,3,522,1420,33,22,96,by,1442,555
5,1,30,1,31,4,574,1420,113,19,96,Product,1439,687
4,1,30,1,32,0,276,1444,1110,35,-1,,1479,1386
5,1,30,1,32,1,276,1449,94,19,96,103265,1468,370
5,1,30,1,32,2,468,1444,70,35,92,HVGO,1479,538
5,1,30,1,32,3,1158,1452,78,19,96,47999,1471,1236
5,1,30,1,32,4,1308,1452,78,19,95,46065,1471,1386
4,1,30,1,33,0,73,1730,1495,36,-1,,1766,1568
5,1,30,1,33,1,73,1740,61,13,93,DRIVER,1753,134
5,1,30,1,33,2,140,1740,95,14,93,SIGNATURE,1754,235
5,1,30,1,33,3,241,1748,5,2,92,-,1750,246
5,1,30,1,33,4,251,1740,95,14,92,SIGNATURE,1754,346
5,1,30,1,33,5,353,1741,21,13,92,DU,1754,374
5,1,30,1,33,6,381,1742,117,13,91,CONDUCTEUR,1755,498
5,1,30,1,33,7,861,1730,72,35,24,aa,1765,933
5,1,30,1,33,8,1025,1740,72,25,72,DEBUT,1765,1097
5,1,30,1,33,9,1075,1736,22,41,72,DU,1777,1097
5,1,30,1,33,10,1100,1740,98,25,61,GHARGEMENT,1765,1198
5,1,30,1,33,11,1208,1736,18,41,36,|,1777,1226
5,1,30,1,33,12,1242,1740,148,26,60,FINDUCHARGEMENT,1766,1390
5,1,30,1,33,13,1502,1741,66,25,5,Dean?,1766,1568
4,1,30,1,34,0,857,1788,695,21,-1,,1809,1552
5,1,30,1,34,1,857,1788,79,19,96,21:49,1807,936
5,1,30,1,34,2,1056,1789,78,19,96,21:52,1808,1134
5,1,30,1,34,3,1274,1790,78,18,96,22:07,1808,1352
5,1,30,1,34,4,1474,1790,78,19,95,22:07,1809,1552
4,1,30,1,35,0,73,1820,1496,19,-1,,1839,1569
5,1,30,1,35,1,73,1820,61,14,70,DRIVER,1834,134
5,1,30,1,35,2,141,1820,45,14,92,NAME,1834,186
5,1,30,1,35,3,192,1828,4,3,92,-,1831,196
5,1,30,1,35,4,203,1821,36,14,96,NOM,1835,239
5,1,30,1,35,5,246,1822,22,13,92,DU,1835,268
5,1,30,1,35,6,274,1822,117,13,92,CONDUCTEUR,1835,391
5,1,30,1,35,7,1280,1825,54,13,95,TOTAL,1838,1334
5,1,30,1,35,8,1339,1825,83,14,93,QUANTITY,1839,1422
5,1,30,1,35,9,1428,1832,4,3,83,-,1835,1432
5,1,30,1,35,10,1438,1825,62,14,93,QUANT.,1839,1500
5,1,30,1,35,11,1505,1826,64,13,93,TOTALE,1839,1569
4,1,30,1,36,0,1291,1851,195,19,-1,,1870,1486
5,1,30,1,36,1,1291,1851,78,19,96,47999,1870,1369
5,1,30,1,36,2,1389,1851,97,19,96,Litres,1870,1486
4,1,30,1,37,0,143,1879,1274,22,-1,,1901,1417
5,1,30,1,37,1,143,1879,114,18,85,SANJEEV,1897,257
5,1,30,1,37,2,291,1880,81,18,82,KUMAR,1898,372
5,1,30,1,37,3,1291,1882,77,19,42,42057,1901,1368
5,1,30,1,37,4,1375,1878,3,32,42,_,1910,1378
5,1,30,1,37,5,1390,1882,27,19,93,kg,1901,1417
2,1,31,0,0,0,57,128,11,1770,-1,,1898,68
3,1,31,1,0,0,57,128,11,1770,-1,,1898,68
4,1,31,1,1,0,57,128,11,1770,-1,,1898,68
5,1,31,1,1,1,57,128,11,1770,95, ,1898,68
2,1,32,0,0,0,81,1909,67,28,-1,,1937,148
3,1,32,1,0,0,81,1909,67,28,-1,,1937,148
4,1,32,1,1,0,81,1909,67,12,-1,,1921,148
5,1,32,1,1,1,81,1909,67,12,95,PRODUCT,1921,148
4,1,32,1,2,0,84,1926,60,11,-1,,1937,144
5,1,32,1,2,1,84,1926,60,11,96,PRODUIT,1937,144
2,1,33,0,0,0,221,1910,109,45,-1,,1955,330
3,1,33,1,0,0,221,1910,109,45,-1,,1955,330
4,1,33,1,1,0,221,1910,109,11,-1,,1921,330
5,1,33,1,1,1,221,1910,36,11,94,TANK,1921,257
5,1,33,1,1,2,262,1910,68,11,91,CAPACITY,1921,330
4,1,33,1,2,0,224,1927,96,11,-1,,1938,320
5,1,33,1,2,1,224,1927,96,11,88,CONTENANCE,1938,320
4,1,33,1,3,0,222,1944,103,11,-1,,1955,325
5,1,33,1,3,1,222,1944,18,11,92,DU,1955,240
5,1,33,1,3,2,245,1944,80,11,92,RESERVIOR,1955,325
2,1,34,0,0,0,390,1927,67,28,-1,,1955,457
3,1,34,1,0,0,390,1927,67,28,-1,,1955,457
4,1,34,1,1,0,390,1927,67,12,-1,,1939,457
5,1,34,1,1,1,390,1927,67,12,87,MEASURE,1939,457
4,1,34,1,2,0,392,1944,62,11,-1,,1955,454
5,1,34,1,2,1,392,1944,62,11,66,DEAUICM,1955,454
2,1,35,0,0,0,498,1927,74,29,-1,,1956,572
3,1,35,1,0,0,498,1927,74,29,-1,,1956,572
4,1,35,1,1,0,500,1927,67,12,-1,,1939,567
5,1,35,1,1,1,500,1928,46,11,94,AVANT,1939,546
5,1,35,1,1,2,550,1927,17,12,78,LE,1939,567
4,1,35,1,2,0,498,1945,74,11,-1,,1956,572
5,1,35,1,2,1,498,1945,74,11,58,JAUGEAGE,1956,572
2,1,36,0,0,0,712,1911,107,46,-1,,1957,819
3,1,36,1,0,0,712,1911,107,46,-1,,1957,819
4,1,36,1,1,0,712,1911,107,12,-1,,1923,819
5,1,36,1,1,1,712,1911,52,12,96,ENDING,1923,764
5,1,36,1,1,2,770,1911,49,12,28,INVENT,1923,819
4,1,36,1,2,0,726,1928,81,12,-1,,1940,807
5,1,36,1,2,1,726,1928,81,12,81,INVENTAIRE,1940,807
4,1,36,1,3,0,741,1945,46,12,-1,,1957,787
5,1,36,1,3,1,741,1945,46,12,81,APRES,1957,787
2,1,37,0,0,0,865,1912,67,28,-1,,1940,932
3,1,37,1,0,0,865,1912,67,28,-1,,1940,932
4,1,37,1,1,0,865,1912,67,11,-1,,1923,932
5,1,37,1,1,1,865,1912,67,11,96,PRODUCT,1923,932
4,1,37,1,2,0,867,1929,62,11,-1,,1940,929
5,1,37,1,2,1,867,1929,62,11,93,PRODUIT,1940,929
2,1,38,0,0,0,1622,134,10,1768,-1,,1902,1632
3,1,38,1,0,0,1622,134,10,1768,-1,,1902,1632
4,1,38,1,1,0,1622,134,10,1768,-1,,1902,1632
5,1,38,1,1,1,1622,134,10,1768,95, ,1902,1632
2,1,39,0,0,0,1003,1912,109,45,-1,,1957,1112
3,1,39,1,0,0,1003,1912,109,45,-1,,1957,1112
4,1,39,1,1,0,1003,1912,109,11,-1,,1923,1112
5,1,39,1,1,1,1003,1912,35,11,95,TANK,1923,1038
5,1,39,1,1,2,1043,1912,69,11,0,CAPACITY,1923,1112
4,1,39,1,2,0,1006,1929,95,12,-1,,1941,1101
5,1,39,1,2,1,1006,1929,95,12,86,CONTENANCE,1941,1101
4,1,39,1,3,0,1003,1946,104,11,-1,,1957,1107
5,1,39,1,3,1,1003,1946,19,11,93,DU,1957,1022
5,1,39,1,3,2,1027,1946,80,11,92,RESERVIOR,1957,1107
2,1,40,0,0,0,1155,1913,102,44,-1,,1957,1257
3,1,40,1,0,0,1155,1913,102,44,-1,,1957,1257
4,1,40,1,1,0,1155,1913,102,11,-1,,1924,1257
5,1,40,1,1,1,1155,1913,49,11,93,WATER,1924,1204
5,1,40,1,1,2,1210,1913,47,11,81,DIPICM,1924,1257
4,1,40,1,2,0,1170,1929,67,12,-1,,1941,1237
5,1,40,1,2,1,1170,1929,67,12,74,MEASURE,1941,1237
4,1,40,1,3,0,1172,1946,63,11,-1,,1957,1235
5,1,40,1,3,1,1172,1946,63,11,64,DEAUICM,1957,1235
2,1,41,0,0,0,1276,1913,92,45,-1,,1958,1368
3,1,41,1,0,0,1276,1913,92,45,-1,,1958,1368
4,1,41,1,1,0,1276,1913,92,12,-1,,1925,1368
5,1,41,1,1,1,1276,1913,56,12,91,BEFORE,1925,1332
5,1,41,1,1,2,1336,1913,32,12,74,DIPS,1925,1368
4,1,41,1,2,0,1283,1929,67,12,-1,,1941,1350
5,1,41,1,2,1,1283,1929,47,12,71,AVANT,1941,1330
5,1,41,1,2,2,1334,1930,16,11,71,LE,1941,1350
4,1,41,1,3,0,1281,1947,75,11,-1,,1958,1356
5,1,41,1,3,1,1281,1947,75,11,87,JAUGEAGE,1958,1356
2,1,42,0,0,0,1386,1913,80,45,-1,,1958,1466
3,1,42,1,0,0,1386,1913,80,45,-1,,1958,1466
4,1,42,1,1,0,1386,1913,80,12,-1,,1925,1466
5,1,42,1,1,1,1386,1913,45,12,95,AFTER,1925,1431
5,1,42,1,1,2,1436,1913,30,12,64,DIPS,1925,1466
4,1,42,1,2,0,1392,1930,66,11,-1,,1941,1458
5,1,42,1,2,1,1392,1930,46,11,91,APRES,1941,1438
5,1,42,1,2,2,1443,1930,15,11,95,LE,1941,1458
4,1,42,1,3,0,1392,1947,74,11,-1,,1958,1466
5,1,42,1,3,1,1392,1947,74,11,85,JAUGEAGE,1958,1466
2,1,43,0,0,0,1497,1914,108,45,-1,,1959,1605
3,1,43,1,0,0,1497,1914,108,45,-1,,1959,1605
4,1,43,1,1,0,1497,1914,108,11,-1,,1925,1605
5,1,43,1,1,1,1497,1914,53,11,96,ENDING,1925,1550
5,1,43,1,1,2,1555,1914,50,11,96,INVENT,1925,1605
4,1,43,1,2,0,1512,1930,81,12,-1,,1942,1593
5,1,43,1,2,1,1512,1930,81,12,15,INVENTAIRE,1942,1593
4,1,43,1,3,0,1525,1947,46,12,-1,,1959,1571
5,1,43,1,3,1,1525,1947,46,12,41,APRES:,1959,1571
2,1,44,0,0,0,63,1956,1561,11,-1,,1967,1624
3,1,44,1,0,0,63,1956,1561,11,-1,,1967,1624
4,1,44,1,1,0,63,1956,1561,11,-1,,1967,1624
5,1,44,1,1,1,63,1956,1561,11,95, ,1967,1624
2,1,45,0,0,0,64,2018,1559,10,-1,,2028,1623
3,1,45,1,0,0,64,2018,1559,10,-1,,2028,1623
4,1,45,1,1,0,64,2018,1559,10,-1,,2028,1623
5,1,45,1,1,1,64,2018,1559,10,95, ,2028,1623
2,1,46,0,0,0,94,2080,1529,10,-1,,2090,1623
3,1,46,1,0,0,94,2080,1529,10,-1,,2090,1623
4,1,46,1,1,0,94,2080,1529,10,-1,,2090,1623
5,1,46,1,1,1,94,2080,1529,10,95, ,2090,1623
2,1,47,0,0,0,368,1904,2,236,-1,,2140,370
3,1,47,1,0,0,368,1904,2,236,-1,,2140,370
4,1,47,1,1,0,368,1904,2,236,-1,,2140,370
5,1,47,1,1,1,368,1904,2,236,95, ,2140,370
2,1,48,0,0,0,39,2159,345,17,-1,,2176,384
3,1,48,1,0,0,39,2159,345,17,-1,,2176,384
4,1,48,1,1,0,39,2159,345,17,-1,,2176,384
5,1,48,1,1,1,39,2159,11,13,88,A,2172,50
5,1,48,1,1,2,55,2159,51,13,88,Suncor,2172,106
5,1,48,1,1,3,112,2159,64,14,93,business,2173,176
5,1,48,1,1,4,182,2159,5,14,91,/,2173,187
5,1,48,1,1,5,193,2159,29,14,93,Une,2173,222
5,1,48,1,1,6,228,2159,73,17,92,entreprise,2176,301
5,1,48,1,1,7,307,2160,18,13,96,de,2173,325
5,1,48,1,1,8,331,2159,53,14,96,Suncor,2173,384
2,1,49,0,0,0,54,1815,1579,335,-1,,2150,1633
3,1,49,1,0,0,54,1815,1579,335,-1,,2150,1633
4,1,49,1,1,0,54,1815,1579,335,-1,,2150,1633
5,1,49,1,1,1,54,1815,1579,335,95, ,2150,1633
2,1,50,0,0,0,950,1906,2,238,-1,,2144,952
3,1,50,1,0,0,950,1906,2,238,-1,,2144,952
4,1,50,1,1,0,950,1906,2,238,-1,,2144,952
5,1,50,1,1,1,950,1906,2,238,95, ,2144,952
2,1,51,0,0,0,1150,1907,2,237,-1,,2144,1152
3,1,51,1,0,0,1150,1907,2,237,-1,,2144,1152
4,1,51,1,1,0,1150,1907,2,237,-1,,2144,1152
5,1,51,1,1,1,1150,1907,2,237,95, ,2144,1152
2,1,52,0,0,0,1262,1907,2,237,-1,,2144,1264
3,1,52,1,0,0,1262,1907,2,237,-1,,2144,1264
4,1,52,1,1,0,1262,1907,2,237,-1,,2144,1264
5,1,52,1,1,1,1262,1907,2,237,95, ,2144,1264
2,1,53,0,0,0,1373,1908,1,237,-1,,2145,1374
3,1,53,1,0,0,1373,1908,1,237,-1,,2145,1374
4,1,53,1,1,0,1373,1908,1,237,-1,,2145,1374
5,1,53,1,1,1,1373,1908,1,237,95, ,2145,1374
2,1,54,0,0,0,1484,1908,2,237,-1,,2145,1486
3,1,54,1,0,0,1484,1908,2,237,-1,,2145,1486
4,1,54,1,1,0,1484,1908,2,237,-1,,2145,1486
5,1,54,1,1,1,1484,1908,2,237,95, ,2145,1486
2,1,55,0,0,0,1552,2161,111,17,-1,,2178,1663
3,1,55,1,0,0,1552,2161,111,17,-1,,2178,1663
4,1,55,1,1,0,1552,2161,111,17,-1,,2178,1663
5,1,55,1,1,1,1552,2161,54,13,73,442791,2174,1606
5,1,55,1,1,2,1612,2161,51,17,93,(05/17),2178,1663
1,1,0,0,0,0,0,0,1700,2200,-1,,2200,1700
2,1,1,0,0,0,775,15,210,51,-1,,66,985
3,1,1,1,0,0,775,15,210,51,-1,,66,985
4,1,1,1,1,0,775,15,210,51,-1,,66,985
5,1,1,1,1,1,775,15,210,51,12,Qyoqe,66,985
5,1,1,1,1,2,949,11,39,65,55,hy,76,988
2,1,2,0,0,0,911,77,613,25,-1,,102,1524
3,1,2,1,0,0,911,77,613,25,-1,,102,1524
4,1,2,1,1,0,911,77,613,25,-1,,102,1524
5,1,2,1,1,1,911,77,118,22,96,VEHICLE,99,1029
5,1,2,1,1,2,1039,78,122,22,95,LOADING,100,1161
5,1,2,1,1,3,1172,79,113,22,93,REPORT,101,1285
5,1,2,1,1,4,1284,73,13,39,92,-,112,1297
5,1,2,1,1,5,1312,80,55,21,95,BILL,101,1367
5,1,2,1,1,6,1377,80,35,22,93,OF,102,1412
5,1,2,1,1,7,1423,81,101,21,91,LADING,102,1524
2,1,3,0,0,0,65,121,1567,16,-1,,137,1632
3,1,3,1,0,0,65,121,1567,16,-1,,137,1632
4,1,3,1,1,0,65,121,1567,16,-1,,137,1632
5,1,3,1,1,1,65,121,1567,16,95, ,137,1632
2,1,4,0,0,0,65,216,607,7,-1,,223,672
3,1,4,1,0,0,65,216,607,7,-1,,223,672
4,1,4,1,1,0,65,216,607,7,-1,,223,672
5,1,4,1,1,1,65,216,607,7,95, ,223,672
2,1,5,0,0,0,822,223,810,9,-1,,232,1632
3,1,5,1,0,0,822,223,810,9,-1,,232,1632
4,1,5,1,1,0,822,223,810,9,-1,,232,1632
5,1,5,1,1,1,822,223,810,9,95, ,232,1632
2,1,6,0,0,0,276,394,575,6,-1,,400,851
3,1,6,1,0,0,276,394,575,6,-1,,400,851
4,1,6,1,1,0,276,394,575,6,-1,,400,851
5,1,6,1,1,1,276,394,575,6,95, ,400,851
2,1,7,0,0,0,561,397,3,70,-1,,467,564
3,1,7,1,0,0,561,397,3,70,-1,,467,564
4,1,7,1,1,0,561,397,3,70,-1,,467,564
5,1,7,1,1,1,561,397,3,70,95, ,467,564
2,1,8,0,0,0,850,225,6,245,-1,,470,856
3,1,8,1,0,0,850,225,6,245,-1,,470,856
4,1,8,1,1,0,850,225,6,245,-1,,470,856
5,1,8,1,1,1,850,225,6,245,95, ,470,856
2,1,9,0,0,0,1449,229,4,62,-1,,291,1453
3,1,9,1,0,0,1449,229,4,62,-1,,291,1453
4,1,9,1,1,0,1449,229,4,62,-1,,291,1453
5,1,9,1,1,1,1449,229,4,62,95, ,291,1453
2,1,10,0,0,0,1450,289,182,4,-1,,293,1632
3,1,10,1,0,0,1450,289,182,4,-1,,293,1632
4,1,10,1,1,0,1450,289,182,4,-1,,293,1632
5,1,10,1,1,1,1450,289,182,4,95, ,293,1632
2,1,11,0,0,0,63,461,1566,13,-1,,474,1629
3,1,11,1,0,0,63,461,1566,13,-1,,474,1629
4,1,11,1,1,0,63,461,1566,13,-1,,474,1629
5,1,11,1,1,1,63,461,1566,13,95, ,474,1629
2,1,12,0,0,0,713,466,3,197,-1,,663,716
3,1,12,1,0,0,713,466,3,197,-1,,663,716
4,1,12,1,1,0,713,466,3,197,-1,,663,716
5,1,12,1,1,1,713,466,3,197,95, ,663,716
2,1,13,0,0,0,67,656,1564,12,-1,,668,1631
3,1,13,1,0,0,67,656,1564,12,-1,,668,1631
4,1,13,1,1,0,67,656,1564,12,-1,,668,1631
5,1,13,1,1,1,67,656,1564,12,95, ,668,1631
2,1,14,0,0,0,64,725,1567,13,-1,,738,1631
3,1,14,1,0,0,64,725,1567,13,-1,,738,1631
4,1,14,1,1,0,64,725,1567,13,-1,,738,1631
5,1,14,1,1,1,64,725,1567,13,95, ,738,1631
2,1,15,0,0,0,58,130,13,1494,-1,,1624,71
3,1,15,1,0,0,58,130,13,1494,-1,,1624,71
4,1,15,1,1,0,58,130,13,1494,-1,,1624,71
5,1,15,1,1,1,58,130,13,1494,95, ,1624,71
2,1,16,0,0,0,252,658,10,1075,-1,,1733,262
3,1,16,1,0,0,252,658,10,1075,-1,,1733,262
4,1,16,1,1,0,252,658,10,1075,-1,,1733,262
5,1,16,1,1,1,252,658,10,1075,95, ,1733,262
2,1,17,0,0,0,929,696,11,1040,-1,,1736,940
3,1,17,1,0,0,929,696,11,1040,-1,,1736,940
4,1,17,1,1,0,929,696,11,1040,-1,,1736,940
5,1,17,1,1,1,929,696,11,1040,95, ,1736,940
2,1,18,0,0,0,1430,665,12,1013,-1,,1678,1442
3,1,18,1,0,0,1430,665,12,1013,-1,,1678,1442
4,1,18,1,1,0,1430,665,12,1013,-1,,1678,1442
5,1,18,1,1,1,1430,665,12,1013,95, ,1678,1442
2,1,19,0,0,0,1124,664,11,1072,-1,,1736,1135
3,1,19,1,0,0,1124,664,11,1072,-1,,1736,1135
4,1,19,1,1,0,1124,664,11,1072,-1,,1736,1135
5,1,19,1,1,1,1124,664,11,1072,95, ,1736,1135
2,1,20,0,0,0,1278,664,10,1073,-1,,1737,1288
3,1,20,1,0,0,1278,664,10,1073,-1,,1737,1288
4,1,20,1,1,0,1278,664,10,1073,-1,,1737,1288
5,1,20,1,1,1,1278,664,10,1073,95, ,1737,1288
2,1,21,0,0,0,1513,666,11,1072,-1,,1738,1524
3,1,21,1,0,0,1513,666,11,1072,-1,,1738,1524
4,1,21,1,1,0,1513,666,11,1072,-1,,1738,1524
5,1,21,1,1,1,1513,666,11,1072,95, ,1738,1524
2,1,22,0,0,0,61,1729,1564,10,-1,,1739,1625
3,1,22,1,0,0,61,1729,1564,10,-1,,1739,1625
4,1,22,1,1,0,61,1729,1564,10,-1,,1739,1625
5,1,22,1,1,1,61,1729,1564,10,95, ,1739,1625
2,1,23,0,0,0,795,1733,1,85,-1,,1818,796
3,1,23,1,0,0,795,1733,1,85,-1,,1818,796
4,1,23,1,1,0,795,1733,1,85,-1,,1818,796
5,1,23,1,1,1,795,1733,1,85,95, ,1818,796
2,1,24,0,0,0,1419,1736,2,84,-1,,1820,1421
3,1,24,1,0,0,1419,1736,2,84,-1,,1820,1421
4,1,24,1,1,0,1419,1736,2,84,-1,,1820,1421
5,1,24,1,1,1,1419,1736,2,84,95, ,1820,1421
2,1,25,0,0,0,1002,1734,2,85,-1,,1819,1004
3,1,25,1,0,0,1002,1734,2,85,-1,,1819,1004
4,1,25,1,1,0,1002,1734,2,85,-1,,1819,1004
5,1,25,1,1,1,1002,1734,2,85,95, ,1819,1004
2,1,26,0,0,0,1211,1738,2,80,-1,,1818,1213
3,1,26,1,0,0,1211,1738,2,80,-1,,1818,1213
4,1,26,1,1,0,1211,1738,2,80,-1,,1818,1213
5,1,26,1,1,1,1211,1738,2,80,95, ,1818,1213
2,1,27,0,0,0,82,1812,1544,9,-1,,1821,1626
3,1,27,1,0,0,82,1812,1544,9,-1,,1821,1626
4,1,27,1,1,0,82,1812,1544,9,-1,,1821,1626
5,1,27,1,1,1,82,1812,1544,9,95, ,1821,1626
2,1,28,0,0,0,55,1857,525,26,-1,,1883,580
3,1,28,1,0,0,55,1857,525,26,-1,,1883,580
4,1,28,1,1,0,55,1857,525,26,-1,,1883,580
5,1,28,1,1,1,55,1857,525,26,95, ,1883,580
2,1,29,0,0,0,1224,1857,68,22,-1,,1879,1292
3,1,29,1,0,0,1224,1857,68,22,-1,,1879,1292
4,1,29,1,1,0,1224,1857,68,22,-1,,1879,1292
5,1,29,1,1,1,1224,1857,68,22,95, ,1879,1292
2,1,30,0,0,0,1224,1857,410,26,-1,,1883,1634
3,1,30,1,0,0,1224,1857,410,26,-1,,1883,1634
4,1,30,1,1,0,1224,1857,410,26,-1,,1883,1634
5,1,30,1,1,1,1224,1857,410,26,95,  ,1883,1634
2,1,31,0,0,0,61,102,1567,1797,-1,,1899,1628
3,1,31,1,0,0,61,102,1567,1797,-1,,1899,1628
4,1,31,1,1,0,149,102,1479,29,-1,,131,1628
5,1,31,1,1,1,149,102,75,24,96,Page:,126,224
5,1,31,1,1,2,248,102,12,19,96,1,121,260
5,1,31,1,1,3,480,104,45,19,96,530,123,525
5,1,31,1,1,4,816,104,131,22,96,RAPPORT,126,947
5,1,31,1,1,5,958,105,35,21,91,DE,126,993
5,1,31,1,1,6,1003,105,196,23,91,CHARGEMENT,128,1199
5,1,31,1,1,7,1208,119,7,3,90,-,122,1215
5,1,31,1,1,8,1224,107,138,22,90,VEHICULE,129,1362
5,1,31,1,1,9,1371,120,8,3,91,-,123,1379
5,1,31,1,1,10,1389,108,239,23,91,CONNAISSEMENT,131,1628
4,1,31,1,2,0,137,131,535,25,-1,,156,672
5,1,31,1,2,1,137,132,110,15,82,DOCUMENT,147,247
5,1,31,1,2,2,254,133,81,15,82,NUMBER,148,335
5,1,31,1,2,3,364,134,60,18,94,1657,152,424
5,1,31,1,2,4,536,131,136,25,36,Pe,156,672
4,1,31,1,3,0,137,151,173,15,-1,,166,310
5,1,31,1,3,1,137,151,23,14,96,No,165,160
5,1,31,1,3,2,167,151,26,15,93,DU,166,193
5,1,31,1,3,3,201,152,109,14,93,DOCUMENT,166,310
4,1,31,1,4,0,523,161,1087,38,-1,,199,1610
5,1,31,1,4,1,523,161,137,38,91,mm/dd/yy,199,660
5,1,31,1,4,2,800,170,29,20,96,24,190,829
5,1,31,1,4,3,840,169,79,21,93,HOUR,190,919
5,1,31,1,4,4,929,169,207,22,83,NUMBER_(403),191,1136
5,1,31,1,4,5,1146,170,128,18,78,296-3000,188,1274
5,1,31,1,4,6,1310,184,8,3,19,-,187,1318
5,1,31,1,4,7,1329,173,120,21,32,NUMERO,194,1449
5,1,31,1,4,8,1459,174,29,20,96,24,194,1488
5,1,31,1,4,9,1499,174,111,21,96,HEURES,195,1610
4,1,31,1,5,0,149,192,1225,32,-1,,224,1374
5,1,31,1,5,1,149,192,110,19,95,0114750,211,259
5,1,31,1,5,2,280,192,94,21,96,10/002,213,374
5,1,31,1,5,3,529,194,129,21,96,10/07/24,215,658
5,1,31,1,5,4,1051,201,231,23,35,COLLECT,224,1282
5,1,31,1,5,5,1180,188,14,41,93,-,229,1194
5,1,31,1,5,6,1207,201,73,23,92,FRAIS,224,1280
5,1,31,1,5,7,1291,203,83,21,92,VIRES,224,1374
4,1,31,1,6,0,79,223,1535,37,-1,,260,1614
5,1,31,1,6,1,79,223,196,15,90,CONSIGNEE/CUSTOMER,238,275
5,1,31,1,6,2,280,232,5,2,90,-,234,285
5,1,31,1,6,3,292,225,182,14,71,DESTINATAIRE/CLIENT,239,474
5,1,31,1,6,4,589,233,3,3,49,>,236,592
5,1,31,1,6,5,688,225,52,25,2,Te,250,740
5,1,31,1,6,6,740,239,97,12,0,eeeievr,251,837
5,1,31,1,6,7,850,220,9,35,93,|,255,859
5,1,31,1,6,8,864,230,111,14,42,CONSIGNOR-,244,975
5,1,31,1,6,9,982,230,105,15,92,EXPEDITEUR,245,1087
5,1,31,1,6,10,1462,225,24,35,36,rg,260,1486
5,1,31,1,6,11,1494,225,120,35,7,pier,260,1614
4,1,31,1,7,0,147,251,1425,31,-1,,282,1572
5,1,31,1,7,1,147,251,180,25,96,Mississauga,276,327
5,1,31,1,7,2,345,254,80,19,96,Lubes,273,425
5,1,31,1,7,3,444,256,98,18,96,Center,274,542
5,1,31,1,7,4,679,257,160,19,93,0000081523,276,839
5,1,31,1,7,5,860,257,183,25,88,|Mississauga,282,1043
5,1,31,1,7,6,1061,260,80,19,96,Lubes,279,1141
5,1,31,1,7,7,1161,262,98,17,95,Center,279,1259
5,1,31,1,7,8,1462,262,110,19,96,0081523,281,1572
4,1,31,1,8,0,149,282,1011,27,-1,,309,1160
5,1,31,1,8,1,149,282,44,20,96,385,302,193
5,1,31,1,8,2,215,284,145,19,96,Southdown,303,360
5,1,31,1,8,3,378,285,66,19,95,Road,304,444
5,1,31,1,8,4,679,288,228,19,77,0000000104|385,307,907
5,1,31,1,8,5,928,290,148,19,95,Southdown,309,1076
5,1,31,1,8,6,1094,290,66,19,96,Road,309,1160
4,1,31,1,9,0,147,312,1059,31,-1,,343,1206
5,1,31,1,9,1,147,312,174,25,90,"Missisauga,",337,321
5,1,31,1,9,2,346,316,31,18,91,ON,334,377
5,1,31,1,9,3,395,316,95,19,29,L5J2Y2,335,490
5,1,31,1,9,4,860,318,176,25,91,"Missisauga,",343,1036
5,1,31,1,9,5,1061,322,32,18,93,ON,340,1093
5,1,31,1,9,6,1111,321,95,19,48,L5J2Y2,340,1206
4,1,31,1,10,0,279,398,567,16,-1,,414,846
5,1,31,1,10,1,279,398,62,12,92,RELEASE,410,341
5,1,31,1,10,2,346,399,48,14,59,(C-of-A),413,394
5,1,31,1,10,3,399,400,59,11,96,NUMBER,411,458
5,1,31,1,10,4,569,400,78,12,94,CUSTOMER,412,647
5,1,31,1,10,5,652,402,77,11,89,PURCHASE,413,729
5,1,31,1,10,6,733,402,50,11,95,ORDER,413,783
5,1,31,1,10,7,787,402,59,12,96,NUMBER,414,846
4,1,31,1,11,0,619,415,190,12,-1,,427,809
5,1,31,1,11,1,619,415,17,11,88,No,426,636
5,1,31,1,11,2,640,416,18,10,96,DE,426,658
5,1,31,1,11,3,663,416,69,11,96,DEMANDE,427,732
5,1,31,1,11,4,737,416,18,11,91,DU,427,755
5,1,31,1,11,5,761,416,48,11,96,CLIENT,427,809
4,1,31,1,12,0,78,472,1338,20,-1,,492,1416
5,1,31,1,12,1,78,472,73,14,93,CARRIER,486,151
5,1,31,1,12,2,157,479,5,3,90,-,482,162
5,1,31,1,12,3,167,472,135,15,91,TRANSPORTEUR,487,302
5,1,31,1,12,4,734,474,71,14,94,VEHICLE,488,805
5,1,31,1,12,5,812,475,71,13,87,NUMBER,488,883
5,1,31,1,12,6,924,476,70,14,39,LICENSE,490,994
5,1,31,1,12,7,1000,476,71,14,96,NUMBER,490,1071
5,1,31,1,12,8,1133,477,78,14,72,ADDRESS,491,1211
5,1,31,1,12,9,1218,477,21,14,96,OF,491,1239
5,1,31,1,12,10,1246,478,56,14,96,METER,492,1302
5,1,31,1,12,11,1308,478,34,14,96,AND,492,1342
5,1,31,1,12,12,1348,478,68,14,96,TRADER,492,1416
4,1,31,1,13,0,148,497,1332,22,-1,,519,1480
5,1,31,1,13,1,148,497,112,18,96,PREMIER,515,260
5,1,31,1,13,2,278,499,65,17,96,BULK,516,343
5,1,31,1,13,3,362,499,112,19,96,SYSTEMS,518,474
5,1,31,1,13,4,578,500,112,19,95,5000234,519,690
5,1,31,1,13,5,708,488,12,35,91,|,523,720
5,1,31,1,13,6,738,497,137,14,88,NoDUVEHICULE,511,875
5,1,31,1,13,7,903,488,10,35,43,=,523,913
5,1,31,1,13,8,924,498,72,14,71,NOMBRE,512,996
5,1,31,1,13,9,1002,499,22,13,55,DE,512,1024
5,1,31,1,13,10,1031,499,61,13,55,PERMIS,512,1092
5,1,31,1,13,11,1099,488,6,35,92,|,523,1105
5,1,31,1,13,12,1119,500,90,14,61,L'ADRESSE,514,1209
5,1,31,1,13,13,1216,500,21,14,96,DE,514,1237
5,1,31,1,13,14,1244,500,56,14,96,METRE,514,1300
5,1,31,1,13,15,1307,501,20,13,96,ET,514,1327
5,1,31,1,13,16,1333,501,21,13,93,DE,514,1354
5,1,31,1,13,17,1360,501,120,14,92,COMMERCANT,515,1480
4,1,31,1,14,0,148,526,1325,32,-1,,558,1473
5,1,31,1,14,1,148,526,28,19,94,25,545,176
5,1,31,1,14,2,197,527,113,23,96,Gormley,550,310
5,1,31,1,14,3,329,528,161,20,96,Industrial,548,490
5,1,31,1,14,4,510,531,32,17,96,Dr,548,542
5,1,31,1,14,5,728,531,95,19,96,919322,550,823
5,1,31,1,14,6,1112,535,96,18,95,Suncor,553,1208
5,1,31,1,14,7,1227,536,99,22,95,Energy,558,1326
5,1,31,1,14,8,1344,535,129,19,96,Products,554,1473
4,1,31,1,15,0,147,554,1277,33,-1,,587,1424
5,1,31,1,15,1,147,554,113,33,96,GORMLEY,587,260
5,1,31,1,15,2,682,584,30,2,10,__,586,712
5,1,31,1,15,3,711,558,11,33,59,|,591,722
5,1,31,1,15,4,728,562,77,19,59,51202,581,805
5,1,31,1,15,5,1111,565,61,19,95,3275,584,1172
5,1,31,1,15,6,1193,565,115,19,96,Rebecca,584,1308
5,1,31,1,15,7,1328,567,96,18,96,Street,585,1424
4,1,31,1,16,0,147,588,524,28,-1,,616,671
5,1,31,1,16,1,147,588,94,20,76,LOH1GO,608,241
5,1,31,1,16,2,488,589,56,25,35,BES,614,544
5,1,31,1,16,3,566,590,105,26,12,EGR,616,671
4,1,31,1,17,0,153,618,203,22,-1,,640,356
5,1,31,1,17,1,153,618,203,22,91,(226)338-5962,640,356
4,1,31,1,18,0,934,669,671,20,-1,,689,1605
5,1,31,1,18,1,934,669,2,17,72,|,686,936
5,1,31,1,18,2,988,673,67,14,74,FACTOR,687,1055
5,1,31,1,18,3,1163,674,92,14,93,MEASURED,688,1255
5,1,31,1,18,4,1275,664,12,34,81,|,698,1287
5,1,31,1,18,5,1307,675,95,13,81,NETLITRES,688,1402
5,1,31,1,18,6,1535,676,70,13,95,DENSITY,689,1605
4,1,31,1,19,0,78,678,1527,31,-1,,709,1605
5,1,31,1,19,1,78,678,143,13,75,PRODUCTMETER,691,221
5,1,31,1,19,2,573,702,5,2,36,.,704,578
5,1,31,1,19,3,988,692,77,13,91,FACTEUR,705,1065
5,1,31,1,19,4,1176,693,57,14,92,LITRES,707,1233
5,1,31,1,19,5,1306,693,105,14,50,correctep,707,1411
5,1,31,1,19,6,1440,687,62,12,40,|TEMPC,699,1502
5,1,31,1,19,7,1511,683,10,34,92,|,717,1521
5,1,31,1,19,8,1535,695,70,14,0,DeNsite,709,1605
4,1,31,1,20,0,78,693,1513,38,-1,,731,1591
5,1,31,1,20,1,78,694,135,34,90,PRODUIT/METER,728,213
5,1,31,1,20,2,369,693,81,14,96,PRODUCT,707,450
5,1,31,1,20,3,456,694,111,13,90,DESCRIPTION,707,567
5,1,31,1,20,4,571,689,11,42,90,-,731,582
5,1,31,1,20,5,584,695,112,14,95,DESCRIPTION,709,696
5,1,31,1,20,6,702,695,23,14,95,DU,709,725
5,1,31,1,20,7,732,696,73,13,95,PRODUIT,709,805
5,1,31,1,20,8,987,711,26,13,65,API,724,1013
5,1,31,1,20,9,1019,711,52,14,65,TABLE,725,1071
5,1,31,1,20,10,1163,712,91,14,84,MESUREES,726,1254
5,1,31,1,20,11,1331,713,63,14,32,TO1SC,727,1394
5,1,31,1,20,12,1412,703,12,34,72,â,737,1424
5,1,31,1,20,13,1440,714,70,13,0,CELSIUS,727,1510
5,1,31,1,20,14,1534,714,57,17,38,kgicu.m,731,1591
4,1,31,1,21,0,148,740,1424,33,-1,,773,1572
5,1,31,1,21,1,148,740,93,19,96,103265,759,241
5,1,31,1,21,2,257,736,15,34,94,|,770,272
5,1,31,1,21,3,277,742,49,18,96,NOT,760,326
5,1,31,1,21,4,344,742,148,19,96,REGULATED,761,492
5,1,31,1,21,5,509,744,83,17,96,UNDER,761,592
5,1,31,1,21,6,610,745,48,18,96,TDG,763,658
5,1,31,1,21,7,935,750,1,10,57,|,760,936
5,1,31,1,21,8,978,745,94,20,85,0.9613,765,1072
5,1,31,1,21,9,1161,747,79,26,96,23500,773,1240
5,1,31,1,21,10,1310,748,80,19,95,22591,767,1390
5,1,31,1,21,11,1445,748,61,19,24,65.6,767,1506
5,1,31,1,21,12,1528,749,44,18,24,/913,767,1572
4,1,31,1,22,0,145,771,930,24,-1,,795,1075
5,1,31,1,22,1,145,771,96,18,92,MTR221,789,241
5,1,31,1,22,2,252,764,16,37,93,|,801,268
5,1,31,1,22,3,277,773,65,18,86,HVGO,791,342
5,1,31,1,22,4,935,772,1,9,95,|,781,936
5,1,31,1,22,5,958,778,49,17,92,API,795,1007
5,1,31,1,22,6,1029,777,46,18,78,54B,795,1075
4,1,31,1,23,0,147,832,1425,27,-1,,859,1572
5,1,31,1,23,1,147,832,93,19,96,103265,851,240
5,1,31,1,23,2,256,828,15,34,95,|,862,271
5,1,31,1,23,3,276,834,49,18,96,NOT,852,325
5,1,31,1,23,4,344,834,147,19,96,REGULATED,853,491
5,1,31,1,23,5,509,836,82,17,96,UNDER,853,591
5,1,31,1,23,6,609,836,49,18,96,TDG,854,658
5,1,31,1,23,7,978,837,95,19,94,0.9610,856,1073
5,1,31,1,23,8,1161,838,78,19,96,24500,857,1239
5,1,31,1,23,9,1310,839,79,19,95,23545,858,1389
5,1,31,1,23,10,1445,840,61,19,11,66.0,859,1506
5,1,31,1,23,11,1527,840,45,19,11,/913,859,1572
4,1,31,1,24,0,145,863,929,24,-1,,887,1074
5,1,31,1,24,1,145,863,95,18,91,MTR222,881,240
5,1,31,1,24,2,253,859,16,32,93,|,891,269
5,1,31,1,24,3,276,865,66,18,92,HVGO,883,342
5,1,31,1,24,4,958,870,48,17,92,API,887,1006
5,1,31,1,24,5,1028,868,46,19,85,54B,887,1074
4,1,31,1,25,0,298,989,60,35,-1,,1024,358
5,1,31,1,25,1,298,989,60,35,81,oY,1024,358
4,1,31,1,26,0,366,999,118,47,-1,,1046,484
5,1,31,1,26,1,366,999,118,47,31,(o/py,1046,484
4,1,31,1,27,0,347,1057,126,43,-1,,1100,473
5,1,31,1,27,1,347,1057,126,43,38,FE7TRe,1100,473
4,1,31,1,28,0,309,1121,63,30,-1,,1151,372
5,1,31,1,28,1,309,1121,63,30,50,Uae,1151,372
4,1,31,1,29,0,292,1123,271,56,-1,,1179,563
5,1,31,1,29,1,292,1123,19,31,58,=,1154,311
5,1,31,1,29,2,384,1133,94,38,49,12:66,1171,478
5,1,31,1,29,3,507,1151,56,28,20,ry,1179,563
4,1,31,1,30,0,272,1194,1011,54,-1,,1248,1283
5,1,31,1,30,1,272,1194,82,33,43,1â,1227,354
5,1,31,1,30,2,370,1206,99,40,41,18145,1246,469
5,1,31,1,30,3,492,1214,61,34,73,Am,1248,553
5,1,31,1,30,4,1281,1223,2,7,68,|,1230,1283
4,1,31,1,31,0,311,1415,378,25,-1,,1440,689
5,1,31,1,31,1,311,1416,78,18,96,Total,1434,389
5,1,31,1,31,2,408,1415,97,20,96,Litres,1435,505
5,1,31,1,31,3,525,1417,33,23,96,by,1440,558
5,1,31,1,31,4,576,1417,113,19,96,Product,1436,689
4,1,31,1,32,0,278,1445,1110,25,-1,,1470,1388
5,1,31,1,32,1,278,1445,94,20,95,103265,1465,372
5,1,31,1,32,2,475,1448,65,17,90,HVGO,1465,540
5,1,31,1,32,3,1160,1449,78,20,96,48000,1469,1238
5,1,31,1,32,4,1310,1450,78,20,95,46136,1470,1388
4,1,31,1,33,0,1433,1687,2,12,-1,,1699,1435
5,1,31,1,33,1,1433,1687,2,12,74,|,1699,1435
4,1,31,1,34,0,1433,1719,3,17,-1,,1736,1436
5,1,31,1,34,1,1433,1719,3,17,62,|,1736,1436
4,1,31,1,35,0,76,1734,1495,39,-1,,1773,1571
5,1,31,1,35,1,76,1738,61,14,96,DRIVER,1752,137
5,1,31,1,35,2,142,1739,95,13,93,SIGNATURE,1752,237
5,1,31,1,35,3,242,1746,5,2,91,-,1748,247
5,1,31,1,35,4,254,1739,95,13,91,SIGNATURE,1752,349
5,1,31,1,35,5,354,1740,23,12,90,DU,1752,377
5,1,31,1,35,6,383,1740,117,13,90,CONDUCTEUR,1753,500
5,1,31,1,35,7,858,1734,65,39,0,anaivee,1773,923
5,1,31,1,35,8,1027,1739,73,24,74,DEBUT,1763,1100
5,1,31,1,35,9,1078,1735,20,39,74,DU,1774,1098
5,1,31,1,35,10,1102,1739,99,24,78,CHARGEMENT,1763,1201
5,1,31,1,35,11,1208,1735,10,39,87,|,1774,1218
5,1,31,1,35,12,1244,1740,22,23,63,FIN,1763,1266
5,1,31,1,35,13,1273,1740,16,23,60,DU,1763,1289
5,1,31,1,35,14,1291,1740,102,24,39,CHARGESENT,1764,1393
5,1,31,1,35,15,1504,1741,67,24,52,DEPART,1765,1571
4,1,31,1,36,0,61,1773,1492,51,-1,,1824,1553
5,1,31,1,36,1,61,1773,49,51,77,X,1824,110
5,1,31,1,36,2,858,1786,79,19,81,23:15,1805,937
5,1,31,1,36,3,1058,1787,80,19,92,23:18,1806,1138
5,1,31,1,36,4,1276,1788,78,18,82,23:33,1806,1354
5,1,31,1,36,5,1476,1789,77,19,86,23:33,1808,1553
4,1,31,1,37,0,76,1814,1495,24,-1,,1838,1571
5,1,31,1,37,1,76,1817,60,13,96,DRIVER,1830,136
5,1,31,1,37,2,142,1817,47,14,91,NAME,1831,189
5,1,31,1,37,3,194,1825,5,3,91,-,1828,199
5,1,31,1,37,4,205,1818,36,14,96,NOM,1832,241
5,1,31,1,37,5,247,1814,23,18,92,DU,1832,270
5,1,31,1,37,6,276,1819,117,13,91,CONDUCTEUR,1832,393
5,1,31,1,37,7,594,1819,61,14,30,DRIVER,1833,655
5,1,31,1,37,8,662,1820,71,14,96,NUMBER,1834,733
5,1,31,1,37,9,1282,1823,53,13,94,TOTAL,1836,1335
5,1,31,1,37,10,1341,1823,84,14,93,QUANTITY,1837,1425
5,1,31,1,37,11,1430,1830,5,3,86,-,1833,1435
5,1,31,1,37,12,1440,1823,61,15,87,QUANT.,1838,1501
5,1,31,1,37,13,1507,1823,64,14,93,TOTALE,1837,1571
4,1,31,1,38,0,580,1834,908,35,-1,,1869,1488
5,1,31,1,38,1,580,1834,20,14,82,No,1848,600
5,1,31,1,38,2,606,1834,145,14,0,DUCONDUGTEUR,1848,751
5,1,31,1,38,3,760,1837,9,9,0,*,1846,769
5,1,31,1,38,4,778,1837,93,23,86,Volume,1860,871
5,1,31,1,38,5,880,1839,114,21,95,corrected,1860,994
5,1,31,1,38,6,1004,1839,21,21,96,to,1860,1025
5,1,31,1,38,7,1037,1839,28,22,96,15,1861,1065
5,1,31,1,38,8,1075,1839,102,28,93,Degrees,1867,1177
5,1,31,1,38,9,1187,1839,18,22,85,C,1861,1205
5,1,31,1,38,10,1214,1839,10,10,85,*,1849,1224
5,1,31,1,38,11,1292,1850,79,18,96,48000,1868,1371
5,1,31,1,38,12,1391,1848,97,21,96,Litres,1869,1488
4,1,31,1,39,0,145,1876,1273,23,-1,,1899,1418
5,1,31,1,39,1,145,1876,114,18,49,SANJEEV,1894,259
5,1,31,1,39,2,293,1878,81,17,49,KUMAR,1895,374
5,1,31,1,39,3,609,1878,128,18,95,56017257,1896,737
5,1,31,1,39,4,1292,1880,78,19,45,42122,1899,1370
5,1,31,1,39,5,1392,1880,26,19,45,kg,1899,1418
2,1,32,0,0,0,83,1906,68,29,-1,,1935,151
3,1,32,1,0,0,83,1906,68,29,-1,,1935,151
4,1,32,1,1,0,83,1906,68,12,-1,,1918,151
5,1,32,1,1,1,83,1906,68,12,95,PRODUCT,1918,151
4,1,32,1,2,0,86,1924,61,11,-1,,1935,147
5,1,32,1,2,1,86,1924,61,11,96,PRODUIT,1935,147
2,1,33,0,0,0,223,1908,110,44,-1,,1952,333
3,1,33,1,0,0,223,1908,110,44,-1,,1952,333
4,1,33,1,1,0,223,1908,110,11,-1,,1919,333
5,1,33,1,1,1,223,1908,36,10,88,TANK,1918,259
5,1,33,1,1,2,264,1908,69,11,68,CAPACITY,1919,333
4,1,33,1,2,0,226,1924,95,12,-1,,1936,321
5,1,33,1,2,1,226,1924,95,12,0,CONTENANCE,1936,321
4,1,33,1,3,0,224,1940,103,12,-1,,1952,327
5,1,33,1,3,1,224,1940,18,11,92,DU,1951,242
5,1,33,1,3,2,248,1940,79,12,92,RESERVIOR,1952,327
2,1,34,0,0,0,392,1925,67,28,-1,,1953,459
3,1,34,1,0,0,392,1925,67,28,-1,,1953,459
4,1,34,1,1,0,392,1925,67,11,-1,,1936,459
5,1,34,1,1,1,392,1925,67,11,69,MEASURE,1936,459
4,1,34,1,2,0,394,1941,63,12,-1,,1953,457
5,1,34,1,2,1,394,1941,63,12,32,DEAU/CM,1953,457
2,1,35,0,0,0,374,1908,207,51,-1,,1959,581
3,1,35,1,0,0,374,1908,207,51,-1,,1959,581
4,1,35,1,1,0,374,1908,207,12,-1,,1920,581
5,1,35,1,1,1,374,1908,50,12,87,WATER,1920,424
5,1,35,1,1,2,429,1908,47,12,74,DIP/CM,1920,476
5,1,35,1,1,3,479,1899,6,32,74,|,1931,485
5,1,35,1,1,4,488,1909,56,11,96,BEFORE,1920,544
5,1,35,1,1,5,549,1909,32,11,92,DIPS,1920,581
4,1,35,1,2,0,502,1926,66,11,-1,,1937,568
5,1,35,1,2,1,502,1926,45,10,83,AVANT,1936,547
5,1,35,1,2,2,552,1926,16,11,83,LE,1937,568
4,1,35,1,3,0,484,1941,89,18,-1,,1959,573
5,1,35,1,3,1,484,1941,89,18,74,_JAUGEAGE,1959,573
2,1,36,0,0,0,604,1909,81,44,-1,,1953,685
3,1,36,1,0,0,604,1909,81,44,-1,,1953,685
4,1,36,1,1,0,604,1909,81,12,-1,,1921,685
5,1,36,1,1,1,604,1909,45,11,93,AFTER,1920,649
5,1,36,1,1,2,654,1910,31,11,65,DIPS.,1921,685
4,1,36,1,2,0,612,1926,68,11,-1,,1937,680
5,1,36,1,2,1,612,1926,47,11,92,APRES,1937,659
5,1,36,1,2,2,664,1926,16,11,96,LE,1937,680
4,1,36,1,3,0,610,1942,75,11,-1,,1953,685
5,1,36,1,3,1,610,1942,75,11,92,JAUGEAGE,1953,685
2,1,37,0,0,0,713,1910,108,44,-1,,1954,821
3,1,37,1,0,0,713,1910,108,44,-1,,1954,821
4,1,37,1,1,0,713,1910,108,12,-1,,1922,821
5,1,37,1,1,1,713,1910,52,11,96,ENDING,1921,765
5,1,37,1,1,2,771,1910,50,12,96,INVENT,1922,821
4,1,37,1,2,0,727,1927,82,10,-1,,1937,809
5,1,37,1,2,1,727,1927,82,10,92,INVENTAIRE,1937,809
4,1,37,1,3,0,743,1943,46,11,-1,,1954,789
5,1,37,1,3,1,743,1943,46,11,32,APRES:,1954,789
2,1,38,0,0,0,866,1911,67,27,-1,,1938,933
3,1,38,1,0,0,866,1911,67,27,-1,,1938,933
4,1,38,1,1,0,866,1911,67,11,-1,,1922,933
5,1,38,1,1,1,866,1911,67,11,96,PRODUCT,1922,933
4,1,38,1,2,0,868,1928,62,10,-1,,1938,930
5,1,38,1,2,1,868,1928,62,10,95,PRODUIT,1938,930
2,1,39,0,0,0,1004,1911,110,44,-1,,1955,1114
3,1,39,1,0,0,1004,1911,110,44,-1,,1955,1114
4,1,39,1,1,0,1004,1911,110,12,-1,,1923,1114
5,1,39,1,1,1,1004,1911,37,11,94,TANK,1922,1041
5,1,39,1,1,2,1045,1911,69,12,84,CAPACITY,1923,1114
4,1,39,1,2,0,1007,1928,96,11,-1,,1939,1103
5,1,39,1,2,1,1007,1928,96,11,88,CONTENANCE,1939,1103
4,1,39,1,3,0,1004,1944,105,11,-1,,1955,1109
5,1,39,1,3,1,1004,1944,19,11,91,DU,1955,1023
5,1,39,1,3,2,1028,1944,81,11,70,RESERVIOR,1955,1109
2,1,40,0,0,0,1157,1912,102,44,-1,,1956,1259
3,1,40,1,0,0,1157,1912,102,44,-1,,1956,1259
4,1,40,1,1,0,1157,1912,102,12,-1,,1924,1259
5,1,40,1,1,1,1157,1912,50,11,93,WATER,1923,1207
5,1,40,1,1,2,1212,1912,47,12,55,DIPICM,1924,1259
4,1,40,1,2,0,1172,1929,67,10,-1,,1939,1239
5,1,40,1,2,1,1172,1929,67,10,73,MEASURE,1939,1239
4,1,40,1,3,0,1174,1945,63,11,-1,,1956,1237
5,1,40,1,3,1,1174,1945,63,11,87,DEAUICM,1956,1237
2,1,41,0,0,0,1277,1912,92,45,-1,,1957,1369
3,1,41,1,0,0,1277,1912,92,45,-1,,1957,1369
4,1,41,1,1,0,1277,1912,92,12,-1,,1924,1369
5,1,41,1,1,1,1277,1912,56,12,88,@EFORE,1924,1333
5,1,41,1,1,2,1338,1913,31,11,86,DIPS,1924,1369
4,1,41,1,2,0,1284,1929,67,10,-1,,1939,1351
5,1,41,1,2,1,1284,1929,47,10,75,AVANT,1939,1331
5,1,41,1,2,2,1336,1930,15,9,92,LE,1939,1351
4,1,41,1,3,0,1282,1945,75,12,-1,,1957,1357
5,1,41,1,3,1,1282,1945,75,12,86,JAUGEAGE,1957,1357
2,1,42,0,0,0,1388,1913,81,44,-1,,1957,1469
3,1,42,1,0,0,1388,1913,81,44,-1,,1957,1469
4,1,42,1,1,0,1388,1913,81,11,-1,,1924,1469
5,1,42,1,1,1,1388,1913,45,11,96,AFTER,1924,1433
5,1,42,1,1,2,1438,1913,31,11,64,DIPS,1924,1469
4,1,42,1,2,0,1393,1930,68,10,-1,,1940,1461
5,1,42,1,2,1,1393,1930,47,10,92,APRES,1940,1440
5,1,42,1,2,2,1444,1930,17,10,96,LE,1940,1461
4,1,42,1,3,0,1394,1945,75,12,-1,,1957,1469
5,1,42,1,3,1,1394,1945,75,12,88,JAUGEAGE,1957,1469
2,1,43,0,0,0,1622,135,15,1765,-1,,1900,1637
3,1,43,1,0,0,1622,135,15,1765,-1,,1900,1637
4,1,43,1,1,0,1622,135,15,1765,-1,,1900,1637
5,1,43,1,1,1,1622,135,15,1765,95, ,1900,1637
2,1,44,0,0,0,1499,1913,108,44,-1,,1957,1607
3,1,44,1,0,0,1499,1913,108,44,-1,,1957,1607
4,1,44,1,1,0,1499,1913,108,12,-1,,1925,1607
5,1,44,1,1,1,1499,1913,52,11,96,ENDING,1924,1551
5,1,44,1,1,2,1556,1913,51,12,96,INVENT,1925,1607
4,1,44,1,2,0,1514,1930,81,11,-1,,1941,1595
5,1,44,1,2,1,1514,1930,81,11,66,INVENTAIRE,1941,1595
4,1,44,1,3,0,1526,1946,47,11,-1,,1957,1573
5,1,44,1,3,1,1526,1946,47,11,92,APRES,1957,1573
2,1,45,0,0,0,64,1955,1561,9,-1,,1964,1625
3,1,45,1,0,0,64,1955,1561,9,-1,,1964,1625
4,1,45,1,1,0,64,1955,1561,9,-1,,1964,1625
5,1,45,1,1,1,64,1955,1561,9,95, ,1964,1625
2,1,46,0,0,0,64,2017,1561,9,-1,,2026,1625
3,1,46,1,0,0,64,2017,1561,9,-1,,2026,1625
4,1,46,1,1,0,64,2017,1561,9,-1,,2026,1625
5,1,46,1,1,1,64,2017,1561,9,95, ,2026,1625
2,1,47,0,0,0,64,2078,1560,9,-1,,2087,1624
3,1,47,1,0,0,64,2078,1560,9,-1,,2087,1624
4,1,47,1,1,0,64,2078,1560,9,-1,,2087,1624
5,1,47,1,1,1,64,2078,1560,9,95, ,2087,1624
2,1,48,0,0,0,479,1960,4,176,-1,,2136,483
3,1,48,1,0,0,479,1960,4,176,-1,,2136,483
4,1,48,1,1,0,479,1960,4,176,-1,,2136,483
5,1,48,1,1,1,479,1960,4,176,95, ,2136,483
2,1,49,0,0,0,39,2161,344,17,-1,,2178,383
3,1,49,1,0,0,39,2161,344,17,-1,,2178,383
4,1,49,1,1,0,39,2161,344,17,-1,,2178,383
5,1,49,1,1,1,39,2161,11,13,89,A,2174,50
5,1,49,1,1,2,55,2161,51,13,89,Suncor,2174,106
5,1,49,1,1,3,112,2161,64,13,93,business,2174,176
5,1,49,1,1,4,182,2161,4,13,93,/,2174,186
5,1,49,1,1,5,193,2161,29,13,93,Une,2174,222
5,1,49,1,1,6,228,2161,73,17,59,entreprisa,2178,301
5,1,49,1,1,7,307,2161,18,13,96,de,2174,325
5,1,49,1,1,8,330,2161,53,14,37,Suncor,2175,383
2,1,50,0,0,0,591,1903,2,237,-1,,2140,593
3,1,50,1,0,0,591,1903,2,237,-1,,2140,593
4,1,50,1,1,0,591,1903,2,237,-1,,2140,593
5,1,50,1,1,1,591,1903,2,237,95, ,2140,593
2,1,51,0,0,0,55,1883,1579,270,-1,,2153,1634
3,1,51,1,0,0,55,1883,1579,270,-1,,2153,1634
4,1,51,1,1,0,55,1883,1579,270,-1,,2153,1634
5,1,51,1,1,1,55,1883,1579,270,95, ,2153,1634
2,1,52,0,0,0,950,1904,4,238,-1,,2142,954
3,1,52,1,0,0,950,1904,4,238,-1,,2142,954
4,1,52,1,1,0,950,1904,4,238,-1,,2142,954
5,1,52,1,1,1,950,1904,4,238,95, ,2142,954
2,1,53,0,0,0,1262,1905,4,237,-1,,2142,1266
3,1,53,1,0,0,1262,1905,4,237,-1,,2142,1266
4,1,53,1,1,0,1262,1905,4,237,-1,,2142,1266
5,1,53,1,1,1,1262,1905,4,237,95, ,2142,1266
2,1,54,0,0,0,1373,1906,4,237,-1,,2143,1377
3,1,54,1,0,0,1373,1906,4,237,-1,,2143,1377
4,1,54,1,1,0,1373,1906,4,237,-1,,2143,1377
5,1,54,1,1,1,1373,1906,4,237,95, ,2143,1377
2,1,55,0,0,0,1552,2163,110,16,-1,,2179,1662
3,1,55,1,0,0,1552,2163,110,16,-1,,2179,1662
4,1,55,1,1,0,1552,2163,110,16,-1,,2179,1662
5,1,55,1,1,1,1552,2164,53,11,76,412791,2175,1605
5,1,55,1,1,2,1610,2163,52,16,89,(05/17),2179,1662
1,1,0,0,0,0,0,0,1700,2200,-1,,2200,1700
2,1,1,0,0,0,772,15,262,53,-1,,68,1034
3,1,1,1,0,0,772,15,262,53,-1,,68,1034
4,1,1,1,1,0,772,15,262,53,-1,,68,1034
5,1,1,1,1,1,772,15,62,48,1,GY,63,834
5,1,1,1,1,2,854,15,180,53,1,09048,68,1034
2,1,2,0,0,0,909,77,613,24,-1,,101,1522
3,1,2,1,0,0,909,77,613,24,-1,,101,1522
4,1,2,1,1,0,909,77,613,24,-1,,101,1522
5,1,2,1,1,1,909,77,117,21,95,VEHICLE,98,1026
5,1,2,1,1,2,1038,78,121,21,96,LOADING,99,1159
5,1,2,1,1,3,1171,78,113,21,93,REPORT,99,1284
5,1,2,1,1,4,1281,73,14,38,92,-,111,1295
5,1,2,1,1,5,1311,79,55,21,77,BILL,100,1366
5,1,2,1,1,6,1375,79,36,21,93,OF,100,1411
5,1,2,1,1,7,1422,79,100,22,91,LADING,101,1522
2,1,3,0,0,0,64,119,1564,21,-1,,140,1628
3,1,3,1,0,0,64,119,1564,21,-1,,140,1628
4,1,3,1,1,0,64,119,1564,21,-1,,140,1628
5,1,3,1,1,1,64,119,1564,21,95, ,140,1628
2,1,4,0,0,0,664,127,160,105,-1,,232,824
3,1,4,1,0,0,664,127,160,105,-1,,232,824
4,1,4,1,1,0,751,127,10,35,-1,,162,761
5,1,4,1,1,1,751,127,10,35,95,   ,162,761
4,1,4,1,2,0,664,162,135,39,-1,,201,799
5,1,4,1,2,1,664,162,135,39,95, ,201,799
4,1,4,1,3,0,664,201,160,31,-1,,232,824
5,1,4,1,3,1,664,201,160,31,95, ,232,824
2,1,5,0,0,0,820,220,812,13,-1,,233,1632
3,1,5,1,0,0,820,220,812,13,-1,,233,1632
4,1,5,1,1,0,820,220,812,13,-1,,233,1632
5,1,5,1,1,1,820,220,812,13,95, ,233,1632
2,1,6,0,0,0,64,217,604,10,-1,,227,668
3,1,6,1,0,0,64,217,604,10,-1,,227,668
4,1,6,1,1,0,64,217,604,10,-1,,227,668
5,1,6,1,1,1,64,217,604,10,95, ,227,668
2,1,7,0,0,0,668,246,11,40,-1,,286,679
3,1,7,1,0,0,668,246,11,40,-1,,286,679
4,1,7,1,1,0,668,246,11,40,-1,,286,679
5,1,7,1,1,1,668,246,11,40,95,  ,286,679
2,1,8,0,0,0,1449,227,2,62,-1,,289,1451
3,1,8,1,0,0,1449,227,2,62,-1,,289,1451
4,1,8,1,1,0,1449,227,2,62,-1,,289,1451
5,1,8,1,1,1,1449,227,2,62,95, ,289,1451
2,1,9,0,0,0,668,256,187,35,-1,,291,855
3,1,9,1,0,0,668,256,187,35,-1,,291,855
4,1,9,1,1,0,668,256,187,35,-1,,291,855
5,1,9,1,1,1,668,256,187,35,95,  ,291,855
2,1,10,0,0,0,270,395,582,9,-1,,404,852
3,1,10,1,0,0,270,395,582,9,-1,,404,852
4,1,10,1,1,0,270,395,582,9,-1,,404,852
5,1,10,1,1,1,270,395,582,9,95, ,404,852
2,1,11,0,0,0,850,224,4,247,-1,,471,854
3,1,11,1,0,0,850,224,4,247,-1,,471,854
4,1,11,1,1,0,850,224,4,247,-1,,471,854
5,1,11,1,1,1,850,224,4,247,95, ,471,854
2,1,12,0,0,0,560,399,2,71,-1,,470,562
3,1,12,1,0,0,560,399,2,71,-1,,470,562
4,1,12,1,1,0,560,399,2,71,-1,,470,562
5,1,12,1,1,1,560,399,2,71,95, ,470,562
2,1,13,0,0,0,63,458,1567,22,-1,,480,1630
3,1,13,1,0,0,63,458,1567,22,-1,,480,1630
4,1,13,1,1,0,63,458,1567,22,-1,,480,1630
5,1,13,1,1,1,63,458,1567,22,95, ,480,1630
2,1,14,0,0,0,1099,470,5,196,-1,,666,1104
3,1,14,1,0,0,1099,470,5,196,-1,,666,1104
4,1,14,1,1,0,1099,470,5,196,-1,,666,1104
5,1,14,1,1,1,1099,470,5,196,95, ,666,1104
2,1,15,0,0,0,710,471,6,193,-1,,664,716
3,1,15,1,0,0,710,471,6,193,-1,,664,716
4,1,15,1,1,0,710,471,6,193,-1,,664,716
5,1,15,1,1,1,710,471,6,193,95, ,664,716
2,1,16,0,0,0,62,652,1565,22,-1,,674,1627
3,1,16,1,0,0,62,652,1565,22,-1,,674,1627
4,1,16,1,1,0,62,652,1565,22,-1,,674,1627
5,1,16,1,1,1,62,652,1565,22,95, ,674,1627
2,1,17,0,0,0,63,722,1567,21,-1,,743,1630
3,1,17,1,0,0,63,722,1567,21,-1,,743,1630
4,1,17,1,1,0,63,722,1567,21,-1,,743,1630
5,1,17,1,1,1,63,722,1567,21,95, ,743,1630
2,1,18,0,0,0,248,660,16,1072,-1,,1732,264
3,1,18,1,0,0,248,660,16,1072,-1,,1732,264
4,1,18,1,1,0,248,660,16,1072,-1,,1732,264
5,1,18,1,1,1,248,660,16,1072,95, ,1732,264
2,1,19,0,0,0,1120,664,17,1065,-1,,1729,1137
3,1,19,1,0,0,1120,664,17,1065,-1,,1729,1137
4,1,19,1,1,0,1120,664,17,1065,-1,,1729,1137
5,1,19,1,1,1,1120,664,17,1065,95, ,1729,1137
2,1,20,0,0,0,1426,665,17,1071,-1,,1736,1443
3,1,20,1,0,0,1426,665,17,1071,-1,,1736,1443
4,1,20,1,1,0,1426,665,17,1071,-1,,1736,1443
5,1,20,1,1,1,1426,665,17,1071,95, ,1736,1443
2,1,21,0,0,0,1509,669,17,1068,-1,,1737,1526
3,1,21,1,0,0,1509,669,17,1068,-1,,1737,1526
4,1,21,1,1,0,1509,669,17,1068,-1,,1737,1526
5,1,21,1,1,1,1509,669,17,1068,95, ,1737,1526
2,1,22,0,0,0,1273,670,17,1063,-1,,1733,1290
3,1,22,1,0,0,1273,670,17,1063,-1,,1733,1290
4,1,22,1,1,0,1273,670,17,1063,-1,,1733,1290
5,1,22,1,1,1,1273,670,17,1063,95, ,1733,1290
2,1,23,0,0,0,925,664,17,1071,-1,,1735,942
3,1,23,1,0,0,925,664,17,1071,-1,,1735,942
4,1,23,1,1,0,925,664,17,1071,-1,,1735,942
5,1,23,1,1,1,925,664,17,1071,95, ,1735,942
2,1,24,0,0,0,96,1723,1532,21,-1,,1744,1628
3,1,24,1,0,0,96,1723,1532,21,-1,,1744,1628
4,1,24,1,1,0,96,1723,1532,21,-1,,1744,1628
5,1,24,1,1,1,96,1723,1532,21,95, ,1744,1628
2,1,25,0,0,0,1000,1733,4,86,-1,,1819,1004
3,1,25,1,0,0,1000,1733,4,86,-1,,1819,1004
4,1,25,1,1,0,1000,1733,4,86,-1,,1819,1004
5,1,25,1,1,1,1000,1733,4,86,95, ,1819,1004
2,1,26,0,0,0,1210,1736,2,81,-1,,1817,1212
3,1,26,1,0,0,1210,1736,2,81,-1,,1817,1212
4,1,26,1,1,0,1210,1736,2,81,-1,,1817,1212
5,1,26,1,1,1,1210,1736,2,81,95, ,1817,1212
2,1,27,0,0,0,81,1807,1547,20,-1,,1827,1628
3,1,27,1,0,0,81,1807,1547,20,-1,,1827,1628
4,1,27,1,1,0,81,1807,1547,20,-1,,1827,1628
5,1,27,1,1,1,81,1807,1547,20,95, ,1827,1628
2,1,28,0,0,0,1615,132,27,1771,-1,,1903,1642
3,1,28,1,0,0,1615,132,27,1771,-1,,1903,1642
4,1,28,1,1,0,1615,132,27,1771,-1,,1903,1642
5,1,28,1,1,1,1615,132,27,1771,95, ,1903,1642
2,1,29,0,0,0,65,104,1563,1797,-1,,1901,1628
3,1,29,1,0,0,65,104,1563,1797,-1,,1901,1628
4,1,29,1,1,0,148,104,1480,26,-1,,130,1628
5,1,29,1,1,1,148,104,74,23,94,Page:,127,222
5,1,29,1,1,2,247,104,12,18,94,1,122,259
5,1,29,1,1,3,475,106,49,24,96,530,130,524
5,1,29,1,1,4,815,104,130,22,95,RAPPORT,126,945
5,1,29,1,1,5,956,104,34,22,91,DE,126,990
5,1,29,1,1,6,1001,104,359,23,91,CHARGEMENT,127,1360
5,1,29,1,1,7,1199,100,16,37,91,-,137,1215
5,1,29,1,1,8,1230,104,124,23,91,VEHICULE,127,1354
5,1,29,1,1,9,1372,118,6,4,91,-,122,1378
5,1,29,1,1,10,1387,106,241,22,91,CONNAISSEMENT,128,1628
4,1,29,1,2,0,136,131,536,26,-1,,157,672
5,1,29,1,2,1,136,134,110,15,0,DOCUMENT,149,246
5,1,29,1,2,2,252,134,83,15,0,NUMBER,149,335
5,1,29,1,2,3,362,136,62,18,90,1659,154,424
5,1,29,1,2,4,478,131,1,21,78,|,152,479
5,1,29,1,2,5,535,132,46,24,0,perce,156,581
5,1,29,1,2,6,587,132,59,24,0,SHFSD,156,646
4,1,29,1,3,0,136,152,173,16,-1,,168,309
5,1,29,1,3,1,136,152,11,15,96,No,167,147
5,1,29,1,3,2,166,152,25,15,94,DU,167,191
5,1,29,1,3,3,199,153,110,15,95,DOCUMENT,168,309
4,1,29,1,4,0,148,156,1462,42,-1,,198,1610
5,1,29,1,4,1,148,156,11,11,89,Â°,167,159
5,1,29,1,4,2,522,161,137,37,95,mm/dd/yy,198,659
5,1,29,1,4,3,799,168,29,21,95,24,189,828
5,1,29,1,4,4,839,168,78,22,95,HOUR,190,917
5,1,29,1,4,5,927,169,118,21,67,NUMBER,190,1045
5,1,29,1,4,6,1066,168,68,21,19,(403),189,1134
5,1,29,1,4,7,1144,168,129,19,19,296-3000,187,1273
5,1,29,1,4,8,1310,171,138,21,54,-NUMERO,192,1448
5,1,29,1,4,9,1458,172,28,20,93,24,192,1486
5,1,29,1,4,10,1498,172,112,21,93,HEURES,193,1610
4,1,29,1,5,0,148,193,1224,29,-1,,222,1372
5,1,29,1,5,1,148,193,111,19,95,0114751,212,259
5,1,29,1,5,2,280,194,93,20,94,10/002,214,373
5,1,29,1,5,3,528,195,129,20,96,10/08/24,215,657
5,1,29,1,5,4,1048,200,233,22,93,COLLECT,222,1281
5,1,29,1,5,5,1180,189,13,38,90,-,227,1193
5,1,29,1,5,6,1208,200,71,22,89,FRAIS,222,1279
5,1,29,1,5,7,1290,200,82,22,91,VIRES,222,1372
4,1,29,1,6,0,77,225,1537,28,-1,,253,1614
5,1,29,1,6,1,77,225,198,14,42,CONSIGNEE/CUSTOMER,239,275
5,1,29,1,6,2,280,233,5,3,91,-,236,285
5,1,29,1,6,3,290,226,183,14,92,DESTINATAIRE/CLIENT,240,473
5,1,29,1,6,4,688,239,16,11,10,pee,250,704
5,1,29,1,6,5,730,238,18,12,0,a,250,748
5,1,29,1,6,6,750,238,87,12,0,gtisectienr,250,837
5,1,29,1,6,7,849,221,9,33,92,|,254,858
5,1,29,1,6,8,862,229,101,14,92,CONSIGNOR,243,963
5,1,29,1,6,9,969,236,4,3,92,-,239,973
5,1,29,1,6,10,980,230,105,13,92,EXPEDITEUR,243,1085
5,1,29,1,6,11,1465,223,67,34,20,LOCATION,257,1532
5,1,29,1,6,12,1543,223,49,34,47,ROE,257,1592
4,1,29,1,7,0,145,253,1427,28,-1,,281,1572
5,1,29,1,7,1,145,253,182,25,96,Mississauga,278,327
5,1,29,1,7,2,344,255,80,19,96,Lubes,274,424
5,1,29,1,7,3,444,257,97,18,96,Center,275,541
5,1,29,1,7,4,679,256,160,20,91,0000081523,276,839
5,1,29,1,7,5,858,256,183,25,91,|Mississauga,281,1041
5,1,29,1,7,6,1059,258,81,20,96,Lubes,278,1140
5,1,29,1,7,7,1159,260,99,18,96,Center,278,1258
5,1,29,1,7,8,1461,260,111,20,95,0081523,280,1572
4,1,29,1,8,0,147,285,1011,30,-1,,315,1158
5,1,29,1,8,1,147,285,45,19,96,385,304,192
5,1,29,1,8,2,214,286,145,19,96,Southdown,305,359
5,1,29,1,8,3,377,286,66,19,96,Road,305,443
5,1,29,1,8,4,679,288,161,19,32,0000000104,307,840
5,1,29,1,8,5,860,289,45,26,32,|385,315,905
5,1,29,1,8,6,927,289,147,20,96,Southdown,309,1074
5,1,29,1,8,7,1092,290,66,19,96,Road,309,1158
4,1,29,1,9,0,144,315,1061,29,-1,,344,1205
5,1,29,1,9,1,144,315,176,25,90,"Missisauga,",340,320
5,1,29,1,9,2,344,318,33,19,93,ON,337,377
5,1,29,1,9,3,394,318,95,19,50,L5J2Â¥2,337,489
5,1,29,1,9,4,858,319,176,25,91,"Missisauga,",344,1034
5,1,29,1,9,5,1059,322,32,18,93,ON,340,1091
5,1,29,1,9,6,1109,321,96,20,0,L5Jd2v2,341,1205
4,1,29,1,10,0,270,399,582,31,-1,,430,852
5,1,29,1,10,1,270,399,2,31,66,|,430,272
5,1,29,1,10,2,278,402,62,11,92,RELEASE,413,340
5,1,29,1,10,3,346,402,47,14,89,(C-of-A),416,393
5,1,29,1,10,4,398,402,59,11,48,NUMBER:,413,457
5,1,29,1,10,5,568,403,78,11,95,CUSTOMER,414,646
5,1,29,1,10,6,651,403,76,12,95,PURCHASE,415,727
5,1,29,1,10,7,733,404,48,11,96,ORDER,415,781
5,1,29,1,10,8,787,404,58,11,96,NUMBER,415,845
5,1,29,1,10,9,851,403,1,16,95,|,419,852
4,1,29,1,11,0,618,417,233,17,-1,,434,851
5,1,29,1,11,1,618,417,17,11,82,No,428,635
5,1,29,1,11,2,639,417,19,11,96,DE,428,658
5,1,29,1,11,3,663,418,68,10,96,DEMANDE,428,731
5,1,29,1,11,4,736,418,18,11,71,OU,429,754
5,1,29,1,11,5,759,418,49,11,96,CLIENT,429,808
5,1,29,1,11,6,850,429,1,5,48,|,434,851
4,1,29,1,12,0,270,440,1,11,-1,,451,271
5,1,29,1,12,1,270,440,1,11,79,|,451,271
4,1,29,1,13,0,76,453,1338,44,-1,,497,1414
5,1,29,1,13,1,76,476,73,13,82,CARRIER,489,149
5,1,29,1,13,2,155,482,4,3,77,-,485,159
5,1,29,1,13,3,164,453,137,44,75,TRANSPORTEUR,497,301
5,1,29,1,13,4,733,476,71,13,94,VEHICLE,489,804
5,1,29,1,13,5,811,476,69,14,94,NUMBER,490,880
5,1,29,1,13,6,922,476,70,14,42,LICENSE,490,992
5,1,29,1,13,7,998,477,71,13,96,NUMBER,490,1069
5,1,29,1,13,8,1130,478,80,13,68,ADDRESS,491,1210
5,1,29,1,13,9,1216,478,22,13,96,OF,491,1238
5,1,29,1,13,10,1244,478,58,13,96,METER,491,1302
5,1,29,1,13,11,1307,478,34,13,96,AND,491,1341
5,1,29,1,13,12,1347,478,67,14,96,TRADER,492,1414
4,1,29,1,14,0,146,498,1334,22,-1,,520,1480
5,1,29,1,14,1,146,500,113,18,96,PREMIER,518,259
5,1,29,1,14,2,278,502,65,17,96,BULK,519,343
5,1,29,1,14,3,361,501,112,19,96,SYSTEMS,520,473
5,1,29,1,14,4,577,502,112,18,96,5000234,520,689
5,1,29,1,14,5,704,489,15,35,92,|,524,719
5,1,29,1,14,6,737,498,135,14,85,NoDUVEHICULE,512,872
5,1,29,1,14,7,896,489,16,35,24,=,524,912
5,1,29,1,14,8,922,499,72,13,0,NOMBRE,512,994
5,1,29,1,14,9,1000,500,21,13,0,DE,513,1021
5,1,29,1,14,10,1028,500,62,13,83,PERMIS,513,1090
5,1,29,1,14,11,1098,489,9,35,93,|,524,1107
5,1,29,1,14,12,1117,500,91,13,72,L'ADRESSE,513,1208
5,1,29,1,14,13,1215,500,21,13,95,DE,513,1236
5,1,29,1,14,14,1242,500,58,14,95,METRE,514,1300
5,1,29,1,14,15,1306,500,20,14,96,ET,514,1326
5,1,29,1,14,16,1332,500,21,14,93,DE,514,1353
5,1,29,1,14,17,1359,500,121,14,92,COMMERCANT,514,1480
4,1,29,1,15,0,146,530,1326,27,-1,,557,1472
5,1,29,1,15,1,146,530,28,18,96,25,548,174
5,1,29,1,15,2,194,530,115,23,96,Gormley,553,309
5,1,29,1,15,3,328,530,161,20,96,Industrial,550,489
5,1,29,1,15,4,508,533,33,17,96,Dr,550,541
5,1,29,1,15,5,727,532,94,19,95,919322,551,821
5,1,29,1,15,6,1110,535,97,18,95,Suncor,553,1207
5,1,29,1,15,7,1226,536,99,21,96,Energy,557,1325
5,1,29,1,15,8,1343,534,129,20,96,Products,554,1472
4,1,29,1,16,0,144,557,1278,32,-1,,589,1422
5,1,29,1,16,1,144,557,115,32,96,GORMLEY,589,259
5,1,29,1,16,2,727,563,78,19,96,51202,582,805
5,1,29,1,16,3,1109,564,63,19,96,3275,583,1172
5,1,29,1,16,4,1192,564,116,20,96,Rebecca,584,1308
5,1,29,1,16,5,1327,566,95,18,96,Street,584,1422
4,1,29,1,17,0,144,591,526,25,-1,,616,670
5,1,29,1,17,1,144,591,97,19,82,LOH1GO,610,241
5,1,29,1,17,2,486,591,66,25,28,EES,616,552
5,1,29,1,17,3,566,591,104,25,4,ENE,616,670
4,1,29,1,18,0,151,621,204,21,-1,,642,355
5,1,29,1,18,1,151,621,68,21,0,(226),642,219
5,1,29,1,18,2,228,622,127,18,0,338-5962,640,355
4,1,29,1,19,0,986,674,618,15,-1,,689,1604
5,1,29,1,19,1,986,674,67,14,96,FACTOR,688,1053
5,1,29,1,19,2,1161,675,93,13,96,MEASURED,688,1254
5,1,29,1,19,3,1306,675,32,13,94,NET,688,1338
5,1,29,1,19,4,1344,675,57,13,94,LITRES,688,1401
5,1,29,1,19,5,1534,676,70,13,96,DENSITY,689,1604
4,1,29,1,20,0,76,681,1528,27,-1,,708,1604
5,1,29,1,20,1,76,681,143,13,91,PRODUCTMETER,694,219
5,1,29,1,20,2,572,704,5,2,36,.,706,577
5,1,29,1,20,3,986,693,77,13,92,FACTEUR,706,1063
5,1,29,1,20,4,1175,694,57,14,84,UTRES,708,1232
5,1,29,1,20,5,1306,694,104,14,2,correcteo,708,1410
5,1,29,1,20,6,1438,687,62,13,48,[TEMPC,700,1500
5,1,29,1,20,7,1511,683,10,35,87,|,718,1521
5,1,29,1,20,8,1534,695,70,13,0,pensite,708,1604
4,1,29,1,21,0,76,696,1514,36,-1,,732,1590
5,1,29,1,21,1,76,698,135,34,91,PRODUIT/METER,732,211
5,1,29,1,21,2,368,696,81,14,4,BRSDUC,710,449
5,1,29,1,21,3,441,692,35,42,4,TEE,734,476
5,1,29,1,21,4,479,697,32,13,0,SSn,710,511
5,1,29,1,21,5,521,692,53,42,0,TION:,734,574
5,1,29,1,21,6,583,697,112,13,0,DERCRIPTION,710,695
5,1,29,1,21,7,702,698,21,13,0,DU,711,723
5,1,29,1,21,8,731,698,73,13,0,PRODUIT,711,804
5,1,29,1,21,9,985,712,25,14,77,API,726,1010
5,1,29,1,21,10,1016,713,52,13,77,TABLE,726,1068
5,1,29,1,21,11,1161,713,93,13,91,MESUREES,726,1254
5,1,29,1,21,12,1330,714,62,14,80,TO15C,728,1392
5,1,29,1,21,13,1439,711,86,17,27,â_|CELSIUSÂ¢,728,1525
5,1,29,1,21,14,1533,714,57,17,81,kg/cu.m,731,1590
4,1,29,1,22,0,146,743,1424,25,-1,,768,1570
5,1,29,1,22,1,146,743,94,19,96,103265,762,240
5,1,29,1,22,2,255,739,15,34,94,|,773,270
5,1,29,1,22,3,276,745,49,18,96,NOT,763,325
5,1,29,1,22,4,343,746,148,18,96,REGULATED,764,491
5,1,29,1,22,5,508,747,83,17,96,UNDER,764,591
5,1,29,1,22,6,609,746,49,18,96,TDG,764,658
5,1,29,1,22,7,976,747,95,19,95,0.9610,766,1071
5,1,29,1,22,8,1159,748,79,18,96,24499,766,1238
5,1,29,1,22,9,1309,748,79,19,96,23544,767,1388
5,1,29,1,22,10,1444,749,126,19,89,66.0/913,768,1570
4,1,29,1,23,0,143,775,929,21,-1,,796,1072
5,1,29,1,23,1,143,775,96,18,91,MTR222,793,239
5,1,29,1,23,2,253,771,17,32,92,|,803,270
5,1,29,1,23,3,276,776,65,18,92,HVGO,794,341
5,1,29,1,23,4,956,779,48,17,89,API,796,1004
5,1,29,1,23,5,1026,778,46,18,81,54B,796,1072
4,1,29,1,24,0,146,836,1424,24,-1,,860,1570
5,1,29,1,24,1,146,836,94,19,94,103265,855,240
5,1,29,1,24,2,252,832,18,34,94,|,866,270
5,1,29,1,24,3,276,837,49,19,96,NOT,856,325
5,1,29,1,24,4,342,838,148,18,96,REGULATED,856,490
5,1,29,1,24,5,508,839,82,17,96,UNDER,856,590
5,1,29,1,24,6,609,839,48,18,96,TDG,857,657
5,1,29,1,24,7,976,839,95,19,79,0.9611,858,1071
5,1,29,1,24,8,1159,840,79,19,96,23500,859,1238
5,1,29,1,24,9,1309,840,79,20,96,22586,860,1388
5,1,29,1,24,10,1443,841,127,19,79,65.8|913,860,1570
4,1,29,1,25,0,143,867,929,22,-1,,889,1072
5,1,29,1,25,1,143,867,97,19,87,MTR221,886,240
5,1,29,1,25,2,251,863,16,32,87,|,895,267
5,1,29,1,25,3,276,868,65,18,91,HVGO,886,341
5,1,29,1,25,4,956,872,48,16,91,API,888,1004
5,1,29,1,25,5,1026,870,46,19,89,54B,889,1072
4,1,29,1,26,0,312,881,201,82,-1,,963,513
5,1,29,1,26,1,312,881,94,81,21,o8/o,962,406
5,1,29,1,26,2,406,886,107,77,29,py,963,513
4,1,29,1,27,0,315,1055,155,37,-1,,1092,470
5,1,29,1,27,1,315,1055,82,37,29,V-,1092,397
5,1,29,1,27,2,464,1075,6,13,24,wo),1088,470
4,1,29,1,28,0,328,1058,276,65,-1,,1123,604
5,1,29,1,28,1,328,1058,43,35,0,M-,1093,371
5,1,29,1,28,2,412,1064,105,49,0,of'o0,1113,517
5,1,29,1,28,3,530,1082,74,41,45,pra,1123,604
4,1,29,1,29,0,376,1152,211,58,-1,,1210,587
5,1,29,1,29,1,376,1152,109,58,51,S26,1210,485
5,1,29,1,29,2,507,1170,80,37,51,4m,1207,587
4,1,29,1,30,0,309,1418,1010,23,-1,,1441,1319
5,1,29,1,30,1,309,1418,79,18,96,Total,1436,388
5,1,29,1,30,2,408,1418,96,19,96,Litres,1437,504
5,1,29,1,30,3,524,1419,32,22,96,by,1441,556
5,1,29,1,30,4,576,1419,112,19,96,Product,1438,688
5,1,29,1,30,5,1316,1433,3,3,58,:,1436,1319
4,1,29,1,31,0,277,1448,1111,22,-1,,1470,1388
5,1,29,1,31,1,277,1448,94,19,96,103265,1467,371
5,1,29,1,31,2,474,1450,65,18,92,HVGO,1468,539
5,1,29,1,31,3,1158,1452,79,18,96,47999,1470,1237
5,1,29,1,31,4,1309,1452,79,18,96,46130,1470,1388
4,1,29,1,32,0,75,1734,1494,29,-1,,1763,1569
5,1,29,1,32,1,75,1738,61,13,95,DRIVER,1751,136
5,1,29,1,32,2,142,1738,95,14,93,SIGNATURE,1752,237
5,1,29,1,32,3,242,1746,5,2,92,-,1748,247
5,1,29,1,32,4,253,1739,95,13,96,SIGNATURE,1752,348
5,1,29,1,32,5,354,1739,22,13,89,DU,1752,376
5,1,29,1,32,6,382,1739,117,14,89,CONDUCTEUR,1753,499
5,1,29,1,32,7,793,1734,4,6,82,],1740,797
5,1,29,1,32,8,862,1737,61,25,28,ARRIVE,1762,923
5,1,29,1,32,9,1026,1734,36,40,0,Dest,1774,1062
5,1,29,1,32,10,1068,1738,31,24,0,TEU,1762,1099
5,1,29,1,32,11,1101,1738,99,25,43,GHARGEMENT,1763,1200
5,1,29,1,32,12,1208,1734,21,40,1,|,1774,1229
5,1,29,1,32,13,1244,1734,45,40,0,FIN'DU,1774,1289
5,1,29,1,32,14,1295,1734,97,40,0,SHAREMENT,1774,1392
5,1,29,1,32,15,1504,1739,65,24,34,Dear,1763,1569
4,1,29,1,33,0,794,1741,759,76,-1,,1817,1553
5,1,29,1,33,1,794,1741,2,76,94,|,1817,796
5,1,29,1,33,2,858,1786,79,20,95,00:39,1806,937
5,1,29,1,33,3,1059,1787,78,19,95,00:42,1806,1137
5,1,29,1,33,4,1276,1787,77,19,95,00:57,1806,1353
5,1,29,1,33,5,1476,1788,77,19,95,00:57,1807,1553
4,1,29,1,34,0,65,1814,1506,24,-1,,1838,1571
5,1,29,1,34,1,65,1814,71,18,50,âDRIVER,1832,136
5,1,29,1,34,2,142,1819,47,13,84,NAME,1832,189
5,1,29,1,34,3,194,1826,5,2,84,-,1828,199
5,1,29,1,34,4,204,1819,37,14,95,NOM,1833,241
5,1,29,1,34,5,248,1819,21,14,93,DU,1833,269
5,1,29,1,34,6,276,1819,117,15,90,CONDUCTEUR,1834,393
5,1,29,1,34,7,594,1821,61,13,93,DRIVER,1834,655
5,1,29,1,34,8,662,1821,70,13,95,NUMBER,1834,732
5,1,29,1,34,9,1282,1823,53,14,95,TOTAL,1837,1335
5,1,29,1,34,10,1340,1823,84,15,93,QUANTITY,1838,1424
5,1,29,1,34,11,1429,1831,6,3,92,-,1834,1435
5,1,29,1,34,12,1440,1823,61,15,93,QUANT.,1838,1501
5,1,29,1,34,13,1506,1824,65,14,93,TOTALE,1838,1571
4,1,29,1,35,0,580,1835,908,35,-1,,1870,1488
5,1,29,1,35,1,580,1835,20,14,92,No,1849,600
5,1,29,1,35,2,606,1835,145,15,28,DUCONOUCTEUR|,1850,751
5,1,29,1,35,3,760,1839,9,9,85,*,1848,769
5,1,29,1,35,4,778,1839,93,22,95,Volume,1861,871
5,1,29,1,35,5,880,1840,113,22,94,corrected,1862,993
5,1,29,1,35,6,1004,1841,21,21,96,to,1862,1025
5,1,29,1,35,7,1037,1840,27,22,96,15,1862,1064
5,1,29,1,35,8,1074,1840,103,28,93,Degrees,1868,1177
5,1,29,1,35,9,1186,1840,19,22,77,C,1862,1205
5,1,29,1,35,10,1214,1840,9,10,77,*,1850,1223
5,1,29,1,35,11,1292,1850,79,20,96,47999,1870,1371
5,1,29,1,35,12,1390,1850,98,20,96,Litres,1870,1488
4,1,29,1,36,0,144,1878,1274,23,-1,,1901,1418
5,1,29,1,36,1,144,1878,115,18,30,SANJEEV__,1896,259
5,1,29,1,36,2,292,1880,82,17,87,KUMAR,1897,374
5,1,29,1,36,3,609,1880,128,18,96,56017257,1898,737
5,1,29,1,36,4,1292,1882,79,19,70,42117,1901,1371
5,1,29,1,36,5,1391,1882,27,19,70,kag,1901,1418
2,1,30,0,0,0,50,124,27,1773,-1,,1897,77
3,1,30,1,0,0,50,124,27,1773,-1,,1897,77
4,1,30,1,1,0,50,124,27,1773,-1,,1897,77
5,1,30,1,1,1,50,124,27,1773,95, ,1897,77
2,1,31,0,0,0,55,1884,554,23,-1,,1907,609
3,1,31,1,0,0,55,1884,554,23,-1,,1907,609
4,1,31,1,1,0,55,1884,554,23,-1,,1907,609
5,1,31,1,1,1,55,1884,554,23,95,  ,1907,609
2,1,32,0,0,0,82,1909,177,12,-1,,1921,259
3,1,32,1,0,0,82,1909,177,12,-1,,1921,259
4,1,32,1,1,0,82,1909,177,12,-1,,1921,259
5,1,32,1,1,1,82,1909,68,11,96,PRODUCT,1920,150
5,1,32,1,1,2,222,1910,37,11,95,TANK,1921,259
2,1,33,0,0,0,1371,1884,263,26,-1,,1910,1634
3,1,33,1,0,0,1371,1884,263,26,-1,,1910,1634
4,1,33,1,1,0,1371,1884,263,26,-1,,1910,1634
5,1,33,1,1,1,1371,1884,263,26,95,      ,1910,1634
2,1,34,0,0,0,55,1884,1237,26,-1,,1910,1292
3,1,34,1,0,0,55,1884,1237,26,-1,,1910,1292
4,1,34,1,1,0,55,1884,1237,26,-1,,1910,1292
5,1,34,1,1,1,55,1884,1237,26,95,   ,1910,1292
2,1,35,0,0,0,374,1884,235,22,-1,,1906,609
3,1,35,1,0,0,374,1884,235,22,-1,,1906,609
4,1,35,1,1,0,374,1884,235,22,-1,,1906,609
5,1,35,1,1,1,374,1884,235,22,95, ,1906,609
2,1,36,0,0,0,264,1903,1343,28,-1,,1931,1607
3,1,36,1,0,0,264,1903,1343,28,-1,,1931,1607
4,1,36,1,1,0,264,1903,1343,28,-1,,1931,1607
5,1,36,1,1,1,264,1903,68,28,81,CAPACITY,1931,332
5,1,36,1,1,2,374,1910,50,12,81,WATER,1922,424
5,1,36,1,1,3,428,1911,47,11,84,DIPICM|,1922,475
5,1,36,1,1,4,488,1911,56,11,88,BEFORE,1922,544
5,1,36,1,1,5,548,1911,32,11,88,DIPS,1922,580
5,1,36,1,1,6,591,1907,2,4,93,|,1911,593
5,1,36,1,1,7,604,1912,45,11,71,AFTER,1923,649
5,1,36,1,1,8,654,1912,31,11,71,DIPS,1923,685
5,1,36,1,1,9,696,1903,10,29,83,|,1932,706
5,1,36,1,1,10,712,1912,53,12,94,ENDING,1924,765
5,1,36,1,1,11,770,1912,51,12,94,INVENT,1924,821
5,1,36,1,1,12,865,1913,68,11,96,PRODUCT,1924,933
5,1,36,1,1,13,1004,1913,37,11,96,TANK,1924,1041
5,1,36,1,1,14,1044,1913,70,12,95,CAPACITY,1925,1114
5,1,36,1,1,15,1156,1914,50,11,92,WATER,1925,1206
5,1,36,1,1,16,1211,1914,48,11,19,DIP/CM),1925,1259
5,1,36,1,1,17,1277,1914,56,12,74,BEFORE,1926,1333
5,1,36,1,1,18,1338,1914,31,12,74,DIPS|,1926,1369
5,1,36,1,1,19,1387,1914,46,12,42,AFTER,1926,1433
5,1,36,1,1,20,1437,1915,32,11,42,DIPS,1926,1469
5,1,36,1,1,21,1478,1907,10,28,94,|,1935,1488
5,1,36,1,1,22,1499,1915,52,11,92,ENDING,1926,1551
5,1,36,1,1,23,1556,1915,51,11,92,INVENT,1926,1607
2,1,37,0,0,0,85,1919,1510,46,-1,,1965,1595
3,1,37,1,0,0,85,1919,1510,45,-1,,1964,1595
4,1,37,1,1,0,85,1919,1510,31,-1,,1950,1595
5,1,37,1,1,1,85,1926,62,11,70,PRODUIT,1937,147
5,1,37,1,1,2,226,1919,95,28,84,CONTENANCE,1947,321
5,1,37,1,1,3,392,1928,67,11,83,MEASURE,1939,459
5,1,37,1,1,4,501,1928,46,11,90,ANANT,1939,547
5,1,37,1,1,5,552,1928,15,11,95,LE,1939,567
5,1,37,1,1,6,612,1929,47,10,89,APRES,1939,659
5,1,37,1,1,7,664,1929,15,10,94,LE,1939,679
5,1,37,1,1,8,726,1921,87,28,0,"INVENTAIRE,",1949,813
5,1,37,1,1,9,868,1930,61,10,96,PRODUIT,1940,929
5,1,37,1,1,10,1006,1922,101,28,12,"CONTENANCE,",1950,1107
5,1,37,1,1,11,1284,1931,47,10,88,AVANT,1941,1331
5,1,37,1,1,12,1335,1931,16,10,88,LE,1941,1351
5,1,37,1,1,13,1393,1931,46,11,92,APRES,1942,1439
5,1,37,1,1,14,1444,1931,16,11,94,LE,1942,1460
5,1,37,1,1,15,1513,1932,82,10,91,INVENTAIRE,1942,1595
4,1,37,1,2,0,223,1937,1350,28,-1,,1965,1573
5,1,37,1,2,1,223,1943,18,11,92,OU,1954,241
5,1,37,1,2,2,247,1943,80,12,90,RESERVIOR,1955,327
5,1,37,1,2,3,394,1937,63,28,61,DEAUICM,1965,457
5,1,37,1,2,4,498,1944,75,11,91,JAUGEAGE,1955,573
5,1,37,1,2,5,585,1937,10,28,86,|,1965,595
5,1,37,1,2,6,609,1945,75,11,86,JAUGEAGE,1956,684
5,1,37,1,2,7,742,1945,47,12,87,APRES,1957,789
5,1,37,1,2,8,955,1962,2,2,55,I,1964,957
5,1,37,1,2,9,1004,1946,19,11,93,DU,1957,1023
5,1,37,1,2,10,1028,1946,81,11,92,RESERVIOR,1957,1109
5,1,37,1,2,11,1282,1947,75,12,92,JAUGEAGE,1959,1357
5,1,37,1,2,12,1369,1940,10,28,88,|,1968,1379
5,1,37,1,2,13,1393,1947,75,12,84,JAUGEAGE,1959,1468
5,1,37,1,2,14,1526,1948,47,11,92,APRES,1959,1573
2,1,38,0,0,0,64,1951,1561,22,-1,,1973,1625
3,1,38,1,0,0,64,1951,1561,22,-1,,1973,1625
4,1,38,1,1,0,64,1951,1561,22,-1,,1973,1625
5,1,38,1,1,1,64,1951,1561,22,95, ,1973,1625
2,1,39,0,0,0,64,2012,1561,23,-1,,2035,1625
3,1,39,1,0,0,64,2012,1561,23,-1,,2035,1625
4,1,39,1,1,0,64,2012,1561,23,-1,,2035,1625
5,1,39,1,1,1,64,2012,1561,23,95, ,2035,1625
2,1,40,0,0,0,64,2073,1560,23,-1,,2096,1624
3,1,40,1,0,0,64,2073,1560,23,-1,,2096,1624
4,1,40,1,1,0,64,2073,1560,23,-1,,2096,1624
5,1,40,1,1,1,64,2073,1560,23,95, ,2096,1624
2,1,41,0,0,0,39,2158,344,16,-1,,2174,383
3,1,41,1,0,0,39,2158,344,16,-1,,2174,383
4,1,41,1,1,0,39,2158,344,16,-1,,2174,383
5,1,41,1,1,1,39,2158,11,12,76,A,2170,50
5,1,41,1,1,2,55,2158,51,13,76,Suncor,2171,106
5,1,41,1,1,3,112,2158,64,13,93,business,2171,176
5,1,41,1,1,4,182,2158,4,13,93,/,2171,186
5,1,41,1,1,5,193,2158,29,13,93,Une,2171,222
5,1,41,1,1,6,228,2158,73,16,92,entreprise,2174,301
5,1,41,1,1,7,307,2158,18,13,96,de,2171,325
5,1,41,1,1,8,330,2158,53,14,96,Suncor,2172,383
2,1,42,0,0,0,55,1910,1579,245,-1,,2155,1634
3,1,42,1,0,0,55,1910,1579,245,-1,,2155,1634
4,1,42,1,1,0,55,1910,1579,245,-1,,2155,1634
5,1,42,1,1,1,55,1910,1579,245,95, ,2155,1634
2,1,43,0,0,0,1149,1907,6,237,-1,,2144,1155
3,1,43,1,0,0,1149,1907,6,237,-1,,2144,1155
4,1,43,1,1,0,1149,1907,6,237,-1,,2144,1155
5,1,43,1,1,1,1149,1907,6,237,95, ,2144,1155
2,1,44,0,0,0,369,1904,5,236,-1,,2140,374
3,1,44,1,0,0,369,1904,5,236,-1,,2140,374
4,1,44,1,1,0,369,1904,5,236,-1,,2140,374
5,1,44,1,1,1,369,1904,5,236,95, ,2140,374
2,1,45,0,0,0,478,1904,6,238,-1,,2142,484
3,1,45,1,0,0,478,1904,6,238,-1,,2142,484
4,1,45,1,1,0,478,1904,6,238,-1,,2142,484
5,1,45,1,1,1,478,1904,6,238,95, ,2142,484
2,1,46,0,0,0,589,1912,5,230,-1,,2142,594
3,1,46,1,0,0,589,1912,5,230,-1,,2142,594
4,1,46,1,1,0,589,1912,5,230,-1,,2142,594
5,1,46,1,1,1,589,1912,5,230,95, ,2142,594
2,1,47,0,0,0,1552,2159,111,17,-1,,2176,1663
3,1,47,1,0,0,1552,2159,111,17,-1,,2176,1663
4,1,47,1,1,0,1552,2159,111,17,-1,,2176,1663
5,1,47,1,1,1,1552,2159,53,14,65,11279L,2173,1605
5,1,47,1,1,2,1611,2159,52,17,95,(05/17),2176,1663
1,1,0,0,0,0,0,0,1700,2200,-1,,2200,1700
2,1,1,0,0,0,736,15,249,48,-1,,63,985
3,1,1,1,0,0,736,15,249,48,-1,,63,985
4,1,1,1,1,0,736,15,249,48,-1,,63,985
5,1,1,1,1,1,736,15,173,48,2,QY4o7o,63,909
5,1,1,1,1,2,922,17,63,44,81,43,61,985
2,1,2,0,0,0,911,76,591,26,-1,,102,1502
3,1,2,1,0,0,911,76,591,26,-1,,102,1502
4,1,2,1,1,0,911,76,591,26,-1,,102,1502
5,1,2,1,1,1,911,76,118,23,95,VEHICLE,99,1029
5,1,2,1,1,2,1040,78,121,22,96,LOADING,100,1161
5,1,2,1,1,3,1172,78,113,23,93,REPORT,101,1285
5,1,2,1,1,4,1294,91,8,3,93,-,94,1302
5,1,2,1,1,5,1312,80,55,21,95,BILL,101,1367
5,1,2,1,1,6,1377,80,35,21,93,OF,101,1412
5,1,2,1,1,7,1423,80,79,22,92,LADIN,102,1502
2,1,3,0,0,0,1505,80,19,22,-1,,102,1524
3,1,3,1,0,0,1505,80,19,22,-1,,102,1524
4,1,3,1,1,0,1505,80,19,22,-1,,102,1524
5,1,3,1,1,1,1505,80,19,22,90,G,102,1524
2,1,4,0,0,0,65,123,1567,14,-1,,137,1632
3,1,4,1,0,0,65,123,1567,14,-1,,137,1632
4,1,4,1,1,0,65,123,1567,14,-1,,137,1632
5,1,4,1,1,1,65,123,1567,14,95, ,137,1632
2,1,5,0,0,0,65,221,1567,12,-1,,233,1632
3,1,5,1,0,0,65,221,1567,12,-1,,233,1632
4,1,5,1,1,0,65,221,1567,12,-1,,233,1632
5,1,5,1,1,1,65,221,1567,12,95, ,233,1632
2,1,6,0,0,0,821,227,811,7,-1,,234,1632
3,1,6,1,0,0,821,227,811,7,-1,,234,1632
4,1,6,1,1,0,821,227,811,7,-1,,234,1632
5,1,6,1,1,1,821,227,811,7,95, ,234,1632
2,1,7,0,0,0,272,396,581,6,-1,,402,853
3,1,7,1,0,0,272,396,581,6,-1,,402,853
4,1,7,1,1,0,272,396,581,6,-1,,402,853
5,1,7,1,1,1,272,396,581,6,95, ,402,853
2,1,8,0,0,0,561,398,3,71,-1,,469,564
3,1,8,1,0,0,561,398,3,71,-1,,469,564
4,1,8,1,1,0,561,398,3,71,-1,,469,564
5,1,8,1,1,1,561,398,3,71,95, ,469,564
2,1,9,0,0,0,851,227,4,244,-1,,471,855
3,1,9,1,0,0,851,227,4,244,-1,,471,855
4,1,9,1,1,0,851,227,4,244,-1,,471,855
5,1,9,1,1,1,851,227,4,244,95, ,471,855
2,1,10,0,0,0,71,464,1560,11,-1,,475,1631
3,1,10,1,0,0,71,464,1560,11,-1,,475,1631
4,1,10,1,1,0,71,464,1560,11,-1,,475,1631
5,1,10,1,1,1,71,464,1560,11,95, ,475,1631
2,1,11,0,0,0,713,468,3,197,-1,,665,716
3,1,11,1,0,0,713,468,3,197,-1,,665,716
4,1,11,1,1,0,713,468,3,197,-1,,665,716
5,1,11,1,1,1,713,468,3,197,95, ,665,716
2,1,12,0,0,0,1101,471,3,196,-1,,667,1104
3,1,12,1,0,0,1101,471,3,196,-1,,667,1104
4,1,12,1,1,0,1101,471,3,196,-1,,667,1104
5,1,12,1,1,1,1101,471,3,196,95, ,667,1104
2,1,13,0,0,0,64,658,1567,11,-1,,669,1631
3,1,13,1,0,0,64,658,1567,11,-1,,669,1631
4,1,13,1,1,0,64,658,1567,11,-1,,669,1631
5,1,13,1,1,1,64,658,1567,11,95, ,669,1631
2,1,14,0,0,0,64,728,1566,11,-1,,739,1630
3,1,14,1,0,0,64,728,1566,11,-1,,739,1630
4,1,14,1,1,0,64,728,1566,11,-1,,739,1630
5,1,14,1,1,1,64,728,1566,11,95, ,739,1630
2,1,15,0,0,0,63,191,4,1267,-1,,1458,67
3,1,15,1,0,0,63,191,4,1267,-1,,1458,67
4,1,15,1,1,0,63,191,4,1267,-1,,1458,67
5,1,15,1,1,1,63,191,4,1267,95, ,1458,67
2,1,16,0,0,0,255,660,4,1074,-1,,1734,259
3,1,16,1,0,0,255,660,4,1074,-1,,1734,259
4,1,16,1,1,0,255,660,4,1074,-1,,1734,259
5,1,16,1,1,1,255,660,4,1074,95, ,1734,259
2,1,17,0,0,0,1281,666,4,446,-1,,1112,1285
3,1,17,1,0,0,1281,666,4,446,-1,,1112,1285
4,1,17,1,1,0,1281,666,4,446,-1,,1112,1285
5,1,17,1,1,1,1281,666,4,446,95, ,1112,1285
2,1,18,0,0,0,1433,667,4,1053,-1,,1720,1437
3,1,18,1,0,0,1433,667,4,1053,-1,,1720,1437
4,1,18,1,1,0,1433,667,4,1053,-1,,1720,1437
5,1,18,1,1,1,1433,667,4,1053,95, ,1720,1437
2,1,19,0,0,0,933,664,3,1073,-1,,1737,936
3,1,19,1,0,0,933,664,3,1073,-1,,1737,936
4,1,19,1,1,0,933,664,3,1073,-1,,1737,936
5,1,19,1,1,1,933,664,3,1073,95, ,1737,936
2,1,20,0,0,0,1127,666,4,1072,-1,,1738,1131
3,1,20,1,0,0,1127,666,4,1072,-1,,1738,1131
4,1,20,1,1,0,1127,666,4,1072,-1,,1738,1131
5,1,20,1,1,1,1127,666,4,1072,95, ,1738,1131
2,1,21,0,0,0,1281,666,3,1073,-1,,1739,1284
3,1,21,1,0,0,1281,666,3,1073,-1,,1739,1284
4,1,21,1,1,0,1281,666,3,1073,-1,,1739,1284
5,1,21,1,1,1,1281,666,3,1073,95, ,1739,1284
2,1,22,0,0,0,1517,667,3,1070,-1,,1737,1520
3,1,22,1,0,0,1517,667,3,1070,-1,,1737,1520
4,1,22,1,1,0,1517,667,3,1070,-1,,1737,1520
5,1,22,1,1,1,1517,667,3,1070,95, ,1737,1520
2,1,23,0,0,0,62,1731,1567,9,-1,,1740,1629
3,1,23,1,0,0,62,1731,1567,9,-1,,1740,1629
4,1,23,1,1,0,62,1731,1567,9,-1,,1740,1629
5,1,23,1,1,1,62,1731,1567,9,95, ,1740,1629
2,1,24,0,0,0,795,1735,1,85,-1,,1820,796
3,1,24,1,0,0,795,1735,1,85,-1,,1820,796
4,1,24,1,1,0,795,1735,1,85,-1,,1820,796
5,1,24,1,1,1,795,1735,1,85,95, ,1820,796
2,1,25,0,0,0,1002,1736,2,86,-1,,1822,1004
3,1,25,1,0,0,1002,1736,2,86,-1,,1822,1004
4,1,25,1,1,0,1002,1736,2,86,-1,,1822,1004
5,1,25,1,1,1,1002,1736,2,86,95, ,1822,1004
2,1,26,0,0,0,1210,1739,3,80,-1,,1819,1213
3,1,26,1,0,0,1210,1739,3,80,-1,,1819,1213
4,1,26,1,1,0,1210,1739,3,80,-1,,1819,1213
5,1,26,1,1,1,1210,1739,3,80,95, ,1819,1213
2,1,27,0,0,0,81,1815,1545,9,-1,,1824,1626
3,1,27,1,0,0,81,1815,1545,9,-1,,1824,1626
4,1,27,1,1,0,81,1815,1545,9,-1,,1824,1626
5,1,27,1,1,1,81,1815,1545,9,95, ,1824,1626
2,1,28,0,0,0,56,1838,524,48,-1,,1886,580
3,1,28,1,0,0,56,1838,524,48,-1,,1886,580
4,1,28,1,1,0,56,1838,524,48,-1,,1886,580
5,1,28,1,1,1,56,1838,524,48,95, ,1886,580
2,1,29,0,0,0,1224,1838,410,48,-1,,1886,1634
3,1,29,1,0,0,1224,1838,410,48,-1,,1886,1634
4,1,29,1,1,0,1224,1838,410,48,-1,,1886,1634
5,1,29,1,1,1,1224,1838,410,48,95,   ,1886,1634
2,1,30,0,0,0,62,102,1566,1800,-1,,1902,1628
3,1,30,1,0,0,62,102,1566,1800,-1,,1902,1628
4,1,30,1,1,0,150,102,1478,29,-1,,131,1628
5,1,30,1,1,1,150,103,74,24,95,Page:,127,224
5,1,30,1,1,2,248,102,12,20,95,1,122,260
5,1,30,1,1,3,480,105,45,19,96,530,124,525
5,1,30,1,1,4,816,104,131,23,95,RAPPORT,127,947
5,1,30,1,1,5,958,105,35,22,90,DE,127,993
5,1,30,1,1,6,1003,105,376,24,90,CHARGEMENT,129,1379
5,1,30,1,1,7,1198,100,17,39,91,-,139,1215
5,1,30,1,1,8,1231,105,127,24,90,VEHICULE,129,1358
5,1,30,1,1,9,1371,100,20,39,92,-,139,1391
5,1,30,1,1,10,1389,108,239,23,91,CONNAISSEMENT,131,1628
4,1,30,1,2,0,138,132,534,26,-1,,158,672
5,1,30,1,2,1,138,133,109,16,96,DOCUMENT,149,247
5,1,30,1,2,2,254,134,82,16,60,NUMBER,150,336
5,1,30,1,2,3,364,136,62,18,60,1661,154,426
5,1,30,1,2,4,537,132,37,25,69,DATE,157,574
5,1,30,1,2,5,576,132,96,26,67,DEXPEDITION,158,672
4,1,30,1,3,0,138,152,172,17,-1,,169,310
5,1,30,1,3,1,138,152,23,15,96,No,167,161
5,1,30,1,3,2,168,153,25,15,90,DU,168,193
5,1,30,1,3,3,201,153,109,16,96,DOCUMENT,169,310
4,1,30,1,4,0,66,129,1545,68,-1,,197,1611
5,1,30,1,4,1,66,163,1,10,91,|,173,67
5,1,30,1,4,2,480,129,1,66,87,|,195,481
5,1,30,1,4,3,523,163,137,34,95,mm/dd/yy,197,660
5,1,30,1,4,4,800,171,29,21,94,24,192,829
5,1,30,1,4,5,840,171,79,22,94,HOUR,193,919
5,1,30,1,4,6,930,172,118,22,0,NUMBER,194,1048
5,1,30,1,4,7,1049,166,4,35,0,_,201,1053
5,1,30,1,4,8,1069,170,68,22,10,(403),192,1137
5,1,30,1,4,9,1146,171,128,19,10,296-3000,190,1274
5,1,30,1,4,10,1311,174,139,22,86,-NUMERO,196,1450
5,1,30,1,4,11,1459,176,29,20,95,24,196,1488
5,1,30,1,4,12,1499,176,112,21,95,HEURES,197,1611
4,1,30,1,5,0,150,194,1224,32,-1,,226,1374
5,1,30,1,5,1,150,194,109,20,96,0114752,214,259
5,1,30,1,5,2,281,196,93,20,96,10/002,216,374
5,1,30,1,5,3,479,205,1,20,36,|,225,480
5,1,30,1,5,4,529,198,129,20,36,10/08/24,218,658
5,1,30,1,5,5,1051,203,231,23,92,COLLECT,226,1282
5,1,30,1,5,6,1180,193,16,38,91,-,231,1196
5,1,30,1,5,7,1208,203,74,23,92,FRAIS,226,1282
5,1,30,1,5,8,1292,205,82,21,92,VIRES,226,1374
4,1,30,1,6,0,79,227,1518,35,-1,,262,1597
5,1,30,1,6,1,79,227,196,15,92,CONSIGNEE/CUSTOMER,242,275
5,1,30,1,6,2,280,235,5,3,93,-,238,285
5,1,30,1,6,3,292,228,182,15,87,DESTINATAIRE/CLIENT,243,474
5,1,30,1,6,4,688,228,17,25,0,Repo,253,705
5,1,30,1,6,5,710,242,127,12,0,eblisettienT,254,837
5,1,30,1,6,6,848,224,12,34,90,|,258,860
5,1,30,1,6,7,864,232,101,14,78,CONSIGNOR,246,965
5,1,30,1,6,8,970,240,5,2,78,-,242,975
5,1,30,1,6,9,982,233,105,14,92,EXPEDITEUR,247,1087
5,1,30,1,6,10,1466,227,26,35,0,LO,262,1492
5,1,30,1,6,11,1502,227,33,35,0,TEN,262,1535
5,1,30,1,6,12,1543,227,54,35,0,NORE,262,1597
4,1,30,1,7,0,147,255,1425,29,-1,,284,1572
5,1,30,1,7,1,147,255,180,25,96,Mississauga,280,327
5,1,30,1,7,2,345,258,79,19,96,Lubes,277,424
5,1,30,1,7,3,444,259,98,18,96,Center,277,542
5,1,30,1,7,4,679,260,162,19,91,0000081523,279,841
5,1,30,1,7,5,860,260,183,24,66,|Mississauga,284,1043
5,1,30,1,7,6,1061,262,80,19,96,Lubes,281,1141
5,1,30,1,7,7,1161,264,98,18,96,Center,282,1259
5,1,30,1,7,8,1462,264,110,19,96,0081523,283,1572
4,1,30,1,8,0,149,286,1011,25,-1,,311,1160
5,1,30,1,8,1,149,286,44,19,96,385,305,193
5,1,30,1,8,2,215,288,145,18,96,Southdown,306,360
5,1,30,1,8,3,378,288,65,19,96,Road,307,443
5,1,30,1,8,4,679,290,162,20,0,0000000104,310,841
5,1,30,1,8,5,862,292,45,18,0,/385,310,907
5,1,30,1,8,6,928,292,148,19,96,Southdown,311,1076
5,1,30,1,8,7,1094,293,66,18,96,Road,311,1160
4,1,30,1,9,0,146,316,1060,29,-1,,345,1206
5,1,30,1,9,1,146,316,174,25,88,"Missisauga,",341,320
5,1,30,1,9,2,345,320,32,17,92,ON,337,377
5,1,30,1,9,3,394,319,96,19,52,L5J2Â¥2,338,490
5,1,30,1,9,4,859,321,177,24,91,"Missisauga,",345,1036
5,1,30,1,9,5,1061,324,32,18,93,ON,342,1093
5,1,30,1,9,6,1111,324,95,18,43,L5J2Y2,342,1206
4,1,30,1,10,0,271,398,575,35,-1,,433,846
5,1,30,1,10,1,271,398,69,14,56,[RELEASE,412,340
5,1,30,1,10,2,346,401,48,14,84,(C-of-A),415,394
5,1,30,1,10,3,399,401,59,12,95,NUMBER,413,458
5,1,30,1,10,4,568,402,37,12,0,EE,414,605
5,1,30,1,10,5,631,402,17,26,0,ER,428,648
5,1,30,1,10,6,663,403,27,25,0,eT,428,690
5,1,30,1,10,7,706,403,22,25,9,ae,428,728
5,1,30,1,10,8,736,404,46,25,0,Demet,429,782
5,1,30,1,10,9,788,398,58,35,24,"NUMBER,",433,846
4,1,30,1,11,0,78,474,1338,19,-1,,493,1416
5,1,30,1,11,1,78,474,73,14,93,CARRIER,488,151
5,1,30,1,11,2,157,481,4,3,67,-,484,161
5,1,30,1,11,3,166,474,136,15,86,TRANSPORTEUR,489,302
5,1,30,1,11,4,734,476,71,14,93,VEHICLE,490,805
5,1,30,1,11,5,811,476,71,14,93,NUMBER,490,882
5,1,30,1,11,6,924,477,70,13,12,LICENSE,490,994
5,1,30,1,11,7,1000,477,71,14,96,NUMBER,491,1071
5,1,30,1,11,8,1132,478,79,14,96,ADDRESS,492,1211
5,1,30,1,11,9,1217,478,22,14,96,OF,492,1239
5,1,30,1,11,10,1245,478,57,14,96,METER,492,1302
5,1,30,1,11,11,1308,479,34,13,96,AND,492,1342
5,1,30,1,11,12,1348,479,68,14,95,TRADER,493,1416
4,1,30,1,12,0,148,498,1332,22,-1,,520,1480
5,1,30,1,12,1,148,500,112,17,96,PREMIER,517,260
5,1,30,1,12,2,278,501,65,17,96,BULK,518,343
5,1,30,1,12,3,362,501,112,19,96,SYSTEMS,520,474
5,1,30,1,12,4,578,501,112,19,96,5000234,520,690
5,1,30,1,12,5,708,489,15,35,91,|,524,723
5,1,30,1,12,6,738,498,137,14,89,NoDUVEHICULE,512,875
5,1,30,1,12,7,900,489,13,35,46,=,524,913
5,1,30,1,12,8,924,500,71,13,74,NOMBRE,513,995
5,1,30,1,12,9,1002,500,22,13,62,DE,513,1024
5,1,30,1,12,10,1031,500,61,14,62,PERMIS,514,1092
5,1,30,1,12,11,1099,489,9,35,92,|,524,1108
5,1,30,1,12,12,1119,501,90,13,38,LâADRESSE,514,1209
5,1,30,1,12,13,1216,501,21,13,96,DE,514,1237
5,1,30,1,12,14,1243,501,57,13,96,METRE,514,1300
5,1,30,1,12,15,1307,502,20,13,96,ET,515,1327
5,1,30,1,12,16,1333,502,21,13,90,DE,515,1354
5,1,30,1,12,17,1360,502,120,14,90,COMMERCANT,516,1480
4,1,30,1,13,0,148,528,1326,30,-1,,558,1474
5,1,30,1,13,1,148,528,28,19,96,25,547,176
5,1,30,1,13,2,196,528,114,24,96,Gormley,552,310
5,1,30,1,13,3,329,530,161,20,95,Industrial,550,490
5,1,30,1,13,4,510,533,31,17,95,Dr,550,541
5,1,30,1,13,5,728,533,95,19,95,919322,552,823
5,1,30,1,13,6,1111,536,97,18,95,Suncor,554,1208
5,1,30,1,13,7,1226,537,100,21,96,Energy,558,1326
5,1,30,1,13,8,1344,536,130,19,96,Products,555,1474
4,1,30,1,14,0,147,556,1277,32,-1,,588,1424
5,1,30,1,14,1,147,556,113,32,96,GORMLEY,588,260
5,1,30,1,14,2,728,564,77,18,96,51202,582,805
5,1,30,1,14,3,1111,565,61,19,96,3275,584,1172
5,1,30,1,14,4,1192,566,116,19,95,Rebecca,585,1308
5,1,30,1,14,5,1328,568,96,18,96,Street,586,1424
4,1,30,1,15,0,147,590,523,27,-1,,617,670
5,1,30,1,15,1,147,590,94,20,0,LOH1GO,610,241
5,1,30,1,15,2,478,593,1,5,63,|,598,479
5,1,30,1,15,3,503,591,41,25,19,SPS,616,544
5,1,30,1,15,4,543,591,127,26,35,ERATE,617,670
4,1,30,1,16,0,153,621,203,21,-1,,642,356
5,1,30,1,16,1,153,621,203,21,90,(226)338-5962,642,356
4,1,30,1,17,0,170,660,1438,38,-1,,698,1608
5,1,30,1,17,1,170,660,4,2,56,|,662,174
5,1,30,1,17,2,988,675,67,13,74,FACTOR,688,1055
5,1,30,1,17,3,1163,676,92,13,94,MEASURED,689,1255
5,1,30,1,17,4,1307,677,32,12,93,NET,689,1339
5,1,30,1,17,5,1345,677,57,12,93,LITRES,689,1402
5,1,30,1,17,6,1534,674,74,24,96,DENSITY,698,1608
4,1,30,1,18,0,78,680,1527,29,-1,,709,1605
5,1,30,1,18,1,78,680,142,13,2,PRODUCTIMETEA,693,220
5,1,30,1,18,2,573,704,5,2,44,.,706,578
5,1,30,1,18,3,988,693,77,14,91,FACTEUR,707,1065
5,1,30,1,18,4,1176,695,57,13,94,LITRES,708,1233
5,1,30,1,18,5,1306,695,104,14,36,correcteo,709,1410
5,1,30,1,18,6,1439,688,63,13,32,|TEMPC,701,1502
5,1,30,1,18,7,1508,684,13,34,92,|,718,1521
5,1,30,1,18,8,1534,696,71,13,26,oensite,709,1605
4,1,30,1,19,0,78,696,1512,36,-1,,732,1590
5,1,30,1,19,1,78,697,135,34,91,PRODUIT/METER,731,213
5,1,30,1,19,2,369,696,198,14,0,Ee,710,567
5,1,30,1,19,3,556,692,14,41,0,Y,733,570
5,1,30,1,19,4,584,697,141,14,18,DESGRIFTIONDU,711,725
5,1,30,1,19,5,732,698,73,13,53,PRODUIT,711,805
5,1,30,1,19,6,986,713,26,13,66,API,726,1012
5,1,30,1,19,7,1018,713,52,14,74,TABLE,727,1070
5,1,30,1,19,8,1163,714,91,13,87,MESUREES,727,1254
5,1,30,1,19,9,1331,696,45,32,0,TO,728,1376
5,1,30,1,19,10,1383,715,11,13,0,ISG,728,1394
5,1,30,1,19,11,1440,715,85,15,92,CELSIUS,730,1525
5,1,30,1,19,12,1515,705,6,34,49,Â¢,739,1521
5,1,30,1,19,13,1534,716,56,16,24,kg/cu.m,732,1590
4,1,30,1,20,0,147,742,1424,27,-1,,769,1571
5,1,30,1,20,1,147,742,94,19,96,103265,761,241
5,1,30,1,20,2,256,738,15,34,94,|,772,271
5,1,30,1,20,3,276,744,49,18,95,NOT,762,325
5,1,30,1,20,4,344,745,147,18,95,REGULATED,763,491
5,1,30,1,20,5,509,746,82,17,96,UNDER,763,591
5,1,30,1,20,6,609,747,49,17,96,TDG,764,658
5,1,30,1,20,7,978,747,95,19,93,0.9611,766,1073
5,1,30,1,20,8,1161,748,78,19,96,23500,767,1239
5,1,30,1,20,9,1310,749,79,18,96,22586,767,1389
5,1,30,1,20,10,1444,749,62,19,54,65.8,768,1506
5,1,30,1,20,11,1527,750,44,19,54,|913,769,1571
4,1,30,1,21,0,145,773,929,24,-1,,797,1074
5,1,30,1,21,1,145,773,96,19,92,MTR221,792,241
5,1,30,1,21,2,253,769,14,32,92,|,801,267
5,1,30,1,21,3,277,775,65,18,90,HVGO,793,342
5,1,30,1,21,4,958,779,48,17,92,API,796,1006
5,1,30,1,21,5,1027,777,47,20,82,54B,797,1074
4,1,30,1,22,0,147,834,1424,26,-1,,860,1571
5,1,30,1,22,1,147,834,93,19,94,103265,853,240
5,1,30,1,22,2,255,830,15,33,94,|,863,270
5,1,30,1,22,3,276,836,49,17,95,NOT,853,325
5,1,30,1,22,4,344,836,147,19,95,REGULATED,855,491
5,1,30,1,22,5,509,838,82,17,96,UNDER,855,591
5,1,30,1,22,6,609,838,49,18,96,TDG,856,658
5,1,30,1,22,7,978,838,95,19,89,0.9611,857,1073
5,1,30,1,22,8,1161,839,77,20,96,24499,859,1238
5,1,30,1,22,9,1310,840,79,19,95,23546,859,1389
5,1,30,1,22,10,1444,841,61,18,55,65.9,859,1505
5,1,30,1,22,11,1527,841,44,19,55,|913,860,1571
4,1,30,1,23,0,145,865,929,24,-1,,889,1074
5,1,30,1,23,1,145,865,95,18,91,MTR222,883,240
5,1,30,1,23,2,253,861,16,32,93,|,893,269
5,1,30,1,23,3,277,867,65,18,90,HVGO,885,342
5,1,30,1,23,4,958,871,48,17,93,API,888,1006
5,1,30,1,23,5,1027,870,47,19,90,54B,889,1074
4,1,30,1,24,0,320,886,196,93,-1,,979,516
5,1,30,1,24,1,320,913,33,62,29,ad,975,353
5,1,30,1,24,2,353,886,82,93,61,she,979,435
5,1,30,1,24,3,455,927,61,40,28,Py,967,516
4,1,30,1,25,0,283,1064,180,44,-1,,1108,463
5,1,30,1,25,1,283,1064,77,44,26,l-,1108,360
5,1,30,1,25,2,454,1088,9,14,43,",",1102,463
4,1,30,1,26,0,371,1081,912,58,-1,,1139,1283
5,1,30,1,26,1,371,1081,78,47,68,OF.,1128,449
5,1,30,1,26,2,468,1095,49,40,77,fo,1135,517
5,1,30,1,26,3,535,1097,77,42,47,pro,1139,612
5,1,30,1,26,4,1281,1122,2,12,62,|,1134,1283
4,1,30,1,27,0,1281,1143,2,12,-1,,1155,1283
5,1,30,1,27,1,1281,1143,2,12,79,|,1155,1283
4,1,30,1,28,0,1281,1175,1,12,-1,,1187,1282
5,1,30,1,28,1,1281,1175,1,12,77,|,1187,1282
4,1,30,1,29,0,326,1186,24,10,-1,,1196,350
5,1,30,1,29,1,326,1186,24,10,29,=,1196,350
4,1,30,1,30,0,310,1414,1125,35,-1,,1449,1435
5,1,30,1,30,1,310,1418,79,19,95,Total,1437,389
5,1,30,1,30,2,408,1418,97,20,96,Litres,1438,505
5,1,30,1,30,3,524,1419,33,23,96,by,1442,557
5,1,30,1,30,4,576,1420,113,18,96,Product,1438,689
5,1,30,1,30,5,1061,1414,15,35,89,\,1449,1076
5,1,30,1,30,6,1434,1423,1,7,89,|,1430,1435
4,1,30,1,31,0,62,1446,1325,39,-1,,1485,1387
5,1,30,1,31,1,62,1464,2,11,95,|,1475,64
5,1,30,1,31,2,279,1448,93,19,95,103265,1467,372
5,1,30,1,31,3,471,1446,69,31,92,HVGO,1477,540
5,1,30,1,31,4,1076,1451,25,34,53,\,1485,1101
5,1,30,1,31,5,1160,1452,78,19,96,47999,1471,1238
5,1,30,1,31,6,1310,1452,77,19,96,46132,1471,1387
4,1,30,1,32,0,62,1486,1,12,-1,,1498,63
5,1,30,1,32,1,62,1486,1,12,84,|,1498,63
4,1,30,1,33,0,62,1504,1,23,-1,,1527,63
5,1,30,1,33,1,62,1504,1,23,90,|,1527,63
4,1,30,1,34,0,62,1536,2,24,-1,,1560,64
5,1,30,1,34,1,62,1536,2,24,76,|,1560,64
4,1,30,1,35,0,62,1666,2,11,-1,,1677,64
5,1,30,1,35,1,62,1666,2,11,65,|,1677,64
4,1,30,1,36,0,62,1689,1,9,-1,,1698,63
5,1,30,1,36,1,62,1689,1,9,95,|,1698,63
4,1,30,1,37,0,62,1710,1373,26,-1,,1736,1435
5,1,30,1,37,1,62,1710,1,22,95,|,1732,63
5,1,30,1,37,2,256,1732,9,2,42,L,1734,265
5,1,30,1,37,3,1433,1730,2,6,45,|,1736,1435
4,1,30,1,38,0,62,1736,1509,31,-1,,1767,1571
5,1,30,1,38,1,62,1736,1,5,89,|,1741,63
5,1,30,1,38,2,76,1740,61,13,60,DRIVER,1753,137
5,1,30,1,38,3,142,1740,95,14,91,SIGNATURE,1754,237
5,1,30,1,38,4,242,1748,5,2,91,-,1750,247
5,1,30,1,38,5,254,1740,95,14,92,SIGNATURE,1754,349
5,1,30,1,38,6,354,1741,23,13,83,DU,1754,377
5,1,30,1,38,7,383,1741,116,14,92,CONDUCTEUR,1755,499
5,1,30,1,38,8,862,1740,61,25,59,ARRIVE,1765,923
5,1,30,1,38,9,1027,1740,73,26,80,DEBUT,1766,1100
5,1,30,1,38,10,1081,1736,18,41,69,DU,1777,1099
5,1,30,1,38,11,1102,1740,99,26,56,CHARGEMENT,1766,1201
5,1,30,1,38,12,1207,1736,21,41,53,|,1777,1228
5,1,30,1,38,13,1244,1741,149,26,0,FINEUGHRRGEMENT,1767,1393
5,1,30,1,38,14,1504,1742,67,25,0,âQepaRT,1767,1571
4,1,30,1,39,0,859,1789,696,21,-1,,1810,1555
5,1,30,1,39,1,859,1789,78,19,96,02:06,1808,937
5,1,30,1,39,2,1059,1790,78,19,96,02:09,1809,1137
5,1,30,1,39,3,1276,1790,79,19,96,02:24,1809,1355
5,1,30,1,39,4,1476,1792,79,18,93,02:24,1810,1555
4,1,30,1,40,0,75,1820,1496,20,-1,,1840,1571
5,1,30,1,40,1,75,1820,61,14,82,ORIVER,1834,136
5,1,30,1,40,2,142,1821,47,13,72,NAME,1834,189
5,1,30,1,40,3,194,1828,5,3,72,-,1831,199
5,1,30,1,40,4,205,1821,36,14,96,NOM,1835,241
5,1,30,1,40,5,248,1822,21,13,93,DU,1835,269
5,1,30,1,40,6,276,1822,117,13,36,CONDUCTEUR,1835,393
5,1,30,1,40,7,594,1822,61,14,95,DRIVER,1836,655
5,1,30,1,40,8,662,1823,71,14,95,NUMBER,1837,733
5,1,30,1,40,9,1282,1826,53,13,95,TOTAL,1839,1335
5,1,30,1,40,10,1341,1826,84,14,93,QUANTITY,1840,1425
5,1,30,1,40,11,1430,1833,5,3,68,-,1836,1435
5,1,30,1,40,12,1440,1826,61,14,92,QUANT.,1840,1501
5,1,30,1,40,13,1506,1826,65,14,92,TOTALE,1840,1571
4,1,30,1,41,0,580,1837,908,35,-1,,1872,1488
5,1,30,1,41,1,580,1837,20,14,88,No,1851,600
5,1,30,1,41,2,606,1837,145,15,49,DUCONDUCTEUR,1852,751
5,1,30,1,41,3,760,1840,9,10,49,*,1850,769
5,1,30,1,41,4,778,1841,93,22,83,Volume,1863,871
5,1,30,1,41,5,880,1842,113,22,96,corrected,1864,993
5,1,30,1,41,6,1004,1843,21,21,96,to,1864,1025
5,1,30,1,41,7,1037,1842,28,22,96,15,1864,1065
5,1,30,1,41,8,1074,1842,103,28,93,Degrees,1870,1177
5,1,30,1,41,9,1186,1842,19,22,89,C,1864,1205
5,1,30,1,41,10,1214,1842,10,10,89,*,1852,1224
5,1,30,1,41,11,1292,1852,79,19,96,47999,1871,1371
5,1,30,1,41,12,1391,1852,97,20,96,Litres,1872,1488
4,1,30,1,42,0,145,1880,1273,22,-1,,1902,1418
5,1,30,1,42,1,145,1880,114,18,67,SANJEEV_,1898,259
5,1,30,1,42,2,293,1881,81,17,95,KUMAR,1898,374
5,1,30,1,42,3,609,1881,128,19,95,56017257,1900,737
5,1,30,1,42,4,1292,1883,79,19,61,42119,1902,1371
5,1,30,1,42,5,1391,1883,27,19,61,kg,1902,1418
2,1,31,0,0,0,84,1909,67,28,-1,,1937,151
3,1,31,1,0,0,84,1909,67,28,-1,,1937,151
4,1,31,1,1,0,84,1909,67,12,-1,,1921,151
5,1,31,1,1,1,84,1909,67,12,94,PRODUCT,1921,151
4,1,31,1,2,0,86,1926,61,11,-1,,1937,147
5,1,31,1,2,1,86,1926,61,11,96,PRODUIT,1937,147
2,1,32,0,0,0,223,1910,110,45,-1,,1955,333
3,1,32,1,0,0,223,1910,110,45,-1,,1955,333
4,1,32,1,1,0,223,1910,110,11,-1,,1921,333
5,1,32,1,1,1,223,1910,37,11,76,TANK,1921,260
5,1,32,1,1,2,264,1910,69,11,95,CAPACITY,1921,333
4,1,32,1,2,0,226,1926,96,12,-1,,1938,322
5,1,32,1,2,1,226,1926,96,12,69,CONTENANCE,1938,322
4,1,32,1,3,0,224,1943,103,12,-1,,1955,327
5,1,32,1,3,1,224,1943,18,11,92,DU,1954,242
5,1,32,1,3,2,248,1943,79,12,92,RESERVIOR,1955,327
2,1,33,0,0,0,375,1910,101,45,-1,,1955,476
3,1,33,1,0,0,375,1910,101,45,-1,,1955,476
4,1,33,1,1,0,375,1910,101,12,-1,,1922,476
5,1,33,1,1,1,375,1910,50,11,61,WATER,1921,425
5,1,33,1,1,2,429,1911,47,11,32,DIPiCM,1922,476
4,1,33,1,2,0,392,1927,67,12,-1,,1939,459
5,1,33,1,2,1,392,1927,67,12,96,MEASURE,1939,459
4,1,33,1,3,0,394,1944,63,11,-1,,1955,457
5,1,33,1,3,1,394,1944,63,11,46,DEAU/CM,1955,457
2,1,34,0,0,0,488,1911,93,44,-1,,1955,581
3,1,34,1,0,0,488,1911,93,44,-1,,1955,581
4,1,34,1,1,0,488,1911,93,11,-1,,1922,581
5,1,34,1,1,1,488,1911,57,11,95,BEFORE,1922,545
5,1,34,1,1,2,549,1911,32,11,53,DIPS,1922,581
4,1,34,1,2,0,502,1928,67,11,-1,,1939,569
5,1,34,1,2,1,502,1928,46,11,89,AVANT,1939,548
5,1,34,1,2,2,552,1928,17,11,89,LE,1939,569
4,1,34,1,3,0,500,1945,74,10,-1,,1955,574
5,1,34,1,3,1,500,1945,74,10,73,JAUGEAGE,1955,574
2,1,35,0,0,0,604,1911,81,45,-1,,1956,685
3,1,35,1,0,0,604,1911,81,45,-1,,1956,685
4,1,35,1,1,0,604,1911,81,12,-1,,1923,685
5,1,35,1,1,1,604,1911,45,12,96,AFTER,1923,649
5,1,35,1,1,2,654,1911,31,12,96,DIPS,1923,685
4,1,35,1,2,0,612,1928,68,11,-1,,1939,680
5,1,35,1,2,1,612,1928,47,11,90,APRES,1939,659
5,1,35,1,2,2,664,1928,16,11,96,LE,1939,680
4,1,35,1,3,0,610,1945,75,11,-1,,1956,685
5,1,35,1,3,1,610,1945,75,11,91,JAUGEAGE,1956,685
2,1,36,0,0,0,713,1911,108,46,-1,,1957,821
3,1,36,1,0,0,713,1911,108,46,-1,,1957,821
4,1,36,1,1,0,713,1911,108,12,-1,,1923,821
5,1,36,1,1,1,713,1911,53,12,96,ENDING,1923,766
5,1,36,1,1,2,771,1912,50,11,96,INVENT,1923,821
4,1,36,1,2,0,727,1928,82,12,-1,,1940,809
5,1,36,1,2,1,727,1928,82,12,78,INVENTAIRE,1940,809
4,1,36,1,3,0,743,1945,46,12,-1,,1957,789
5,1,36,1,3,1,743,1945,46,12,15,APRES:,1957,789
2,1,37,0,0,0,866,1912,68,29,-1,,1941,934
3,1,37,1,0,0,866,1912,68,29,-1,,1941,934
4,1,37,1,1,0,866,1912,68,11,-1,,1923,934
5,1,37,1,1,1,866,1912,68,11,96,PRODUCT,1923,934
4,1,37,1,2,0,868,1929,62,12,-1,,1941,930
5,1,37,1,2,1,868,1929,62,12,91,PRODUIT,1941,930
2,1,38,0,0,0,1004,1913,111,44,-1,,1957,1115
3,1,38,1,0,0,1004,1913,111,44,-1,,1957,1115
4,1,38,1,1,0,1004,1913,111,11,-1,,1924,1115
5,1,38,1,1,1,1004,1913,37,11,95,TANK,1924,1041
5,1,38,1,1,2,1045,1913,70,11,87,CAPACITY,1924,1115
4,1,38,1,2,0,1007,1930,96,11,-1,,1941,1103
5,1,38,1,2,1,1007,1930,96,11,83,CONTENANCE,1941,1103
4,1,38,1,3,0,1004,1946,105,11,-1,,1957,1109
5,1,38,1,3,1,1004,1946,19,11,87,DU,1957,1023
5,1,38,1,3,2,1028,1946,81,11,87,RESERVIOR,1957,1109
2,1,39,0,0,0,1157,1913,102,45,-1,,1958,1259
3,1,39,1,0,0,1157,1913,102,45,-1,,1958,1259
4,1,39,1,1,0,1157,1913,102,12,-1,,1925,1259
5,1,39,1,1,1,1157,1913,50,12,93,WATER,1925,1207
5,1,39,1,1,2,1212,1913,47,12,75,DIPICM,1925,1259
4,1,39,1,2,0,1172,1930,67,11,-1,,1941,1239
5,1,39,1,2,1,1172,1930,67,11,83,MEASURE,1941,1239
4,1,39,1,3,0,1174,1947,63,11,-1,,1958,1237
5,1,39,1,3,1,1174,1947,63,11,70,BEAUICM,1958,1237
2,1,40,0,0,0,1278,1914,91,45,-1,,1959,1369
3,1,40,1,0,0,1278,1914,91,45,-1,,1959,1369
4,1,40,1,1,0,1278,1914,91,11,-1,,1925,1369
5,1,40,1,1,1,1278,1914,55,11,96,BEFORE,1925,1333
5,1,40,1,1,2,1338,1914,31,11,96,DIPS,1925,1369
4,1,40,1,2,0,1285,1930,66,12,-1,,1942,1351
5,1,40,1,2,1,1285,1930,46,12,79,ANANT,1942,1331
5,1,40,1,2,2,1336,1931,15,11,96,LE,1942,1351
4,1,40,1,3,0,1282,1947,75,12,-1,,1959,1357
5,1,40,1,3,1,1282,1947,75,12,88,JAUGEAGE,1959,1357
2,1,41,0,0,0,1388,1914,81,45,-1,,1959,1469
3,1,41,1,0,0,1388,1914,81,45,-1,,1959,1469
4,1,41,1,1,0,1388,1914,81,11,-1,,1925,1469
5,1,41,1,1,1,1388,1914,45,11,95,AFTER,1925,1433
5,1,41,1,1,2,1438,1914,31,11,56,DIPS.,1925,1469
4,1,41,1,2,0,1393,1931,68,11,-1,,1942,1461
5,1,41,1,2,1,1393,1931,47,11,92,APRES,1942,1440
5,1,41,1,2,2,1444,1931,17,11,96,LE,1942,1461
4,1,41,1,3,0,1394,1948,75,11,-1,,1959,1469
5,1,41,1,3,1,1394,1948,75,11,47,JAUGEAGE,1959,1469
2,1,42,0,0,0,1627,136,5,1764,-1,,1900,1632
3,1,42,1,0,0,1627,136,5,1764,-1,,1900,1632
4,1,42,1,1,0,1627,136,5,1764,-1,,1900,1632
5,1,42,1,1,1,1627,136,5,1764,95, ,1900,1632
2,1,43,0,0,0,1499,1914,108,12,-1,,1926,1607
3,1,43,1,0,0,1499,1914,108,12,-1,,1926,1607
4,1,43,1,1,0,1499,1914,108,12,-1,,1926,1607
5,1,43,1,1,1,1499,1914,53,11,96,ENDING,1925,1552
5,1,43,1,1,2,1557,1914,50,12,96,INVENT,1926,1607
2,1,44,0,0,0,1514,1931,81,28,-1,,1959,1595
3,1,44,1,0,0,1514,1931,81,28,-1,,1959,1595
4,1,44,1,1,0,1514,1931,81,12,-1,,1943,1595
5,1,44,1,1,1,1514,1931,81,12,91,INVENTAIRE,1943,1595
4,1,44,1,2,0,1526,1947,47,12,-1,,1959,1573
5,1,44,1,2,1,1526,1947,47,12,91,APRES,1959,1573
2,1,45,0,0,0,64,1958,1561,7,-1,,1965,1625
3,1,45,1,0,0,64,1958,1561,7,-1,,1965,1625
4,1,45,1,1,0,64,1958,1561,7,-1,,1965,1625
5,1,45,1,1,1,64,1958,1561,7,95, ,1965,1625
2,1,46,0,0,0,1374,1964,4,12,-1,,1976,1378
3,1,46,1,0,0,1374,1964,4,12,-1,,1976,1378
4,1,46,1,1,0,1374,1964,4,12,-1,,1976,1378
5,1,46,1,1,1,1374,1964,4,12,91,T,1976,1378
2,1,47,0,0,0,109,2019,1516,7,-1,,2026,1625
3,1,47,1,0,0,109,2019,1516,7,-1,,2026,1625
4,1,47,1,1,0,109,2019,1516,7,-1,,2026,1625
5,1,47,1,1,1,109,2019,1516,7,95, ,2026,1625
2,1,48,0,0,0,121,2081,1504,7,-1,,2088,1625
3,1,48,1,0,0,121,2081,1504,7,-1,,2088,1625
4,1,48,1,1,0,121,2081,1504,7,-1,,2088,1625
5,1,48,1,1,1,121,2081,1504,7,95, ,2088,1625
2,1,49,0,0,0,172,1904,2,236,-1,,2140,174
3,1,49,1,0,0,172,1904,2,236,-1,,2140,174
4,1,49,1,1,0,172,1904,2,236,-1,,2140,174
5,1,49,1,1,1,172,1904,2,236,95, ,2140,174
2,1,50,0,0,0,370,1905,2,236,-1,,2141,372
3,1,50,1,0,0,370,1905,2,236,-1,,2141,372
4,1,50,1,1,0,370,1905,2,236,-1,,2141,372
5,1,50,1,1,1,370,1905,2,236,95, ,2141,372
2,1,51,0,0,0,481,1905,2,235,-1,,2140,483
3,1,51,1,0,0,481,1905,2,235,-1,,2140,483
4,1,51,1,1,0,481,1905,2,235,-1,,2140,483
5,1,51,1,1,1,481,1905,2,235,95, ,2140,483
2,1,52,0,0,0,592,1906,1,237,-1,,2143,593
3,1,52,1,0,0,592,1906,1,237,-1,,2143,593
4,1,52,1,1,0,592,1906,1,237,-1,,2143,593
5,1,52,1,1,1,592,1906,1,237,95, ,2143,593
2,1,53,0,0,0,39,2157,346,18,-1,,2175,385
3,1,53,1,0,0,39,2157,346,18,-1,,2175,385
4,1,53,1,1,0,39,2157,346,18,-1,,2175,385
5,1,53,1,1,1,39,2157,12,14,86,A,2171,51
5,1,53,1,1,2,55,2157,52,14,86,Suncor,2171,107
5,1,53,1,1,3,112,2158,66,13,92,business,2171,178
5,1,53,1,1,4,183,2158,5,14,92,/,2172,188
5,1,53,1,1,5,194,2158,29,13,93,Une,2171,223
5,1,53,1,1,6,229,2158,74,17,90,entreprise,2175,303
5,1,53,1,1,7,308,2159,18,13,96,de,2172,326
5,1,53,1,1,8,332,2158,53,14,96,Suncor,2172,385
2,1,54,0,0,0,1263,1908,2,207,-1,,2115,1265
3,1,54,1,0,0,1263,1908,2,207,-1,,2115,1265
4,1,54,1,1,0,1263,1908,2,207,-1,,2115,1265
5,1,54,1,1,1,1263,1908,2,207,95, ,2115,1265
2,1,55,0,0,0,56,1886,1578,269,-1,,2155,1634
3,1,55,1,0,0,56,1886,1578,269,-1,,2155,1634
4,1,55,1,1,0,56,1886,1578,269,-1,,2155,1634
5,1,55,1,1,1,56,1886,1578,269,95, ,2155,1634
2,1,56,0,0,0,1375,1908,2,237,-1,,2145,1377
3,1,56,1,0,0,1375,1908,2,237,-1,,2145,1377
4,1,56,1,1,0,1375,1908,2,237,-1,,2145,1377
5,1,56,1,1,1,1375,1908,2,237,95, ,2145,1377
2,1,57,0,0,0,1553,2159,110,17,-1,,2176,1663
3,1,57,1,0,0,1553,2159,110,17,-1,,2176,1663
4,1,57,1,1,0,1553,2159,110,17,-1,,2176,1663
5,1,57,1,1,1,1553,2159,53,14,47,112791,2173,1606
5,1,57,1,1,2,1612,2159,51,17,95,(05/17),2176,1663
1,1,0,0,0,0,0,0,1700,2200,-1,,2200,1700
2,1,1,0,0,0,716,15,236,54,-1,,69,952
3,1,1,1,0,0,716,15,236,54,-1,,69,952
4,1,1,1,1,0,716,15,236,54,-1,,69,952
5,1,1,1,1,1,716,15,236,54,8,Q4yoqohy,69,952
2,1,2,0,0,0,912,79,612,24,-1,,103,1524
3,1,2,1,0,0,912,79,612,24,-1,,103,1524
4,1,2,1,1,0,912,79,612,24,-1,,103,1524
5,1,2,1,1,1,912,79,117,21,96,VEHICLE,100,1029
5,1,2,1,1,2,1040,80,122,21,96,LOADING,101,1162
5,1,2,1,1,3,1172,80,114,22,93,REPORT,102,1286
5,1,2,1,1,4,1284,75,14,38,93,-,113,1298
5,1,2,1,1,5,1312,81,55,21,96,BILL,102,1367
5,1,2,1,1,6,1377,82,36,20,93,OF,102,1413
5,1,2,1,1,7,1424,82,100,21,91,LADING,103,1524
2,1,3,0,0,0,66,126,1566,10,-1,,136,1632
3,1,3,1,0,0,66,126,1566,10,-1,,136,1632
4,1,3,1,1,0,66,126,1566,10,-1,,136,1632
5,1,3,1,1,1,66,126,1566,10,95, ,136,1632
2,1,4,0,0,0,479,129,3,97,-1,,226,482
3,1,4,1,0,0,479,129,3,97,-1,,226,482
4,1,4,1,1,0,479,129,3,97,-1,,226,482
5,1,4,1,1,1,479,129,3,97,95, ,226,482
2,1,5,0,0,0,66,221,633,6,-1,,227,699
3,1,5,1,0,0,66,221,633,6,-1,,227,699
4,1,5,1,1,0,66,221,633,6,-1,,227,699
5,1,5,1,1,1,66,221,633,6,95, ,227,699
2,1,6,0,0,0,822,226,810,6,-1,,232,1632
3,1,6,1,0,0,822,226,810,6,-1,,232,1632
4,1,6,1,1,0,822,226,810,6,-1,,232,1632
5,1,6,1,1,1,822,226,810,6,95, ,232,1632
2,1,7,0,0,0,674,226,1,62,-1,,288,675
3,1,7,1,0,0,674,226,1,62,-1,,288,675
4,1,7,1,1,0,674,226,1,62,-1,,288,675
5,1,7,1,1,1,674,226,1,62,95, ,288,675
2,1,8,0,0,0,674,286,181,4,-1,,290,855
3,1,8,1,0,0,674,286,181,4,-1,,290,855
4,1,8,1,1,0,674,286,181,4,-1,,290,855
5,1,8,1,1,1,674,286,181,4,95, ,290,855
2,1,9,0,0,0,272,397,582,5,-1,,402,854
3,1,9,1,0,0,272,397,582,5,-1,,402,854
4,1,9,1,1,0,272,397,582,5,-1,,402,854
5,1,9,1,1,1,272,397,582,5,95, ,402,854
2,1,10,0,0,0,852,228,4,244,-1,,472,856
3,1,10,1,0,0,852,228,4,244,-1,,472,856
4,1,10,1,1,0,852,228,4,244,-1,,472,856
5,1,10,1,1,1,852,228,4,244,95, ,472,856
2,1,11,0,0,0,272,398,1,71,-1,,469,273
3,1,11,1,0,0,272,398,1,71,-1,,469,273
4,1,11,1,1,0,272,398,1,71,-1,,469,273
5,1,11,1,1,1,272,398,1,71,95, ,469,273
2,1,12,0,0,0,65,465,1564,10,-1,,475,1629
3,1,12,1,0,0,65,465,1564,10,-1,,475,1629
4,1,12,1,1,0,65,465,1564,10,-1,,475,1629
5,1,12,1,1,1,65,465,1564,10,95, ,475,1629
2,1,13,0,0,0,480,469,240,200,-1,,669,720
3,1,13,1,0,0,480,469,240,200,-1,,669,720
4,1,13,1,1,0,710,469,10,25,-1,,494,720
5,1,13,1,1,1,710,469,10,25,95, ,494,720
4,1,13,1,2,0,710,494,10,37,-1,,531,720
5,1,13,1,2,1,710,494,10,37,95, ,531,720
4,1,13,1,3,0,480,531,240,79,-1,,610,720
5,1,13,1,3,1,480,586,14,24,95, ,610,494
5,1,13,1,3,2,664,531,56,79,95,    ,610,720
4,1,13,1,4,0,710,610,10,59,-1,,669,720
5,1,13,1,4,1,710,610,10,59,95, ,669,720
2,1,14,0,0,0,478,585,3,80,-1,,665,481
3,1,14,1,0,0,478,585,3,80,-1,,665,481
4,1,14,1,1,0,478,585,3,80,-1,,665,481
5,1,14,1,1,1,478,585,3,80,95, ,665,481
2,1,15,0,0,0,1101,472,4,196,-1,,668,1105
3,1,15,1,0,0,1101,472,4,196,-1,,668,1105
4,1,15,1,1,0,1101,472,4,196,-1,,668,1105
5,1,15,1,1,1,1101,472,4,196,95, ,668,1105
2,1,16,0,0,0,65,660,1567,10,-1,,670,1632
3,1,16,1,0,0,65,660,1567,10,-1,,670,1632
4,1,16,1,1,0,65,660,1567,10,-1,,670,1632
5,1,16,1,1,1,65,660,1567,10,95, ,670,1632
2,1,17,0,0,0,85,730,1547,9,-1,,739,1632
3,1,17,1,0,0,85,730,1547,9,-1,,739,1632
4,1,17,1,1,0,85,730,1547,9,-1,,739,1632
5,1,17,1,1,1,85,730,1547,9,95, ,739,1632
2,1,18,0,0,0,63,238,7,970,-1,,1208,70
3,1,18,1,0,0,63,238,7,970,-1,,1208,70
4,1,18,1,1,0,63,238,7,970,-1,,1208,70
5,1,18,1,1,1,63,238,7,970,95, ,1208,70
2,1,19,0,0,0,253,665,9,1069,-1,,1734,262
3,1,19,1,0,0,253,665,9,1069,-1,,1734,262
4,1,19,1,1,0,253,665,9,1069,-1,,1734,262
5,1,19,1,1,1,253,665,9,1069,95, ,1734,262
2,1,20,0,0,0,935,665,2,128,-1,,793,937
3,1,20,1,0,0,935,665,2,128,-1,,793,937
4,1,20,1,1,0,935,665,2,128,-1,,793,937
5,1,20,1,1,1,935,665,2,128,95, ,793,937
2,1,21,0,0,0,931,973,7,763,-1,,1736,938
3,1,21,1,0,0,931,973,7,763,-1,,1736,938
4,1,21,1,1,0,931,973,7,763,-1,,1736,938
5,1,21,1,1,1,931,973,7,763,95, ,1736,938
2,1,22,0,0,0,1126,666,8,1071,-1,,1737,1134
3,1,22,1,0,0,1126,666,8,1071,-1,,1737,1134
4,1,22,1,1,0,1126,666,8,1071,-1,,1737,1134
5,1,22,1,1,1,1126,666,8,1071,95, ,1737,1134
2,1,23,0,0,0,1432,668,8,1070,-1,,1738,1440
3,1,23,1,0,0,1432,668,8,1070,-1,,1738,1440
4,1,23,1,1,0,1432,668,8,1070,-1,,1738,1440
5,1,23,1,1,1,1432,668,8,1070,95, ,1738,1440
2,1,24,0,0,0,1279,667,8,1071,-1,,1738,1287
3,1,24,1,0,0,1279,667,8,1071,-1,,1738,1287
4,1,24,1,1,0,1279,667,8,1071,-1,,1738,1287
5,1,24,1,1,1,1279,667,8,1071,95, ,1738,1287
2,1,25,0,0,0,1514,668,9,1071,-1,,1739,1523
3,1,25,1,0,0,1514,668,9,1071,-1,,1739,1523
4,1,25,1,1,0,1514,668,9,1071,-1,,1739,1523
5,1,25,1,1,1,1514,668,9,1071,95, ,1739,1523
2,1,26,0,0,0,63,1729,1563,11,-1,,1740,1626
3,1,26,1,0,0,63,1729,1563,11,-1,,1740,1626
4,1,26,1,1,0,63,1729,1563,11,-1,,1740,1626
5,1,26,1,1,1,63,1729,1563,11,95, ,1740,1626
2,1,27,0,0,0,795,1734,2,87,-1,,1821,797
3,1,27,1,0,0,795,1734,2,87,-1,,1821,797
4,1,27,1,1,0,795,1734,2,87,-1,,1821,797
5,1,27,1,1,1,795,1734,2,87,95, ,1821,797
2,1,28,0,0,0,1003,1735,2,86,-1,,1821,1005
3,1,28,1,0,0,1003,1735,2,86,-1,,1821,1005
4,1,28,1,1,0,1003,1735,2,86,-1,,1821,1005
5,1,28,1,1,1,1003,1735,2,86,95, ,1821,1005
2,1,29,0,0,0,1211,1735,2,87,-1,,1822,1213
3,1,29,1,0,0,1211,1735,2,87,-1,,1822,1213
4,1,29,1,1,0,1211,1735,2,87,-1,,1822,1213
5,1,29,1,1,1,1211,1735,2,87,95, ,1822,1213
2,1,30,0,0,0,83,1814,1546,10,-1,,1824,1629
3,1,30,1,0,0,83,1814,1546,10,-1,,1824,1629
4,1,30,1,1,0,83,1814,1546,10,-1,,1824,1629
5,1,30,1,1,1,83,1814,1546,10,95, ,1824,1629
2,1,31,0,0,0,76,106,1553,1795,-1,,1901,1629
3,1,31,1,0,0,138,106,1491,63,-1,,169,1629
4,1,31,1,1,0,150,106,1479,25,-1,,131,1629
5,1,31,1,1,1,150,106,74,23,96,Page:,129,224
5,1,31,1,1,2,248,106,12,18,96,1,124,260
5,1,31,1,1,3,481,107,45,19,96,530,126,526
5,1,31,1,1,4,816,106,132,22,96,RAPPORT,128,948
5,1,31,1,1,5,958,106,35,22,92,DE,128,993
5,1,31,1,1,6,1003,106,196,23,90,CHARGEMENT,129,1199
5,1,31,1,1,7,1208,120,8,3,90,-,123,1216
5,1,31,1,1,8,1224,108,138,22,90,VEHICULE,130,1362
5,1,31,1,1,9,1371,120,9,4,92,-,124,1380
5,1,31,1,1,10,1389,109,240,22,91,CONNAISSEMENT,131,1629
4,1,31,1,2,0,138,134,535,25,-1,,159,673
5,1,31,1,2,1,138,135,109,15,95,DOCUMENT,150,247
5,1,31,1,2,2,254,136,82,15,74,NUMBER,151,336
5,1,31,1,2,3,364,137,60,18,74,1663,155,424
5,1,31,1,2,4,537,134,35,24,93,DATE,158,572
5,1,31,1,2,5,581,130,92,39,74,DEXPEDITION,169,673
4,1,31,1,3,0,138,154,172,15,-1,,169,310
5,1,31,1,3,1,138,154,12,14,96,No,168,150
5,1,31,1,3,2,169,154,24,14,96,DU,168,193
5,1,31,1,3,3,201,154,109,15,96,DOCUMENT,169,310
3,1,31,2,0,0,151,158,1460,42,-1,,200,1611
4,1,31,2,1,0,151,158,1460,42,-1,,200,1611
5,1,31,2,1,1,151,158,10,10,87,Â°,168,161
5,1,31,2,1,2,523,163,138,37,94,mm/dd/yy,200,661
5,1,31,2,1,3,801,171,29,20,93,24,191,830
5,1,31,2,1,4,840,170,79,22,89,HOUR,192,919
5,1,31,2,1,5,930,172,118,21,0,NUMBER_,193,1048
5,1,31,2,1,6,1069,170,68,21,0,(403),191,1137
5,1,31,2,1,7,1147,170,128,19,0,296-3000,189,1275
5,1,31,2,1,8,1311,174,139,21,66,-NUMERO,195,1450
5,1,31,2,1,9,1459,174,29,21,96,24,195,1488
5,1,31,2,1,10,1499,174,112,22,96,HEURES,196,1611
3,1,31,3,0,0,80,194,1535,62,-1,,256,1615
4,1,31,3,1,0,151,194,1223,31,-1,,225,1374
5,1,31,3,1,1,151,194,108,19,94,0114753,213,259
5,1,31,3,1,2,282,196,93,19,95,10/002,215,375
5,1,31,3,1,3,530,197,128,20,95,10/08/24,217,658
5,1,31,3,1,4,1051,202,231,22,93,COLLECT,224,1282
5,1,31,3,1,5,1180,189,14,41,93,-,230,1194
5,1,31,3,1,6,1207,202,73,22,92,FRAIS,224,1280
5,1,31,3,1,7,1292,204,82,21,92,VIRES,225,1374
4,1,31,3,2,0,80,226,1535,30,-1,,256,1615
5,1,31,3,2,1,80,226,196,15,91,CONSIGNEE/CUSTOMER,241,276
5,1,31,3,2,2,282,234,4,3,91,-,237,286
5,1,31,3,2,3,292,228,183,14,91,DESTINATAIRE/CLIENT,242,475
5,1,31,3,2,4,689,227,18,25,3,Poo,252,707
5,1,31,3,2,5,711,241,128,12,0,aaeeettwr,253,839
5,1,31,3,2,6,851,222,9,35,93,|,257,860
5,1,31,3,2,7,864,231,102,14,90,CONSIGNOR,245,966
5,1,31,3,2,8,971,239,5,2,91,-,241,976
5,1,31,3,2,9,982,232,106,14,91,EXPEDITEUR,246,1088
5,1,31,3,2,10,1462,225,73,35,0,TRCN,260,1535
5,1,31,3,2,11,1543,225,54,35,16,NOREER,260,1597
3,1,31,4,0,0,147,254,1426,30,-1,,284,1573
4,1,31,4,1,0,147,254,1426,30,-1,,284,1573
5,1,31,4,1,1,147,254,181,25,95,Mississauga,279,328
5,1,31,4,1,2,346,256,80,20,96,Lubes,276,426
5,1,31,4,1,3,446,258,98,19,96,Center,277,544
5,1,31,4,1,4,680,259,161,20,91,0000081523,279,841
5,1,31,4,1,5,860,259,184,25,90,|Mississauga,284,1044
5,1,31,4,1,6,1062,261,80,19,96,Lubes,280,1142
5,1,31,4,1,7,1162,262,97,19,95,Center,281,1259
5,1,31,4,1,8,1463,263,110,19,95,0081523,282,1573
3,1,31,5,0,0,150,286,1011,25,-1,,311,1161
4,1,31,5,1,0,150,286,1011,25,-1,,311,1161
5,1,31,5,1,1,150,286,44,19,96,385,305,194
5,1,31,5,1,2,217,287,144,19,95,Southdown,306,361
5,1,31,5,1,3,379,288,65,19,96,Road,307,444
5,1,31,5,1,4,680,290,161,19,61,0000000104,309,841
5,1,31,5,1,5,863,292,45,18,61,|385,310,908
5,1,31,5,1,6,930,292,147,19,96,Southdown,311,1077
5,1,31,5,1,7,1095,292,66,19,96,Road,311,1161
3,1,31,6,0,0,147,316,1060,29,-1,,345,1207
4,1,31,6,1,0,147,316,1060,29,-1,,345,1207
5,1,31,6,1,1,147,316,175,25,92,"Missisauga,",341,322
5,1,31,6,1,2,346,320,32,18,92,ON,338,378
5,1,31,6,1,3,396,319,95,19,6,L5d2y2,338,491
5,1,31,6,1,4,860,321,177,24,90,"Missisauga,",345,1037
5,1,31,6,1,5,1062,324,32,18,92,ON,342,1094
5,1,31,6,1,6,1112,324,95,18,0,L5J2y2,342,1207
3,1,31,7,0,0,280,402,567,66,-1,,468,847
4,1,31,7,1,0,280,402,567,17,-1,,419,847
5,1,31,7,1,1,280,402,61,12,93,RELEASE,414,341
5,1,31,7,1,2,346,402,49,15,85,(C-of-A),417,395
5,1,31,7,1,3,400,402,58,12,54,NUMBER:,414,458
5,1,31,7,1,4,562,406,2,13,89,|,419,564
5,1,31,7,1,5,569,404,79,11,95,CUSTOMER,415,648
5,1,31,7,1,6,652,404,77,12,95,PURCHASE,416,729
5,1,31,7,1,7,734,405,49,11,96,ORDER,416,783
5,1,31,7,1,8,788,405,59,11,23,NUMER:,416,847
4,1,31,7,2,0,619,418,191,12,-1,,430,810
5,1,31,7,2,1,619,418,17,11,94,No,429,636
5,1,31,7,2,2,641,418,18,11,96,DE,429,659
5,1,31,7,2,3,664,418,68,12,96,DEMANDE,430,732
5,1,31,7,2,4,737,419,19,11,96,DU,430,756
5,1,31,7,2,5,761,419,49,11,96,CLIENT,430,810
4,1,31,7,3,0,562,440,1,28,-1,,468,563
5,1,31,7,3,1,562,440,1,28,82,|,468,563
3,1,31,8,0,0,79,476,1337,18,-1,,494,1416
4,1,31,8,1,0,79,476,1337,18,-1,,494,1416
5,1,31,8,1,1,79,476,73,14,92,CARRIER,490,152
5,1,31,8,1,2,157,484,5,2,89,-,486,162
5,1,31,8,1,3,167,477,136,14,89,TRANSPORTEUR,491,303
5,1,31,8,1,4,735,478,70,14,96,VEHICLE,492,805
5,1,31,8,1,5,812,478,71,14,93,NUMBER,492,883
5,1,31,8,1,6,924,479,71,13,46,LICENSE,492,995
5,1,31,8,1,7,1001,479,71,13,94,NUMBER,492,1072
5,1,31,8,1,8,1133,480,78,14,96,ADDRESS,494,1211
5,1,31,8,1,9,1218,480,21,14,96,OF,494,1239
5,1,31,8,1,10,1246,480,57,14,96,METER,494,1303
5,1,31,8,1,11,1308,481,34,13,96,AND,494,1342
5,1,31,8,1,12,1348,481,68,13,96,TRADER,494,1416
3,1,31,9,0,0,149,500,1331,22,-1,,522,1480
4,1,31,9,1,0,149,500,1331,22,-1,,522,1480
5,1,31,9,1,1,149,502,112,17,96,PREMIER,519,261
5,1,31,9,1,2,279,503,65,17,96,BULK,520,344
5,1,31,9,1,3,362,503,113,18,96,SYSTEMS,521,475
5,1,31,9,1,4,579,503,111,19,95,5000234,522,690
5,1,31,9,1,5,707,490,15,36,93,|,526,722
5,1,31,9,1,6,739,500,136,14,56,NeDUVEHICULE,514,875
5,1,31,9,1,7,902,490,12,36,43,=,526,914
5,1,31,9,1,8,924,501,73,13,0,NOMBRE,514,997
5,1,31,9,1,9,1002,501,22,13,0,DE,514,1024
5,1,31,9,1,10,1031,502,62,12,77,PERMIS,514,1093
5,1,31,9,1,11,1097,490,9,36,77,|,526,1106
5,1,31,9,1,12,1119,502,91,14,65,L'ADRESSE,516,1210
5,1,31,9,1,13,1216,503,22,13,90,DE,516,1238
5,1,31,9,1,14,1244,503,57,13,90,METRE,516,1301
5,1,31,9,1,15,1308,503,20,13,95,ET,516,1328
5,1,31,9,1,16,1333,503,21,13,93,DE,516,1354
5,1,31,9,1,17,1361,503,119,13,92,COMMERCANT,516,1480
3,1,31,10,0,0,149,530,1325,30,-1,,560,1474
4,1,31,10,1,0,149,530,1325,30,-1,,560,1474
5,1,31,10,1,1,149,530,28,19,90,25,549,177
5,1,31,10,1,2,197,531,114,23,96,Gormley,554,311
5,1,31,10,1,3,330,531,161,20,96,Industrial,551,491
5,1,31,10,1,4,511,534,31,17,96,Dr,551,542
5,1,31,10,1,5,728,534,95,19,95,919322,553,823
5,1,31,10,1,6,1112,537,96,18,95,Suncor,555,1208
5,1,31,10,1,7,1228,538,98,22,96,Energy,560,1326
5,1,31,10,1,8,1345,537,129,19,96,Products,556,1474
3,1,31,11,0,0,147,558,1277,31,-1,,589,1424
4,1,31,11,1,0,147,558,1277,31,-1,,589,1424
5,1,31,11,1,1,147,558,114,31,95,GORMLEY,589,261
5,1,31,11,1,2,729,565,78,18,95,51202,583,807
5,1,31,11,1,3,1112,567,61,18,96,3275,585,1173
5,1,31,11,1,4,1194,567,115,19,95,Rebecca,586,1309
5,1,31,11,1,5,1328,569,96,17,96,Street,586,1424
3,1,31,12,0,0,147,592,525,26,-1,,618,672
4,1,31,12,1,0,147,592,525,26,-1,,618,672
5,1,31,12,1,1,147,592,95,20,69,LOH1GO,612,242
5,1,31,12,1,2,489,592,65,26,30,BPG,618,554
5,1,31,12,1,3,568,593,104,25,0,ERECTE,618,672
3,1,31,13,0,0,154,622,203,22,-1,,644,357
4,1,31,13,1,0,154,622,203,22,-1,,644,357
5,1,31,13,1,1,154,622,203,22,91,(226)338-5962,644,357
3,1,31,14,0,0,988,675,618,16,-1,,691,1606
4,1,31,14,1,0,988,675,618,16,-1,,691,1606
5,1,31,14,1,1,988,675,68,14,95,FACTOR,689,1056
5,1,31,14,1,2,1164,676,92,13,87,MEASURED,689,1256
5,1,31,14,1,3,1276,665,12,34,74,|,699,1288
5,1,31,14,1,4,1308,677,94,13,74,NETLITRES,690,1402
5,1,31,14,1,5,1535,678,71,13,95,DENSITY,691,1606
3,1,31,15,0,0,79,681,1527,60,-1,,741,1606
4,1,31,15,1,0,79,681,1527,30,-1,,711,1606
5,1,31,15,1,1,79,681,142,14,11,PRODUCTIMETER,695,221
5,1,31,15,1,2,574,705,4,2,36,7,707,578
5,1,31,15,1,3,988,695,78,13,92,FACTEUR,708,1066
5,1,31,15,1,4,1176,695,57,14,96,LITRES,709,1233
5,1,31,15,1,5,1307,696,105,13,55,corrected,709,1412
5,1,31,15,1,6,1440,688,62,14,74,|TEMPC,702,1502
5,1,31,15,1,7,1512,684,10,35,88,|,719,1522
5,1,31,15,1,8,1535,697,71,14,66,pensite,711,1606
4,1,31,15,2,0,79,697,1513,44,-1,,741,1592
5,1,31,15,2,1,79,698,135,35,66,PRODUIT/METER,733,214
5,1,31,15,2,2,370,697,80,14,93,PRODUCT,711,450
5,1,31,15,2,3,456,698,112,13,43,OESCRIPTION:,711,568
5,1,31,15,2,4,585,698,140,14,44,DESCRIPTION.OU,712,725
5,1,31,15,2,5,732,699,73,14,77,PRODUIT,713,805
5,1,31,15,2,6,987,714,26,13,76,API,727,1013
5,1,31,15,2,7,1019,714,52,13,76,TABLE,727,1071
5,1,31,15,2,8,1164,715,91,14,42,MESUREES,729,1255
5,1,31,15,2,9,1332,716,62,13,67,TO15C,729,1394
5,1,31,15,2,10,1441,716,85,25,0,â_|CELSIUS,741,1526
5,1,31,15,2,11,1518,705,7,40,9,&,745,1525
5,1,31,15,2,12,1535,716,57,17,74,kgicu.m,733,1592
3,1,31,16,0,0,148,744,1424,25,-1,,769,1572
4,1,31,16,1,0,148,744,1424,25,-1,,769,1572
5,1,31,16,1,1,148,744,93,19,96,103265,763,241
5,1,31,16,1,2,256,740,15,33,94,|,773,271
5,1,31,16,1,3,278,746,48,18,94,NOT,764,326
5,1,31,16,1,4,344,746,148,19,95,REGULATED,765,492
5,1,31,16,1,5,510,748,82,17,96,UNDER,765,592
5,1,31,16,1,6,610,748,49,18,96,TDG,766,659
5,1,31,16,1,7,978,749,95,18,95,0.9609,767,1073
5,1,31,16,1,8,1161,749,79,19,96,24500,768,1240
5,1,31,16,1,9,1311,750,78,19,96,23542,769,1389
5,1,31,16,1,10,1445,750,127,19,45,66.1/|913,769,1572
3,1,31,17,0,0,145,775,930,22,-1,,797,1075
4,1,31,17,1,0,145,775,930,22,-1,,797,1075
5,1,31,17,1,1,145,775,96,18,90,MTR222,793,241
5,1,31,17,1,2,254,771,14,31,92,|,802,268
5,1,31,17,1,3,278,777,64,18,88,HVGO,795,342
5,1,31,17,1,4,958,781,49,16,88,API,797,1007
5,1,31,17,1,5,1029,780,46,17,87,54B,797,1075
3,1,31,18,0,0,76,814,1496,1087,-1,,1901,1572
4,1,31,18,1,0,935,814,1,10,-1,,824,936
5,1,31,18,1,1,935,814,1,10,73,|,824,936
4,1,31,18,2,0,148,835,1424,26,-1,,861,1572
5,1,31,18,2,1,148,835,93,20,96,103265,855,241
5,1,31,18,2,2,254,831,16,35,96,|,866,270
5,1,31,18,2,3,277,837,49,19,96,NOT,856,326
5,1,31,18,2,4,344,838,148,18,96,REGULATED,856,492
5,1,31,18,2,5,510,839,82,18,96,UNDER,857,592
5,1,31,18,2,6,610,839,48,19,96,TDG,858,658
5,1,31,18,2,7,978,840,95,18,91,0.9611,858,1073
5,1,31,18,2,8,1161,840,78,20,96,23500,860,1239
5,1,31,18,2,9,1310,841,80,19,96,22586,860,1390
5,1,31,18,2,10,1445,842,127,19,21,65.9/913,861,1572
4,1,31,18,3,0,145,866,930,33,-1,,899,1075
5,1,31,18,3,1,145,866,96,19,92,MTR221,885,241
5,1,31,18,3,2,253,862,16,32,93,|,894,269
5,1,31,18,3,3,278,868,64,18,89,HVGO,886,342
5,1,31,18,3,4,935,889,1,10,76,|,899,936
5,1,31,18,3,5,958,872,49,17,94,API,889,1007
5,1,31,18,3,6,1028,871,47,18,34,543,889,1075
4,1,31,18,4,0,295,889,201,85,-1,,974,496
5,1,31,18,4,1,295,910,35,52,28,cad,962,330
5,1,31,18,4,2,328,891,70,83,14,x),974,398
5,1,31,18,4,3,394,889,43,80,0,of,969,437
5,1,31,18,4,4,450,893,46,72,0,by,965,496
4,1,31,18,5,0,352,1077,107,29,-1,,1106,459
5,1,31,18,5,1,352,1083,18,10,69,-,1093,370
5,1,31,18,5,2,386,1077,33,29,56,oO,1106,419
5,1,31,18,5,3,452,1087,7,9,29,â,1096,459
4,1,31,18,6,0,292,1071,338,59,-1,,1130,630
5,1,31,18,6,1,292,1071,56,38,0,IV,1109,348
5,1,31,18,6,2,412,1081,112,45,46,O35,1126,524
5,1,31,18,6,3,551,1091,79,39,37,Am,1130,630
4,1,31,18,7,0,260,1169,133,43,-1,,1212,393
5,1,31,18,7,1,260,1169,80,40,46,OUT.,1209,340
5,1,31,18,7,2,366,1187,27,25,51,6,1212,393
4,1,31,18,8,0,332,1196,116,16,-1,,1212,448
5,1,31,18,8,1,332,1198,18,7,23,-,1205,350
5,1,31,18,8,2,441,1196,7,16,19,",",1212,448
4,1,31,18,9,0,400,1187,198,47,-1,,1234,598
5,1,31,18,9,1,400,1187,92,45,52,Ylo,1232,492
5,1,31,18,9,2,518,1196,80,38,26,An,1234,598
4,1,31,18,10,0,311,1418,378,24,-1,,1442,689
5,1,31,18,10,1,311,1419,79,19,96,Total,1438,390
5,1,31,18,10,2,410,1418,97,20,96,Litres,1438,507
5,1,31,18,10,3,526,1420,33,22,96,by,1442,559
5,1,31,18,10,4,577,1420,112,19,96,Product,1439,689
4,1,31,18,11,0,279,1449,1110,23,-1,,1472,1389
5,1,31,18,11,1,279,1449,94,20,96,103265,1469,373
5,1,31,18,11,2,475,1451,66,19,91,HVGO,1470,541
5,1,31,18,11,3,1160,1453,79,19,96,48000,1472,1239
5,1,31,18,11,4,1310,1454,79,18,96,46128,1472,1389
4,1,31,18,12,0,76,1739,1495,27,-1,,1766,1571
5,1,31,18,12,1,76,1739,61,14,96,DRIVER,1753,137
5,1,31,18,12,2,144,1740,95,13,93,SIGNATURE,1753,239
5,1,31,18,12,3,244,1747,5,2,90,-,1749,249
5,1,31,18,12,4,254,1740,95,14,95,SIGNATURE,1754,349
5,1,31,18,12,5,356,1740,22,14,93,DU,1754,378
5,1,31,18,12,6,384,1740,117,14,79,CONDUCTEUR,1754,501
5,1,31,18,12,7,864,1739,60,26,0,ARRIVE,1765,924
5,1,31,18,12,8,1028,1740,73,25,65,DEBUT,1765,1101
5,1,31,18,12,9,1082,1735,18,41,55,EU,1776,1100
5,1,31,18,12,10,1102,1739,99,26,39,CHARGEMENT,1765,1201
5,1,31,18,12,11,1208,1735,21,41,25,|,1776,1229
5,1,31,18,12,12,1244,1740,149,26,62,FINDUCHARGENENT,1766,1393
5,1,31,18,12,13,1505,1741,66,25,41,teat,1766,1571
4,1,31,18,13,0,860,1788,695,22,-1,,1810,1555
5,1,31,18,13,1,860,1788,78,20,95,03:37,1808,938
5,1,31,18,13,2,1060,1789,79,19,95,03:40,1808,1139
5,1,31,18,13,3,1278,1790,77,19,96,03:56,1809,1355
5,1,31,18,13,4,1477,1790,78,20,95,03:56,1810,1555
4,1,31,18,14,0,76,1820,1496,31,-1,,1851,1572
5,1,31,18,14,1,76,1820,61,14,89,ORIVER,1834,137
5,1,31,18,14,2,144,1821,46,13,84,NAME,1834,190
5,1,31,18,14,3,195,1828,5,3,84,-,1831,200
5,1,31,18,14,4,206,1822,37,13,87,NOM,1835,243
5,1,31,18,14,5,250,1822,21,13,87,DU,1835,271
5,1,31,18,14,6,277,1822,117,14,71,CONDUGTEUR,1836,394
5,1,31,18,14,7,582,1823,75,27,0,NORIVER,1850,657
5,1,31,18,14,8,662,1823,71,14,47,NUMBER,1837,733
5,1,31,18,14,9,1216,1842,9,9,0,:,1851,1225
5,1,31,18,14,10,1283,1826,54,13,94,TOTAL,1839,1337
5,1,31,18,14,11,1342,1826,83,13,93,QUANTITY,1839,1425
5,1,31,18,14,12,1430,1833,5,2,92,-,1835,1435
5,1,31,18,14,13,1441,1826,61,14,88,QUANT.,1840,1502
5,1,31,18,14,14,1508,1826,64,14,92,TOTALE,1840,1572
4,1,31,18,15,0,592,1837,897,34,-1,,1871,1489
5,1,31,18,15,1,592,1840,9,10,53,0,1850,601
5,1,31,18,15,2,608,1838,21,13,73,DU,1851,629
5,1,31,18,15,3,636,1837,117,15,8,CONDUCTEUR,1852,753
5,1,31,18,15,4,762,1840,9,10,82,*,1850,771
5,1,31,18,15,5,780,1840,92,22,93,Volume,1862,872
5,1,31,18,15,6,882,1842,113,21,96,corrected,1863,995
5,1,31,18,15,7,1004,1843,23,20,96,to,1863,1027
5,1,31,18,15,8,1038,1842,27,22,95,15,1864,1065
5,1,31,18,15,9,1076,1842,102,27,93,Degrees,1869,1178
5,1,31,18,15,10,1188,1842,18,22,93,C,1864,1206
5,1,31,18,15,11,1293,1852,79,18,96,48000,1870,1372
5,1,31,18,15,12,1392,1851,97,20,93,Litres,1871,1489
4,1,31,18,16,0,146,1879,1272,22,-1,,1901,1418
5,1,31,18,16,1,146,1879,114,19,58,SANJEEV_,1898,260
5,1,31,18,16,2,294,1881,81,17,93,KUMAR,1898,375
5,1,31,18,16,3,610,1880,127,20,95,56017257,1900,737
5,1,31,18,16,4,1293,1882,78,19,53,42115,1901,1371
5,1,31,18,16,5,1392,1882,26,19,53,kg,1901,1418
2,1,32,0,0,0,61,1456,5,442,-1,,1898,66
3,1,32,1,0,0,61,1456,5,442,-1,,1898,66
4,1,32,1,1,0,61,1456,5,442,-1,,1898,66
5,1,32,1,1,1,61,1456,5,442,95, ,1898,66
2,1,33,0,0,0,57,1884,553,26,-1,,1910,610
3,1,33,1,0,0,57,1884,553,26,-1,,1910,610
4,1,33,1,1,0,57,1884,553,26,-1,,1910,610
5,1,33,1,1,1,57,1884,553,26,95,  ,1910,610
2,1,34,0,0,0,84,1909,67,28,-1,,1937,151
3,1,34,1,0,0,84,1909,67,28,-1,,1937,151
4,1,34,1,1,0,84,1909,67,12,-1,,1921,151
5,1,34,1,1,1,84,1909,67,12,96,PRODUCT,1921,151
4,1,34,1,2,0,86,1926,62,11,-1,,1937,148
5,1,34,1,2,1,86,1926,62,11,93,PRODUIT,1937,148
2,1,35,0,0,0,224,1909,109,45,-1,,1954,333
3,1,35,1,0,0,224,1909,109,45,-1,,1954,333
4,1,35,1,1,0,224,1909,109,12,-1,,1921,333
5,1,35,1,1,1,224,1909,37,12,93,TANK,1921,261
5,1,35,1,1,2,265,1910,68,11,95,CAPACITY,1921,333
4,1,35,1,2,0,227,1926,96,11,-1,,1937,323
5,1,35,1,2,1,227,1926,96,11,87,CONTENANCE,1937,323
4,1,35,1,3,0,224,1943,105,11,-1,,1954,329
5,1,35,1,3,1,224,1943,19,11,86,DU,1954,243
5,1,35,1,3,2,248,1943,81,11,46,RESERV:OR,1954,329
2,1,36,0,0,0,375,1884,235,23,-1,,1907,610
3,1,36,1,0,0,375,1884,235,23,-1,,1907,610
4,1,36,1,1,0,375,1884,235,23,-1,,1907,610
5,1,36,1,1,1,375,1884,235,23,95, ,1907,610
2,1,37,0,0,0,376,1910,101,45,-1,,1955,477
3,1,37,1,0,0,376,1910,101,45,-1,,1955,477
4,1,37,1,1,0,376,1910,101,11,-1,,1921,477
5,1,37,1,1,1,376,1910,49,11,93,WATER,1921,425
5,1,37,1,1,2,430,1910,47,11,54,DIP/CM,1921,477
4,1,37,1,2,0,392,1927,68,12,-1,,1939,460
5,1,37,1,2,1,392,1927,68,12,96,MEASURE,1939,460
4,1,37,1,3,0,395,1944,62,11,-1,,1955,457
5,1,37,1,3,1,395,1944,62,11,82,DEAU/CM,1955,457
2,1,38,0,0,0,490,1911,91,44,-1,,1955,581
3,1,38,1,0,0,490,1911,91,44,-1,,1955,581
4,1,38,1,1,0,490,1911,91,11,-1,,1922,581
5,1,38,1,1,1,490,1911,55,11,91,BEFORE,1922,545
5,1,38,1,1,2,550,1911,31,11,95,DIPS,1922,581
4,1,38,1,2,0,502,1927,67,12,-1,,1939,569
5,1,38,1,2,1,502,1927,47,12,90,AVANT,1939,549
5,1,38,1,2,2,553,1927,16,12,89,LE,1939,569
4,1,38,1,3,0,500,1944,75,11,-1,,1955,575
5,1,38,1,3,1,500,1944,75,11,80,JAUGEAGE,1955,575
2,1,39,0,0,0,605,1911,102,52,-1,,1963,707
3,1,39,1,0,0,605,1911,102,52,-1,,1963,707
4,1,39,1,1,0,605,1911,81,12,-1,,1923,686
5,1,39,1,1,1,605,1911,45,11,94,AFTER,1922,650
5,1,39,1,1,2,655,1911,31,12,84,DIPS,1923,686
4,1,39,1,2,0,613,1928,68,11,-1,,1939,681
5,1,39,1,2,1,613,1928,46,11,92,APRES,1939,659
5,1,39,1,2,2,664,1928,17,11,96,LE,1939,681
4,1,39,1,3,0,610,1944,97,19,-1,,1963,707
5,1,39,1,3,1,610,1944,75,11,82,JAUGEAGE,1955,685
5,1,39,1,3,2,699,1956,8,7,82,|,1963,707
2,1,40,0,0,0,714,1911,107,45,-1,,1956,821
3,1,40,1,0,0,714,1911,107,45,-1,,1956,821
4,1,40,1,1,0,714,1911,107,12,-1,,1923,821
5,1,40,1,1,1,714,1911,53,12,85,ENDING,1923,767
5,1,40,1,1,2,772,1911,49,12,95,INVENT,1923,821
4,1,40,1,2,0,728,1928,81,11,-1,,1939,809
5,1,40,1,2,1,728,1928,81,11,85,INVENTAIRE,1939,809
4,1,40,1,3,0,744,1945,46,11,-1,,1956,790
5,1,40,1,3,1,744,1945,46,11,15,APRES.,1956,790
2,1,41,0,0,0,866,1912,68,27,-1,,1939,934
3,1,41,1,0,0,866,1912,68,27,-1,,1939,934
4,1,41,1,1,0,866,1912,68,11,-1,,1923,934
5,1,41,1,1,1,866,1912,68,11,96,PRODUCT,1923,934
4,1,41,1,2,0,869,1929,62,10,-1,,1939,931
5,1,41,1,2,1,869,1929,62,10,94,PRODUIT,1939,931
2,1,42,0,0,0,737,1884,556,26,-1,,1910,1293
3,1,42,1,0,0,737,1884,556,26,-1,,1910,1293
4,1,42,1,1,0,737,1884,556,26,-1,,1910,1293
5,1,42,1,1,1,737,1884,556,26,95,  ,1910,1293
2,1,43,0,0,0,1004,1912,111,45,-1,,1957,1115
3,1,43,1,0,0,1004,1912,111,45,-1,,1957,1115
4,1,43,1,1,0,1004,1912,111,11,-1,,1923,1115
5,1,43,1,1,1,1004,1912,37,11,58,âTANK,1923,1041
5,1,43,1,1,2,1046,1912,69,11,91,CAPACITY,1923,1115
4,1,43,1,2,0,1008,1929,96,12,-1,,1941,1104
5,1,43,1,2,1,1008,1929,96,12,91,CONTENANCE,1941,1104
4,1,43,1,3,0,1005,1946,105,11,-1,,1957,1110
5,1,43,1,3,1,1005,1946,18,11,75,OU,1957,1023
5,1,43,1,3,2,1029,1946,81,11,79,RESERVIOR,1957,1110
2,1,44,0,0,0,1388,1913,81,44,-1,,1957,1469
3,1,44,1,0,0,1388,1913,81,44,-1,,1957,1469
4,1,44,1,1,0,1388,1913,81,12,-1,,1925,1469
5,1,44,1,1,1,1388,1913,45,12,94,AFTER,1925,1433
5,1,44,1,1,2,1438,1914,31,11,67,DIPS,1925,1469
4,1,44,1,2,0,1394,1930,67,11,-1,,1941,1461
5,1,44,1,2,1,1394,1930,46,11,92,APRES,1941,1440
5,1,44,1,2,2,1445,1930,16,11,95,LE,1941,1461
4,1,44,1,3,0,1394,1947,75,10,-1,,1957,1469
5,1,44,1,3,1,1394,1947,75,10,86,JAUGEAGE,1957,1469
2,1,45,0,0,0,1158,1913,101,44,-1,,1957,1259
3,1,45,1,0,0,1158,1913,101,44,-1,,1957,1259
4,1,45,1,1,0,1158,1913,101,11,-1,,1924,1259
5,1,45,1,1,1,1158,1913,49,11,92,WATER,1924,1207
5,1,45,1,1,2,1212,1913,47,11,91,DIPICM,1924,1259
4,1,45,1,2,0,1172,1929,67,12,-1,,1941,1239
5,1,45,1,2,1,1172,1929,67,12,83,MEASURE,1941,1239
4,1,45,1,3,0,1174,1946,63,11,-1,,1957,1237
5,1,45,1,3,1,1174,1946,63,11,80,DEAUICM,1957,1237
2,1,46,0,0,0,1278,1913,92,44,-1,,1957,1370
3,1,46,1,0,0,1278,1913,92,44,-1,,1957,1370
4,1,46,1,1,0,1278,1913,92,12,-1,,1925,1370
5,1,46,1,1,1,1278,1913,56,12,96,BEFORE,1925,1334
5,1,46,1,1,2,1338,1913,32,12,88,DIPS,1925,1370
4,1,46,1,2,0,1286,1929,66,12,-1,,1941,1352
5,1,46,1,2,1,1286,1929,45,12,96,AVANT,1941,1331
5,1,46,1,2,2,1336,1930,16,11,96,LE,1941,1352
4,1,46,1,3,0,1283,1946,75,11,-1,,1957,1358
5,1,46,1,3,1,1283,1946,75,11,91,JAUGEAGE,1957,1358
2,1,47,0,0,0,1418,1884,217,26,-1,,1910,1635
3,1,47,1,0,0,1418,1884,217,26,-1,,1910,1635
4,1,47,1,1,0,1418,1884,217,26,-1,,1910,1635
5,1,47,1,1,1,1418,1884,217,26,95,  ,1910,1635
2,1,48,0,0,0,1623,135,15,1767,-1,,1902,1638
3,1,48,1,0,0,1623,135,15,1767,-1,,1902,1638
4,1,48,1,1,0,1623,135,15,1767,-1,,1902,1638
5,1,48,1,1,1,1623,135,15,1767,95, ,1902,1638
2,1,49,0,0,0,1500,1914,107,11,-1,,1925,1607
3,1,49,1,0,0,1500,1914,107,11,-1,,1925,1607
4,1,49,1,1,0,1500,1914,107,11,-1,,1925,1607
5,1,49,1,1,1,1500,1914,53,11,96,ENDING,1925,1553
5,1,49,1,1,2,1557,1914,50,11,96,INVENT,1925,1607
2,1,50,0,0,0,1514,1930,81,28,-1,,1958,1595
3,1,50,1,0,0,1514,1930,81,28,-1,,1958,1595
4,1,50,1,1,0,1514,1930,81,11,-1,,1941,1595
5,1,50,1,1,1,1514,1930,81,11,86,INVENTAIRE,1941,1595
4,1,50,1,2,0,1527,1947,46,11,-1,,1958,1573
5,1,50,1,2,1,1527,1947,46,11,31,APRES:,1958,1573
2,1,51,0,0,0,65,1955,1560,12,-1,,1967,1625
3,1,51,1,0,0,65,1955,1560,12,-1,,1967,1625
4,1,51,1,1,0,65,1955,1560,12,-1,,1967,1625
5,1,51,1,1,1,65,1955,1560,12,95, ,1967,1625
2,1,52,0,0,0,69,2017,1556,10,-1,,2027,1625
3,1,52,1,0,0,69,2017,1556,10,-1,,2027,1625
4,1,52,1,1,0,69,2017,1556,10,-1,,2027,1625
5,1,52,1,1,1,69,2017,1556,10,95, ,2027,1625
2,1,53,0,0,0,79,2078,1544,11,-1,,2089,1623
3,1,53,1,0,0,79,2078,1544,11,-1,,2089,1623
4,1,53,1,1,0,79,2078,1544,11,-1,,2089,1623
5,1,53,1,1,1,79,2078,1544,11,95, ,2089,1623
2,1,54,0,0,0,370,1904,4,237,-1,,2141,374
3,1,54,1,0,0,370,1904,4,237,-1,,2141,374
4,1,54,1,1,0,370,1904,4,237,-1,,2141,374
5,1,54,1,1,1,370,1904,4,237,95, ,2141,374
2,1,55,0,0,0,480,1905,4,237,-1,,2142,484
3,1,55,1,0,0,480,1905,4,237,-1,,2142,484
4,1,55,1,1,0,480,1905,4,237,-1,,2142,484
5,1,55,1,1,1,480,1905,4,237,95, ,2142,484
2,1,56,0,0,0,702,1906,4,237,-1,,2143,706
3,1,56,1,0,0,702,1906,4,237,-1,,2143,706
4,1,56,1,1,0,702,1906,4,237,-1,,2143,706
5,1,56,1,1,1,702,1906,4,237,95, ,2143,706
2,1,57,0,0,0,591,1907,4,236,-1,,2143,595
3,1,57,1,0,0,591,1907,4,236,-1,,2143,595
4,1,57,1,1,0,591,1907,4,236,-1,,2143,595
5,1,57,1,1,1,591,1907,4,236,95, ,2143,595
2,1,58,0,0,0,39,2158,345,17,-1,,2175,384
3,1,58,1,0,0,39,2158,345,17,-1,,2175,384
4,1,58,1,1,0,39,2158,345,17,-1,,2175,384
5,1,58,1,1,1,39,2158,11,13,83,A,2171,50
5,1,58,1,1,2,55,2158,52,13,89,Suncor,2171,107
5,1,58,1,1,3,112,2158,65,13,91,business,2171,177
5,1,58,1,1,4,182,2158,5,13,93,/,2171,187
5,1,58,1,1,5,193,2158,29,13,93,Une,2171,222
5,1,58,1,1,6,228,2158,74,17,89,entreprise,2175,302
5,1,58,1,1,7,308,2158,17,14,96,de,2172,325
5,1,58,1,1,8,331,2158,53,14,96,Suncor,2172,384
2,1,59,0,0,0,1263,1907,4,238,-1,,2145,1267
3,1,59,1,0,0,1263,1907,4,238,-1,,2145,1267
4,1,59,1,1,0,1263,1907,4,238,-1,,2145,1267
5,1,59,1,1,1,1263,1907,4,238,95, ,2145,1267
2,1,60,0,0,0,1375,1908,3,237,-1,,2145,1378
3,1,60,1,0,0,1375,1908,3,237,-1,,2145,1378
4,1,60,1,1,0,1375,1908,3,237,-1,,2145,1378
5,1,60,1,1,1,1375,1908,3,237,95, ,2145,1378
2,1,61,0,0,0,57,1910,1578,245,-1,,2155,1635
3,1,61,1,0,0,57,1910,1578,245,-1,,2155,1635
4,1,61,1,1,0,57,1910,1578,245,-1,,2155,1635
5,1,61,1,1,1,57,1910,1578,245,95, ,2155,1635
2,1,62,0,0,0,1552,2159,110,17,-1,,2176,1662
3,1,62,1,0,0,1552,2159,110,17,-1,,2176,1662
4,1,62,1,1,0,1552,2159,110,17,-1,,2176,1662
5,1,62,1,1,1,1552,2159,53,14,48,112791,2173,1605
5,1,62,1,1,2,1611,2159,51,17,95,(05/17),2176,1662
1,1,0,0,0,0,0,0,1700,2200,-1,,2200,1700
2,1,1,0,0,0,793,17,278,55,-1,,72,1071
3,1,1,1,0,0,793,17,278,55,-1,,72,1071
4,1,1,1,1,0,793,17,278,55,-1,,72,1071
5,1,1,1,1,1,793,17,278,55,33,QYUOFOYS,72,1071
2,1,2,0,0,0,912,77,612,25,-1,,102,1524
3,1,2,1,0,0,912,77,612,25,-1,,102,1524
4,1,2,1,1,0,912,77,612,25,-1,,102,1524
5,1,2,1,1,1,912,77,117,22,96,VEHICLE,99,1029
5,1,2,1,1,2,1040,78,122,22,96,LOADING,100,1162
5,1,2,1,1,3,1172,79,114,21,92,REPORT,100,1286
5,1,2,1,1,4,1294,91,8,3,92,-,94,1302
5,1,2,1,1,5,1312,79,56,22,96,BILL,101,1368
5,1,2,1,1,6,1377,79,36,22,93,OF,101,1413
5,1,2,1,1,7,1424,80,100,22,92,LADING,102,1524
2,1,3,0,0,0,66,125,1567,11,-1,,136,1633
3,1,3,1,0,0,66,125,1567,11,-1,,136,1633
4,1,3,1,1,0,66,125,1567,11,-1,,136,1633
5,1,3,1,1,1,66,125,1567,11,95, ,136,1633
2,1,4,0,0,0,480,131,2,86,-1,,217,482
3,1,4,1,0,0,480,131,2,86,-1,,217,482
4,1,4,1,1,0,480,131,2,86,-1,,217,482
5,1,4,1,1,1,480,131,2,86,95, ,217,482
2,1,5,0,0,0,756,130,4,102,-1,,232,760
3,1,5,1,0,0,756,130,4,102,-1,,232,760
4,1,5,1,1,0,756,130,4,102,-1,,232,760
5,1,5,1,1,1,756,130,4,102,95, ,232,760
2,1,6,0,0,0,79,221,620,6,-1,,227,699
3,1,6,1,0,0,79,221,620,6,-1,,227,699
4,1,6,1,1,0,79,221,620,6,-1,,227,699
5,1,6,1,1,1,79,221,620,6,95, ,227,699
2,1,7,0,0,0,822,226,810,6,-1,,232,1632
3,1,7,1,0,0,822,226,810,6,-1,,232,1632
4,1,7,1,1,0,822,226,810,6,-1,,232,1632
5,1,7,1,1,1,822,226,810,6,95, ,232,1632
2,1,8,0,0,0,67,105,1562,206,-1,,311,1629
3,1,8,1,0,0,67,105,1562,206,-1,,311,1629
4,1,8,1,1,0,150,105,1479,25,-1,,130,1629
5,1,8,1,1,1,150,105,74,23,95,Page:,128,224
5,1,8,1,1,2,249,105,11,18,96,1,123,260
5,1,8,1,1,3,481,106,45,19,96,530,125,526
5,1,8,1,1,4,816,105,132,21,95,RAPPORT,126,948
5,1,8,1,1,5,958,105,35,22,92,DE,127,993
5,1,8,1,1,6,1003,105,196,23,91,CHARGEMENT,128,1199
5,1,8,1,1,7,1208,119,8,3,92,-,122,1216
5,1,8,1,1,8,1224,107,138,21,91,VEHICULE,128,1362
5,1,8,1,1,9,1372,119,8,4,87,-,123,1380
5,1,8,1,1,10,1389,107,240,23,91,CONNAISSEMENT,130,1629
4,1,8,1,2,0,67,131,606,37,-1,,168,673
5,1,8,1,2,1,67,131,1,32,78,|,163,68
5,1,8,1,2,2,139,134,108,34,85,POCUMENT,168,247
5,1,8,1,2,3,260,135,76,33,57,NUMBER,168,336
5,1,8,1,2,4,364,136,62,18,57,1665,154,426
5,1,8,1,2,5,537,132,29,24,0,DBF,156,566
5,1,8,1,2,6,565,132,108,26,10,BEXBEDITION,158,673
4,1,8,1,3,0,151,157,1460,44,-1,,201,1611
5,1,8,1,3,1,151,157,10,10,92,Â°,167,161
5,1,8,1,3,2,523,161,138,40,95,mm/dd/yy,201,661
5,1,8,1,3,3,801,169,28,21,96,24,190,829
5,1,8,1,3,4,840,169,79,22,96,HOUR,191,919
5,1,8,1,3,5,930,170,118,22,44,NUMBER,192,1048
5,1,8,1,3,6,1069,169,206,21,44,(403)296~3000,190,1275
5,1,8,1,3,7,1311,183,8,4,58,~,187,1319
5,1,8,1,3,8,1330,172,120,22,95,NUMERO,194,1450
5,1,8,1,3,9,1460,173,28,21,95,24,194,1488
5,1,8,1,3,10,1499,173,112,21,96,HEURES,194,1611
4,1,8,1,4,0,151,193,1223,31,-1,,224,1374
5,1,8,1,4,1,151,193,109,20,96,0114754,213,260
5,1,8,1,4,2,282,195,93,19,96,10/002,214,375
5,1,8,1,4,3,480,218,1,6,72,|,224,481
5,1,8,1,4,4,530,196,128,20,70,10/08/24,216,658
5,1,8,1,4,5,1051,201,232,23,92,COLLECT,224,1283
5,1,8,1,4,6,1184,197,15,35,88,-,232,1199
5,1,8,1,4,7,1210,201,73,23,93,FRAIS,224,1283
5,1,8,1,4,8,1292,203,82,21,90,VIRES,224,1374
4,1,8,1,5,0,79,219,1536,37,-1,,256,1615
5,1,8,1,5,1,79,219,185,33,91,CONSIGNEE/CUSTOMER,252,264
5,1,8,1,5,2,278,227,8,13,84,-,240,286
5,1,8,1,5,3,295,219,179,33,84,DESTINATAIRE/CLIENT,252,474
5,1,8,1,5,4,689,225,40,27,13,ee,252,729
5,1,8,1,5,5,766,221,57,35,13,ee,256,823
5,1,8,1,5,6,851,241,1,11,85,|,252,852
5,1,8,1,5,7,864,231,223,15,67,CONSIGNOR,246,1087
5,1,8,1,5,8,967,221,10,35,67,-,256,977
5,1,8,1,5,9,985,231,102,15,92,EXPEDITEUR,246,1087
5,1,8,1,5,10,1466,231,52,25,0,RET,256,1518
5,1,8,1,5,11,1550,245,65,11,0,CeeeNT,256,1615
4,1,8,1,6,0,147,254,1426,29,-1,,283,1573
5,1,8,1,6,1,147,254,181,24,96,Mississauga,278,328
5,1,8,1,6,2,346,257,80,19,96,Lubes,276,426
5,1,8,1,6,3,445,258,98,18,96,Center,276,543
5,1,8,1,6,4,680,259,161,19,92,0000081523,278,841
5,1,8,1,6,5,860,258,183,25,90,|Mississauga,283,1043
5,1,8,1,6,6,1061,261,81,19,96,Lubes,280,1142
5,1,8,1,6,7,1161,263,98,17,96,Center,280,1259
5,1,8,1,6,8,1463,263,110,19,96,0081523,282,1573
4,1,8,1,7,0,679,289,482,22,-1,,311,1161
5,1,8,1,7,1,679,289,228,21,43,0000000104|385,310,907
5,1,8,1,7,2,929,291,147,19,96,Southdown,310,1076
5,1,8,1,7,3,1095,292,66,19,96,Road,311,1161
2,1,9,0,0,0,673,225,2,63,-1,,288,675
3,1,9,1,0,0,673,225,2,63,-1,,288,675
4,1,9,1,1,0,673,225,2,63,-1,,288,675
5,1,9,1,1,1,673,225,2,63,95, ,288,675
2,1,10,0,0,0,673,286,181,3,-1,,289,854
3,1,10,1,0,0,673,286,181,3,-1,,289,854
4,1,10,1,1,0,673,286,181,3,-1,,289,854
5,1,10,1,1,1,673,286,181,3,95, ,289,854
2,1,11,0,0,0,147,316,343,25,-1,,341,490
3,1,11,1,0,0,147,316,343,25,-1,,341,490
4,1,11,1,1,0,147,316,343,25,-1,,341,490
5,1,11,1,1,1,147,316,174,25,92,"Missisauga,",341,321
5,1,11,1,1,2,346,320,31,18,92,ON,338,377
5,1,11,1,1,3,395,320,95,18,25,L5J2Y2,338,490
2,1,12,0,0,0,853,226,1,172,-1,,398,854
3,1,12,1,0,0,853,226,1,172,-1,,398,854
4,1,12,1,1,0,853,226,1,172,-1,,398,854
5,1,12,1,1,1,853,226,1,172,95, ,398,854
2,1,13,0,0,0,277,398,576,5,-1,,403,853
3,1,13,1,0,0,277,398,576,5,-1,,403,853
4,1,13,1,1,0,277,398,576,5,-1,,403,853
5,1,13,1,1,1,277,398,576,5,95, ,403,853
2,1,14,0,0,0,279,402,179,14,-1,,416,458
3,1,14,1,0,0,279,402,179,14,-1,,416,458
4,1,14,1,1,0,279,402,179,14,-1,,416,458
5,1,14,1,1,1,279,402,62,12,93,RELEASE,414,341
5,1,14,1,1,2,346,403,48,13,82,(C-of-A),416,394
5,1,14,1,1,3,399,403,59,11,93,NUMBER,414,458
2,1,15,0,0,0,65,174,379,234,-1,,408,444
3,1,15,1,0,0,65,174,379,234,-1,,408,444
4,1,15,1,1,0,67,174,1,10,-1,,184,68
5,1,15,1,1,1,67,174,1,10,69,|,184,68
4,1,15,1,2,0,66,206,1,10,-1,,216,67
5,1,15,1,2,1,66,206,1,10,34,it,216,67
4,1,15,1,3,0,65,285,379,123,-1,,408,444
5,1,15,1,3,1,65,290,2,118,94,|,408,67
5,1,15,1,3,2,149,285,45,19,96,385,304,194
5,1,15,1,3,3,215,286,145,20,96,Southdown,306,360
5,1,15,1,3,4,378,287,66,19,96,Road,306,444
2,1,16,0,0,0,272,398,2,69,-1,,467,274
3,1,16,1,0,0,272,398,2,69,-1,,467,274
4,1,16,1,1,0,272,398,2,69,-1,,467,274
5,1,16,1,1,1,272,398,2,69,95, ,467,274
2,1,17,0,0,0,561,401,2,69,-1,,470,563
3,1,17,1,0,0,561,401,2,69,-1,,470,563
4,1,17,1,1,0,561,401,2,69,-1,,470,563
5,1,17,1,1,1,561,401,2,69,95, ,470,563
2,1,18,0,0,0,569,404,285,26,-1,,430,854
3,1,18,1,0,0,569,404,285,26,-1,,430,854
4,1,18,1,1,0,569,404,285,14,-1,,418,854
5,1,18,1,1,1,569,404,78,11,88,CUSTOMER,415,647
5,1,18,1,1,2,652,404,77,12,96,PURCHASE,416,729
5,1,18,1,1,3,733,405,50,11,96,ORDER,416,783
5,1,18,1,1,4,787,405,60,11,96,NUMBER,416,847
5,1,18,1,1,5,853,409,1,9,96,|,418,854
4,1,18,1,2,0,619,418,190,12,-1,,430,809
5,1,18,1,2,1,619,418,16,11,96,No,429,635
5,1,18,1,2,2,641,418,17,11,96,DE,429,658
5,1,18,1,2,3,663,418,69,12,94,DEMANDE,430,732
5,1,18,1,2,4,737,419,18,11,94,DU,430,755
5,1,18,1,2,5,760,418,49,12,91,CLIENT,430,809
2,1,19,0,0,0,1451,229,1,63,-1,,292,1452
3,1,19,1,0,0,1451,229,1,63,-1,,292,1452
4,1,19,1,1,0,1451,229,1,63,-1,,292,1452
5,1,19,1,1,1,1451,229,1,63,95, ,292,1452
2,1,20,0,0,0,1450,290,182,3,-1,,293,1632
3,1,20,1,0,0,1450,290,182,3,-1,,293,1632
4,1,20,1,1,0,1450,290,182,3,-1,,293,1632
5,1,20,1,1,1,1450,290,182,3,95, ,293,1632
2,1,21,0,0,0,860,320,346,25,-1,,345,1206
3,1,21,1,0,0,860,320,346,25,-1,,345,1206
4,1,21,1,1,0,860,320,346,25,-1,,345,1206
5,1,21,1,1,1,860,320,177,25,90,"Missisauga,",345,1037
5,1,21,1,1,2,1061,324,33,18,93,ON,342,1094
5,1,21,1,1,3,1111,323,95,19,32,L5J2Y2,342,1206
2,1,22,0,0,0,69,465,1531,9,-1,,474,1600
3,1,22,1,0,0,69,465,1531,9,-1,,474,1600
4,1,22,1,1,0,69,465,1531,9,-1,,474,1600
5,1,22,1,1,1,69,465,1531,9,95, ,474,1600
2,1,23,0,0,0,65,475,237,21,-1,,496,302
3,1,23,1,0,0,65,475,237,21,-1,,496,302
4,1,23,1,1,0,65,475,237,21,-1,,496,302
5,1,23,1,1,1,65,493,1,3,95,|,496,66
5,1,23,1,1,2,78,475,74,13,92,CARRIER,488,152
5,1,23,1,1,3,157,482,5,3,92,-,485,162
5,1,23,1,1,4,167,476,135,14,92,TRANSPORTEUR,490,302
2,1,24,0,0,0,479,583,236,3,-1,,586,715
3,1,24,1,0,0,479,583,236,3,-1,,586,715
4,1,24,1,1,0,479,583,236,3,-1,,586,715
5,1,24,1,1,1,479,583,236,3,95, ,586,715
2,1,25,0,0,0,478,584,3,79,-1,,663,481
3,1,25,1,0,0,478,584,3,79,-1,,663,481
4,1,25,1,1,0,478,584,3,79,-1,,663,481
5,1,25,1,1,1,478,584,3,79,95, ,663,481
2,1,26,0,0,0,713,469,4,196,-1,,665,717
3,1,26,1,0,0,713,469,4,196,-1,,665,717
4,1,26,1,1,0,713,469,4,196,-1,,665,717
5,1,26,1,1,1,713,469,4,196,95, ,665,717
2,1,27,0,0,0,734,476,149,14,-1,,490,883
3,1,27,1,0,0,734,476,149,14,-1,,490,883
4,1,27,1,1,0,734,476,149,14,-1,,490,883
5,1,27,1,1,1,734,476,71,14,80,VERICLE,490,805
5,1,27,1,1,2,812,476,71,14,96,NUMBER,490,883
2,1,28,0,0,0,924,477,492,15,-1,,492,1416
3,1,28,1,0,0,924,477,492,15,-1,,492,1416
4,1,28,1,1,0,924,477,492,15,-1,,492,1416
5,1,28,1,1,1,924,477,71,14,96,LICENSE,491,995
5,1,28,1,1,2,1000,478,71,13,95,NUMBER,491,1071
5,1,28,1,1,3,1133,478,78,14,96,ADDRESS,492,1211
5,1,28,1,1,4,1218,478,21,14,96,OF,492,1239
5,1,28,1,1,5,1246,479,57,13,96,METER,492,1303
5,1,28,1,1,6,1308,479,34,13,96,AND,492,1342
5,1,28,1,1,7,1348,479,68,13,96,TRADER,492,1416
2,1,29,0,0,0,1101,471,4,196,-1,,667,1105
3,1,29,1,0,0,1101,471,4,196,-1,,667,1105
4,1,29,1,1,0,1101,471,4,196,-1,,667,1105
5,1,29,1,1,1,1101,471,4,196,95, ,667,1105
2,1,30,0,0,0,64,659,1560,10,-1,,669,1624
3,1,30,1,0,0,64,659,1560,10,-1,,669,1624
4,1,30,1,1,0,64,659,1560,10,-1,,669,1624
5,1,30,1,1,1,64,659,1560,10,95, ,669,1624
2,1,31,0,0,0,75,729,1556,10,-1,,739,1631
3,1,31,1,0,0,75,729,1556,10,-1,,739,1631
4,1,31,1,1,0,75,729,1556,10,-1,,739,1631
5,1,31,1,1,1,75,729,1556,10,95, ,739,1631
2,1,32,0,0,0,255,664,4,1069,-1,,1733,259
3,1,32,1,0,0,255,664,4,1069,-1,,1733,259
4,1,32,1,1,0,255,664,4,1069,-1,,1733,259
5,1,32,1,1,1,255,664,4,1069,95, ,1733,259
2,1,33,0,0,0,933,664,4,1068,-1,,1732,937
3,1,33,1,0,0,933,664,4,1068,-1,,1732,937
4,1,33,1,1,0,933,664,4,1068,-1,,1732,937
5,1,33,1,1,1,933,664,4,1068,95, ,1732,937
2,1,34,0,0,0,1127,664,5,1071,-1,,1735,1132
3,1,34,1,0,0,1127,664,5,1071,-1,,1735,1132
4,1,34,1,1,0,1127,664,5,1071,-1,,1735,1132
5,1,34,1,1,1,1127,664,5,1071,95, ,1735,1132
2,1,35,0,0,0,1433,667,5,1071,-1,,1738,1438
3,1,35,1,0,0,1433,667,5,1071,-1,,1738,1438
4,1,35,1,1,0,1433,667,5,1071,-1,,1738,1438
5,1,35,1,1,1,1433,667,5,1071,95, ,1738,1438
2,1,36,0,0,0,1516,667,4,1072,-1,,1739,1520
3,1,36,1,0,0,1516,667,4,1072,-1,,1739,1520
4,1,36,1,1,0,1516,667,4,1072,-1,,1739,1520
5,1,36,1,1,1,1516,667,4,1072,95, ,1739,1520
2,1,37,0,0,0,1280,670,5,1067,-1,,1737,1285
3,1,37,1,0,0,1280,670,5,1067,-1,,1737,1285
4,1,37,1,1,0,1280,670,5,1067,-1,,1737,1285
5,1,37,1,1,1,1280,670,5,1067,95, ,1737,1285
2,1,38,0,0,0,61,1730,1567,9,-1,,1739,1628
3,1,38,1,0,0,61,1730,1567,9,-1,,1739,1628
4,1,38,1,1,0,61,1730,1567,9,-1,,1739,1628
5,1,38,1,1,1,61,1730,1567,9,95, ,1739,1628
2,1,39,0,0,0,62,498,1566,1326,-1,,1824,1628
3,1,39,1,0,0,149,498,1331,22,-1,,520,1480
4,1,39,1,1,0,149,498,1331,22,-1,,520,1480
5,1,39,1,1,1,149,500,112,17,96,PREMIER,517,261
5,1,39,1,1,2,279,501,64,17,96,BULK,518,343
5,1,39,1,1,3,362,501,113,18,95,SYSTEMS,519,475
5,1,39,1,1,4,579,502,111,18,95,5000234,520,690
5,1,39,1,1,5,707,488,15,36,93,|,524,722
5,1,39,1,1,6,738,498,137,14,69,NeDUVEHICLLE,512,875
5,1,39,1,1,7,902,488,12,36,41,=,524,914
5,1,39,1,1,8,924,500,72,12,71,NOMBRE,512,996
5,1,39,1,1,9,1002,500,22,13,71,DE,513,1024
5,1,39,1,1,10,1031,500,62,13,91,PERMIS,513,1093
5,1,39,1,1,11,1100,488,6,36,93,|,524,1106
5,1,39,1,1,12,1119,500,90,14,58,L'ADRESSE,514,1209
5,1,39,1,1,13,1216,500,21,14,96,DE,514,1237
5,1,39,1,1,14,1244,501,56,13,94,METRE,514,1300
5,1,39,1,1,15,1307,501,20,13,94,ET,514,1327
5,1,39,1,1,16,1333,502,21,12,93,DE,514,1354
5,1,39,1,1,17,1360,501,120,13,93,COMMERCANT,514,1480
3,1,39,2,0,0,149,528,1325,29,-1,,557,1474
4,1,39,2,1,0,149,528,1325,29,-1,,557,1474
5,1,39,2,1,1,149,528,27,19,94,25,547,176
5,1,39,2,1,2,197,529,114,23,96,Gormley,552,311
5,1,39,2,1,3,330,530,160,19,95,Industrial,549,490
5,1,39,2,1,4,510,532,32,17,96,Dr,549,542
5,1,39,2,1,5,728,532,95,19,94,919322,551,823
5,1,39,2,1,6,1112,535,96,18,95,Suncor,553,1208
5,1,39,2,1,7,1227,536,99,21,95,Energy,557,1326
5,1,39,2,1,8,1345,535,129,19,96,Products,554,1474
3,1,39,3,0,0,147,555,1277,33,-1,,588,1424
4,1,39,3,1,0,147,555,1277,33,-1,,588,1424
5,1,39,3,1,1,147,555,114,33,96,GORMLEY,588,261
5,1,39,3,1,2,728,563,78,19,95,51202,582,806
5,1,39,3,1,3,1112,564,61,19,96,3275,583,1173
5,1,39,3,1,4,1193,564,116,20,96,Rebecca,584,1309
5,1,39,3,1,5,1328,566,96,18,96,Street,584,1424
3,1,39,4,0,0,147,590,524,26,-1,,616,671
4,1,39,4,1,0,147,590,524,26,-1,,616,671
5,1,39,4,1,1,147,590,95,19,61,LOHLGO,609,242
5,1,39,4,1,2,488,590,64,26,21,LER,616,552
5,1,39,4,1,3,585,590,86,26,47,ERE,616,671
3,1,39,5,0,0,153,620,204,22,-1,,642,357
4,1,39,5,1,0,153,620,204,22,-1,,642,357
5,1,39,5,1,1,153,620,204,22,87,(226)338-5962,642,357
3,1,39,6,0,0,988,667,640,24,-1,,691,1628
4,1,39,6,1,0,988,667,640,24,-1,,691,1628
5,1,39,6,1,1,988,675,67,13,95,FACTOR,688,1055
5,1,39,6,1,2,1163,676,92,14,96,MEASURED,690,1255
5,1,39,6,1,3,1308,676,32,14,91,NET,690,1340
5,1,39,6,1,4,1346,676,56,14,91,LITRES,690,1402
5,1,39,6,1,5,1535,678,71,13,60,DENSITY,691,1606
5,1,39,6,1,6,1626,667,2,2,60,|,669,1628
3,1,39,7,0,0,79,681,1527,52,-1,,733,1606
4,1,39,7,1,0,79,681,1527,31,-1,,712,1606
5,1,39,7,1,1,79,681,142,13,52,PRODUCTIMETER,694,221
5,1,39,7,1,2,370,697,80,13,96,PRODUCT,710,450
5,1,39,7,1,3,456,697,112,14,93,DESCRIPTION,711,568
5,1,39,7,1,4,573,705,5,3,92,-,708,578
5,1,39,7,1,5,585,698,111,14,93,DESCRIPTION,712,696
5,1,39,7,1,6,703,698,22,14,96,DU,712,725
5,1,39,7,1,7,732,699,73,13,96,PRODUIT,712,805
5,1,39,7,1,8,988,695,78,13,89,FACTEUR,708,1066
5,1,39,7,1,9,1176,695,57,14,96,LITRES,709,1233
5,1,39,7,1,10,1307,696,105,14,35,correcteo,710,1412
5,1,39,7,1,11,1440,688,62,14,20,[TEMPS,702,1502
5,1,39,7,1,12,1511,684,11,41,92,|,725,1522
5,1,39,7,1,13,1535,697,71,13,25,Densite,710,1606
4,1,39,7,2,0,79,708,1512,25,-1,,733,1591
5,1,39,7,2,1,79,708,134,14,58,PRODUITMETER,722,213
5,1,39,7,2,2,262,730,3,2,44,|,732,265
5,1,39,7,2,3,455,731,4,2,44,:,733,459
5,1,39,7,2,4,987,714,26,13,39,API,727,1013
5,1,39,7,2,5,1019,714,52,13,39,TABLE,727,1071
5,1,39,7,2,6,1163,715,92,13,93,MESUREES,728,1255
5,1,39,7,2,7,1331,715,63,14,38,TO1BC,729,1394
5,1,39,7,2,8,1440,716,70,14,41,â_|CELSIUS,730,1510
5,1,39,7,2,9,1516,711,10,19,43,Â©,730,1526
5,1,39,7,2,10,1535,716,56,17,53,kg/cum,733,1591
3,1,39,8,0,0,148,740,1424,30,-1,,770,1572
4,1,39,8,1,0,148,740,1424,30,-1,,770,1572
5,1,39,8,1,1,148,744,93,19,96,103265,763,241
5,1,39,8,1,2,256,740,15,33,95,|,773,271
5,1,39,8,1,3,277,746,49,18,95,NOT,764,326
5,1,39,8,1,4,344,746,148,18,96,REGULATED,764,492
5,1,39,8,1,5,509,747,82,18,96,UNDER,765,591
5,1,39,8,1,6,610,748,48,18,96,TDG,766,658
5,1,39,8,1,7,978,748,95,19,94,0.9611,767,1073
5,1,39,8,1,8,1161,749,78,19,83,23500,768,1239
5,1,39,8,1,9,1283,740,1,16,48,|,756,1284
5,1,39,8,1,10,1310,750,80,19,95,22586,769,1390
5,1,39,8,1,11,1445,750,61,19,63,65.8,769,1506
5,1,39,8,1,12,1528,751,44,19,41,/913,770,1572
3,1,39,9,0,0,145,775,930,22,-1,,797,1075
4,1,39,9,1,0,145,775,930,22,-1,,797,1075
5,1,39,9,1,1,145,775,96,18,90,MTR221,793,241
5,1,39,9,1,2,254,771,14,31,90,|,802,268
5,1,39,9,1,3,277,777,65,16,92,HVGO,793,342
5,1,39,9,1,4,958,780,49,17,92,API,797,1007
5,1,39,9,1,5,1028,780,47,17,85,54B,797,1075
3,1,39,10,0,0,147,835,1424,25,-1,,860,1571
4,1,39,10,1,0,147,835,1424,25,-1,,860,1571
5,1,39,10,1,1,147,835,94,19,93,103265,854,241
5,1,39,10,1,2,255,831,15,33,93,|,864,270
5,1,39,10,1,3,276,837,49,18,95,NOT,855,325
5,1,39,10,1,4,344,837,147,18,96,REGULATED,855,491
5,1,39,10,1,5,509,838,82,18,96,UNDER,856,591
5,1,39,10,1,6,609,839,49,18,96,TDG,857,658
5,1,39,10,1,7,978,839,95,19,95,0.9609,858,1073
5,1,39,10,1,8,1161,840,78,19,95,24499,859,1239
5,1,39,10,1,9,1310,841,80,18,94,23541,859,1390
5,1,39,10,1,10,1444,841,127,19,57,66.1/913,860,1571
3,1,39,11,0,0,145,866,929,23,-1,,889,1074
4,1,39,11,1,0,145,866,929,23,-1,,889,1074
5,1,39,11,1,1,145,866,95,19,92,MTR222,885,240
5,1,39,11,1,2,255,862,14,32,93,|,894,269
5,1,39,11,1,3,277,868,65,17,92,HVGO,885,342
5,1,39,11,1,4,958,871,48,17,87,API,888,1006
5,1,39,11,1,5,1027,870,47,19,87,54B,889,1074
3,1,39,12,0,0,62,880,1507,940,-1,,1820,1569
4,1,39,12,1,0,326,880,199,125,-1,,1005,525
5,1,39,12,1,1,326,880,101,125,45,23/),1005,427
5,1,39,12,1,2,423,891,102,110,49,oft),1001,525
4,1,39,12,2,0,465,1103,321,35,-1,,1138,786
5,1,39,12,2,1,465,1103,11,35,55,ty,1138,476
5,1,39,12,2,2,779,1118,7,12,44,â,1130,786
4,1,39,12,3,0,464,1117,447,41,-1,,1158,911
5,1,39,12,3,1,464,1135,5,5,64,:,1140,469
5,1,39,12,3,2,610,1119,81,39,71,(N-,1158,691
5,1,39,12,3,3,706,1119,129,39,0,OF:60,1158,835
5,1,39,12,3,4,846,1117,65,37,58,AM,1154,911
4,1,39,12,4,0,362,1197,138,11,-1,,1208,500
5,1,39,12,4,1,362,1201,21,7,45,-,1208,383
5,1,39,12,4,2,493,1197,7,10,38,.,1207,500
4,1,39,12,5,0,282,1170,389,66,-1,,1236,671
5,1,39,12,5,1,282,1170,84,46,20,UT,1216,366
5,1,39,12,5,2,395,1190,28,26,20,0,1216,423
5,1,39,12,5,3,439,1178,57,54,3,2:,1232,496
5,1,39,12,5,4,510,1201,59,30,0,oe,1231,569
5,1,39,12,5,5,584,1201,87,35,36,qm,1236,671
4,1,39,12,6,0,310,1418,379,24,-1,,1442,689
5,1,39,12,6,1,310,1418,79,19,95,Total,1437,389
5,1,39,12,6,2,408,1418,97,20,95,Litres,1438,505
5,1,39,12,6,3,524,1419,34,23,95,by,1442,558
5,1,39,12,6,4,576,1420,113,18,96,Product,1438,689
4,1,39,12,7,0,279,1446,1108,32,-1,,1478,1387
5,1,39,12,7,1,279,1448,93,20,96,103265,1468,372
5,1,39,12,7,2,470,1446,70,32,92,HVGO,1478,540
5,1,39,12,7,3,1159,1452,79,19,95,47999,1471,1238
5,1,39,12,7,4,1310,1452,77,20,96,46127,1472,1387
4,1,39,12,8,0,76,1735,1493,39,-1,,1774,1569
5,1,39,12,8,1,76,1738,61,14,87,ORIVER,1752,137
5,1,39,12,8,2,142,1739,95,14,92,SIGNATURE,1753,237
5,1,39,12,8,3,243,1747,4,2,91,-,1749,247
5,1,39,12,8,4,254,1739,95,15,96,SIGNATURE,1754,349
5,1,39,12,8,5,354,1740,23,14,89,DU,1754,377
5,1,39,12,8,6,383,1740,116,14,89,CONDUCTEUR,1754,499
5,1,39,12,8,7,862,1735,60,39,16,ARRIVE,1774,922
5,1,39,12,8,8,1026,1740,73,24,22,DESUT,1764,1099
5,1,39,12,8,9,1077,1736,20,39,53,OU,1775,1097
5,1,39,12,8,10,1101,1740,99,24,71,GHARGENENT,1764,1200
5,1,39,12,8,11,1207,1736,20,39,58,|,1775,1227
5,1,39,12,8,12,1243,1740,149,25,28,FIN'DUGHASGEMENT,1765,1392
5,1,39,12,8,13,1503,1741,66,24,42,âDEPART,1765,1569
4,1,39,12,9,0,62,1771,1491,53,-1,,1824,1553
5,1,39,12,9,1,62,1771,54,53,50,D4,1824,116
5,1,39,12,9,2,858,1787,78,20,96,05:09,1807,936
5,1,39,12,9,3,1058,1789,79,19,93,05:11,1808,1137
5,1,39,12,9,4,1276,1789,78,19,93,05:26,1808,1354
5,1,39,12,9,5,1475,1790,78,19,96,05:26,1809,1553
2,1,40,0,0,0,794,1733,2,87,-1,,1820,796
3,1,40,1,0,0,794,1733,2,87,-1,,1820,796
4,1,40,1,1,0,794,1733,2,87,-1,,1820,796
5,1,40,1,1,1,794,1733,2,87,95, ,1820,796
2,1,41,0,0,0,1002,1735,1,86,-1,,1821,1003
3,1,41,1,0,0,1002,1735,1,86,-1,,1821,1003
4,1,41,1,1,0,1002,1735,1,86,-1,,1821,1003
5,1,41,1,1,1,1002,1735,1,86,95, ,1821,1003
2,1,42,0,0,0,1210,1735,2,87,-1,,1822,1212
3,1,42,1,0,0,1210,1735,2,87,-1,,1822,1212
4,1,42,1,1,0,1210,1735,2,87,-1,,1822,1212
5,1,42,1,1,1,1210,1735,2,87,95, ,1822,1212
2,1,43,0,0,0,138,1815,1490,8,-1,,1823,1628
3,1,43,1,0,0,138,1815,1490,8,-1,,1823,1628
4,1,43,1,1,0,138,1815,1490,8,-1,,1823,1628
5,1,43,1,1,1,138,1815,1490,8,95, ,1823,1628
2,1,44,0,0,0,75,1815,318,19,-1,,1834,393
3,1,44,1,0,0,75,1815,318,19,-1,,1834,393
4,1,44,1,1,0,75,1815,318,19,-1,,1834,393
5,1,44,1,1,1,75,1815,61,18,54,DRIVER,1833,136
5,1,44,1,1,2,142,1819,47,15,91,NAME,1834,189
5,1,44,1,1,3,194,1827,5,3,91,-,1830,199
5,1,44,1,1,4,205,1820,36,14,95,NOM,1834,241
5,1,44,1,1,5,248,1821,21,13,93,DU,1834,269
5,1,44,1,1,6,276,1821,117,13,90,CONDUCTEUR,1834,393
2,1,45,0,0,0,56,1815,6,27,-1,,1842,62
3,1,45,1,0,0,56,1815,6,27,-1,,1842,62
4,1,45,1,1,0,56,1815,6,27,-1,,1842,62
5,1,45,1,1,1,56,1815,6,27,95, ,1842,62
2,1,46,0,0,0,61,622,6,1274,-1,,1896,67
3,1,46,1,0,0,61,622,6,1274,-1,,1896,67
4,1,46,1,1,0,61,622,6,1274,-1,,1896,67
5,1,46,1,1,1,61,622,6,1274,95, ,1896,67
2,1,47,0,0,0,83,1878,290,75,-1,,1953,373
3,1,47,1,0,0,83,1878,290,75,-1,,1953,373
4,1,47,1,1,0,144,1878,229,19,-1,,1897,373
5,1,47,1,1,1,144,1878,115,18,64,SANJEEV_,1896,259
5,1,47,1,1,2,292,1880,81,17,92,KUMAR,1897,373
4,1,47,1,2,0,83,1909,249,11,-1,,1920,332
5,1,47,1,2,1,83,1909,67,11,85,PRODUCT,1920,150
5,1,47,1,2,2,222,1909,37,11,70,âTANK,1920,259
5,1,47,1,2,3,264,1909,68,11,42,CAPACITY,1920,332
4,1,47,1,3,0,86,1925,235,12,-1,,1937,321
5,1,47,1,3,1,86,1925,61,11,14,PRODUIT,1936,147
5,1,47,1,3,2,226,1926,95,11,28,CONTENANCE,1937,321
4,1,47,1,4,0,224,1942,103,11,-1,,1953,327
5,1,47,1,4,1,224,1942,18,11,91,DU,1953,242
5,1,47,1,4,2,247,1942,80,11,90,RESERVIOR,1953,327
2,1,48,0,0,0,609,1879,62,19,-1,,1898,671
3,1,48,1,0,0,609,1879,62,19,-1,,1898,671
4,1,48,1,1,0,609,1879,62,19,-1,,1898,671
5,1,48,1,1,1,609,1879,62,19,96,5601,1898,671
2,1,49,0,0,0,374,1910,206,44,-1,,1954,580
3,1,49,1,0,0,374,1910,206,44,-1,,1954,580
4,1,49,1,1,0,374,1910,206,12,-1,,1922,580
5,1,49,1,1,1,374,1910,50,11,86,WATER,1921,424
5,1,49,1,1,2,428,1910,47,12,77,DIP/CM,1922,475
5,1,49,1,1,3,479,1903,6,28,96,|,1931,485
5,1,49,1,1,4,488,1911,56,11,91,BEFORE,1922,544
5,1,49,1,1,5,548,1911,32,11,79,D:PS,1922,580
4,1,49,1,2,0,392,1927,175,10,-1,,1937,567
5,1,49,1,2,1,392,1927,67,10,54,MEASURE,1937,459
5,1,49,1,2,2,502,1927,45,10,90,AVANT,1937,547
5,1,49,1,2,3,552,1927,15,10,96,LE,1937,567
4,1,49,1,3,0,394,1942,179,12,-1,,1954,573
5,1,49,1,3,1,394,1942,63,11,78,DEAUICM,1953,457
5,1,49,1,3,2,498,1943,75,11,62,JAUGEAGE,1954,573
2,1,50,0,0,0,604,1911,81,50,-1,,1961,685
3,1,50,1,0,0,604,1911,81,50,-1,,1961,685
4,1,50,1,1,0,604,1911,81,11,-1,,1922,685
5,1,50,1,1,1,604,1911,45,11,89,AFTER,1922,649
5,1,50,1,1,2,654,1911,31,11,26,O1PS,1922,685
4,1,50,1,2,0,613,1928,67,10,-1,,1938,680
5,1,50,1,2,1,613,1928,46,9,76,APRES,1937,659
5,1,50,1,2,2,664,1928,16,10,76,LE,1938,680
4,1,50,1,3,0,609,1943,76,18,-1,,1961,685
5,1,50,1,3,1,609,1943,76,18,88,JAUGEAGE,1961,685
2,1,51,0,0,0,761,1839,462,29,-1,,1868,1223
3,1,51,1,0,0,761,1839,462,29,-1,,1868,1223
4,1,51,1,1,0,761,1839,462,29,-1,,1868,1223
5,1,51,1,1,1,761,1839,8,10,92,*,1849,769
5,1,51,1,1,2,779,1839,91,23,96,Volume,1862,870
5,1,51,1,1,3,880,1841,113,21,96,corrected,1862,993
5,1,51,1,1,4,1003,1842,21,20,96,to,1862,1024
5,1,51,1,1,5,1036,1841,27,22,96,15,1863,1063
5,1,51,1,1,6,1074,1841,102,27,93,Degrees,1868,1176
5,1,51,1,1,7,1186,1841,18,22,88,C,1863,1204
5,1,51,1,1,8,1214,1841,9,10,88,*,1851,1223
2,1,52,0,0,0,675,1880,146,75,-1,,1955,821
3,1,52,1,0,0,675,1880,146,75,-1,,1955,821
4,1,52,1,1,0,675,1880,61,18,-1,,1898,736
5,1,52,1,1,1,675,1880,61,18,95,7257,1898,736
4,1,52,1,2,0,713,1911,108,11,-1,,1922,821
5,1,52,1,2,1,713,1911,53,11,96,ENDING,1922,766
5,1,52,1,2,2,771,1911,50,11,96,INVENT,1922,821
4,1,52,1,3,0,727,1928,82,11,-1,,1939,809
5,1,52,1,3,1,727,1928,82,11,84,INVENTAIRE,1939,809
4,1,52,1,4,0,743,1944,46,11,-1,,1955,789
5,1,52,1,4,1,743,1944,46,11,88,APRES,1955,789
2,1,53,0,0,0,111,1815,1522,27,-1,,1842,1633
3,1,53,1,0,0,111,1815,1522,27,-1,,1842,1633
4,1,53,1,1,0,111,1815,1522,27,-1,,1842,1633
5,1,53,1,1,1,111,1815,1522,27,95, ,1842,1633
2,1,54,0,0,0,1281,1825,289,14,-1,,1839,1570
3,1,54,1,0,0,1281,1825,289,14,-1,,1839,1570
4,1,54,1,1,0,1281,1825,289,14,-1,,1839,1570
5,1,54,1,1,1,1281,1825,53,13,96,TOTAL,1838,1334
5,1,54,1,1,2,1340,1825,84,13,92,QUANTITY,1838,1424
5,1,54,1,1,3,1429,1831,5,3,91,-,1834,1434
5,1,54,1,1,4,1439,1825,61,14,93,QUANT.,1839,1500
5,1,54,1,1,5,1506,1825,64,14,20,TOTALE:,1839,1570
2,1,55,0,0,0,1291,1850,195,50,-1,,1900,1486
3,1,55,1,0,0,1291,1850,195,50,-1,,1900,1486
4,1,55,1,1,0,1292,1850,194,20,-1,,1870,1486
5,1,55,1,1,1,1292,1851,78,19,96,47999,1870,1370
5,1,55,1,1,2,1390,1850,96,20,96,Litres,1870,1486
4,1,55,1,2,0,1291,1882,126,18,-1,,1900,1417
5,1,55,1,2,1,1291,1882,79,18,92,42114,1900,1370
5,1,55,1,2,2,1390,1882,27,18,94,kg,1900,1417
2,1,56,0,0,0,1276,1913,192,44,-1,,1957,1468
3,1,56,1,0,0,1276,1913,192,44,-1,,1957,1468
4,1,56,1,1,0,1276,1913,192,12,-1,,1925,1468
5,1,56,1,1,1,1276,1913,56,11,93,BEFORE,1924,1332
5,1,56,1,1,2,1337,1913,31,11,87,DIPS|,1924,1368
5,1,56,1,1,3,1387,1914,45,11,87,AFTER,1925,1432
5,1,56,1,1,4,1437,1914,31,11,87,DIPS,1925,1468
4,1,56,1,2,0,1284,1930,175,11,-1,,1941,1459
5,1,56,1,2,1,1284,1930,46,10,90,AVANT,1940,1330
5,1,56,1,2,2,1335,1930,15,10,93,LE,1940,1350
5,1,56,1,2,3,1392,1930,46,11,90,APRES,1941,1438
5,1,56,1,2,4,1444,1930,15,11,92,LE,1941,1459
4,1,56,1,3,0,1281,1945,186,12,-1,,1957,1467
5,1,56,1,3,1,1281,1945,75,12,82,JAUGEAGE,1957,1356
5,1,56,1,3,2,1368,1938,12,28,86,|,1966,1380
5,1,56,1,3,3,1392,1946,75,11,83,JAUGEAGE,1957,1467
2,1,57,0,0,0,864,1912,68,27,-1,,1939,932
3,1,57,1,0,0,864,1912,68,27,-1,,1939,932
4,1,57,1,1,0,864,1912,68,11,-1,,1923,932
5,1,57,1,1,1,864,1912,68,11,96,PRODUCT,1923,932
4,1,57,1,2,0,868,1929,60,10,-1,,1939,928
5,1,57,1,2,1,868,1929,60,10,96,PRODUIT,1939,928
2,1,58,0,0,0,1002,1912,111,44,-1,,1956,1113
3,1,58,1,0,0,1002,1912,111,44,-1,,1956,1113
4,1,58,1,1,0,1002,1912,111,12,-1,,1924,1113
5,1,58,1,1,1,1002,1912,37,12,88,TANK,1924,1039
5,1,58,1,1,2,1044,1912,69,12,94,CAPACITY,1924,1113
4,1,58,1,2,0,1006,1929,96,10,-1,,1939,1102
5,1,58,1,2,1,1006,1929,96,10,89,CONTENANCE,1939,1102
4,1,58,1,3,0,1004,1945,104,11,-1,,1956,1108
5,1,58,1,3,1,1004,1945,18,10,92,DU,1955,1022
5,1,58,1,3,2,1028,1945,80,11,92,RESERVIOR,1956,1108
2,1,59,0,0,0,1156,1913,102,44,-1,,1957,1258
3,1,59,1,0,0,1156,1913,102,44,-1,,1957,1258
4,1,59,1,1,0,1156,1913,102,11,-1,,1924,1258
5,1,59,1,1,1,1156,1913,50,11,86,WATER,1924,1206
5,1,59,1,1,2,1211,1913,47,11,29,DIP/CM.,1924,1258
4,1,59,1,2,0,1171,1930,67,10,-1,,1940,1238
5,1,59,1,2,1,1171,1930,67,10,66,"MEASURE,",1940,1238
4,1,59,1,3,0,1173,1945,63,12,-1,,1957,1236
5,1,59,1,3,1,1173,1945,63,12,58,DEAWCM,1957,1236
2,1,60,0,0,0,1498,1914,54,27,-1,,1941,1552
3,1,60,1,0,0,1498,1914,54,27,-1,,1941,1552
4,1,60,1,1,0,1498,1914,52,11,-1,,1925,1550
5,1,60,1,1,1,1498,1914,52,11,96,ENDING,1925,1550
4,1,60,1,2,0,1512,1930,40,11,-1,,1941,1552
5,1,60,1,2,1,1512,1930,40,11,92,INVEN,1941,1552
2,1,61,0,0,0,1626,134,8,1768,-1,,1902,1634
3,1,61,1,0,0,1626,134,8,1768,-1,,1902,1634
4,1,61,1,1,0,1626,134,8,1768,-1,,1902,1634
5,1,61,1,1,1,1626,134,8,1768,95, ,1902,1634
2,1,62,0,0,0,1554,1914,52,27,-1,,1941,1606
3,1,62,1,0,0,1554,1914,52,27,-1,,1941,1606
4,1,62,1,1,0,1556,1914,50,12,-1,,1926,1606
5,1,62,1,1,1,1556,1914,50,12,82,INVENT,1926,1606
4,1,62,1,2,0,1554,1931,40,10,-1,,1941,1594
5,1,62,1,2,1,1554,1931,40,10,52,TAIRE,1941,1594
2,1,63,0,0,0,1525,1946,47,11,-1,,1957,1572
3,1,63,1,0,0,1525,1946,47,11,-1,,1957,1572
4,1,63,1,1,0,1525,1946,47,11,-1,,1957,1572
5,1,63,1,1,1,1525,1946,47,11,92,APRES,1957,1572
2,1,64,0,0,0,64,1957,1560,7,-1,,1964,1624
3,1,64,1,0,0,64,1957,1560,7,-1,,1964,1624
4,1,64,1,1,0,64,1957,1560,7,-1,,1964,1624
5,1,64,1,1,1,64,1957,1560,7,95, ,1964,1624
2,1,65,0,0,0,64,2017,1557,8,-1,,2025,1621
3,1,65,1,0,0,64,2017,1557,8,-1,,2025,1621
4,1,65,1,1,0,64,2017,1557,8,-1,,2025,1621
5,1,65,1,1,1,64,2017,1557,8,95, ,2025,1621
2,1,66,0,0,0,64,2079,1560,8,-1,,2087,1624
3,1,66,1,0,0,64,2079,1560,8,-1,,2087,1624
4,1,66,1,1,0,64,2079,1560,8,-1,,2087,1624
5,1,66,1,1,1,64,2079,1560,8,95, ,2087,1624
2,1,67,0,0,0,170,1903,5,237,-1,,2140,175
3,1,67,1,0,0,170,1903,5,237,-1,,2140,175
4,1,67,1,1,0,170,1903,5,237,-1,,2140,175
5,1,67,1,1,1,170,1903,5,237,95, ,2140,175
2,1,68,0,0,0,590,1906,3,236,-1,,2142,593
3,1,68,1,0,0,590,1906,3,236,-1,,2142,593
4,1,68,1,1,0,590,1906,3,236,-1,,2142,593
5,1,68,1,1,1,590,1906,3,236,95, ,2142,593
2,1,69,0,0,0,479,1965,4,174,-1,,2139,483
3,1,69,1,0,0,479,1965,4,174,-1,,2139,483
4,1,69,1,1,0,480,1965,2,54,-1,,2019,482
5,1,69,1,1,1,480,1965,2,54,90,|,2019,482
4,1,69,1,2,0,479,2028,4,57,-1,,2085,483
5,1,69,1,2,1,479,2028,4,57,95,|,2085,483
4,1,69,1,3,0,480,2092,2,47,-1,,2139,482
5,1,69,1,3,1,480,2092,2,47,95,|,2139,482
2,1,70,0,0,0,40,2158,345,16,-1,,2174,385
3,1,70,1,0,0,40,2158,345,16,-1,,2174,385
4,1,70,1,1,0,40,2158,345,16,-1,,2174,385
5,1,70,1,1,1,40,2158,12,12,60,A,2170,52
5,1,70,1,1,2,56,2158,52,13,60,Suncor,2171,108
5,1,70,1,1,3,114,2158,65,13,92,business,2171,179
5,1,70,1,1,4,184,2158,5,13,92,/,2171,189
5,1,70,1,1,5,195,2158,30,13,93,Une,2171,225
5,1,70,1,1,6,230,2158,74,16,91,entreprise,2174,304
5,1,70,1,1,7,309,2158,18,13,96,de,2171,327
5,1,70,1,1,8,332,2158,53,13,96,Suncor,2171,385
2,1,71,0,0,0,701,1905,4,237,-1,,2142,705
3,1,71,1,0,0,701,1905,4,237,-1,,2142,705
4,1,71,1,1,0,701,1905,4,237,-1,,2142,705
5,1,71,1,1,1,701,1905,4,237,95, ,2142,705
2,1,72,0,0,0,56,1842,1577,309,-1,,2151,1633
3,1,72,1,0,0,56,1842,1577,309,-1,,2151,1633
4,1,72,1,1,0,56,1842,1577,309,-1,,2151,1633
5,1,72,1,1,1,56,1842,1577,309,95, ,2151,1633
2,1,73,0,0,0,950,1906,4,237,-1,,2143,954
3,1,73,1,0,0,950,1906,4,237,-1,,2143,954
4,1,73,1,1,0,950,1906,4,237,-1,,2143,954
5,1,73,1,1,1,950,1906,4,237,95, ,2143,954
2,1,74,0,0,0,1150,1907,4,237,-1,,2144,1154
3,1,74,1,0,0,1150,1907,4,237,-1,,2144,1154
4,1,74,1,1,0,1150,1907,4,237,-1,,2144,1154
5,1,74,1,1,1,1150,1907,4,237,95, ,2144,1154
2,1,75,0,0,0,1373,1907,3,237,-1,,2144,1376
3,1,75,1,0,0,1373,1907,3,237,-1,,2144,1376
4,1,75,1,1,0,1373,1907,3,237,-1,,2144,1376
5,1,75,1,1,1,1373,1907,3,237,95, ,2144,1376
2,1,76,0,0,0,1554,2159,111,17,-1,,2176,1665
3,1,76,1,0,0,1554,2159,111,17,-1,,2176,1665
4,1,76,1,1,0,1554,2159,111,17,-1,,2176,1665
5,1,76,1,1,1,1554,2159,53,14,81,11279L,2173,1607
5,1,76,1,1,2,1613,2159,52,17,95,(05/17),2176,1665
1,1,0,0,0,0,0,0,1700,2200,-1,,2200,1700
2,1,1,0,0,0,914,78,613,26,-1,,104,1527
3,1,1,1,0,0,914,78,613,26,-1,,104,1527
4,1,1,1,1,0,914,78,613,26,-1,,104,1527
5,1,1,1,1,1,914,78,116,22,95,VEHICLE,100,1030
5,1,1,1,1,2,1042,79,122,22,95,LOADING,101,1164
5,1,1,1,1,3,1175,80,114,22,93,REPORT,102,1289
5,1,1,1,1,4,1287,74,13,39,92,-,113,1300
5,1,1,1,1,5,1316,81,55,22,95,BILL,103,1371
5,1,1,1,1,6,1380,82,36,21,93,OF,103,1416
5,1,1,1,1,7,1426,82,101,22,90,LADING,104,1527
2,1,2,0,0,0,69,123,1550,15,-1,,138,1619
3,1,2,1,0,0,69,123,1550,15,-1,,138,1619
4,1,2,1,1,0,69,123,1550,15,-1,,138,1619
5,1,2,1,1,1,69,123,1550,15,95, ,138,1619
2,1,3,0,0,0,482,128,2,99,-1,,227,484
3,1,3,1,0,0,482,128,2,99,-1,,227,484
4,1,3,1,1,0,482,128,2,99,-1,,227,484
5,1,3,1,1,1,482,128,2,99,95, ,227,484
2,1,4,0,0,0,75,221,625,6,-1,,227,700
3,1,4,1,0,0,75,221,625,6,-1,,227,700
4,1,4,1,1,0,75,221,625,6,-1,,227,700
5,1,4,1,1,1,75,221,625,6,95, ,227,700
2,1,5,0,0,0,823,226,808,7,-1,,233,1631
3,1,5,1,0,0,823,226,808,7,-1,,233,1631
4,1,5,1,1,0,823,226,808,7,-1,,233,1631
5,1,5,1,1,1,823,226,808,7,95, ,233,1631
2,1,6,0,0,0,675,226,2,62,-1,,288,677
3,1,6,1,0,0,675,226,2,62,-1,,288,677
4,1,6,1,1,0,675,226,2,62,-1,,288,677
5,1,6,1,1,1,675,226,2,62,95, ,288,677
2,1,7,0,0,0,275,396,580,6,-1,,402,855
3,1,7,1,0,0,275,396,580,6,-1,,402,855
4,1,7,1,1,0,275,396,580,6,-1,,402,855
5,1,7,1,1,1,275,396,580,6,95, ,402,855
2,1,8,0,0,0,854,227,3,244,-1,,471,857
3,1,8,1,0,0,854,227,3,244,-1,,471,857
4,1,8,1,1,0,854,227,3,244,-1,,471,857
5,1,8,1,1,1,854,227,3,244,95, ,471,857
2,1,9,0,0,0,564,399,1,70,-1,,469,565
3,1,9,1,0,0,564,399,1,70,-1,,469,565
4,1,9,1,1,0,564,399,1,70,-1,,469,565
5,1,9,1,1,1,564,399,1,70,95, ,469,565
2,1,10,0,0,0,101,464,1532,11,-1,,475,1633
3,1,10,1,0,0,101,464,1532,11,-1,,475,1633
4,1,10,1,1,0,101,464,1532,11,-1,,475,1633
5,1,10,1,1,1,101,464,1532,11,95, ,475,1633
2,1,11,0,0,0,480,580,237,7,-1,,587,717
3,1,11,1,0,0,480,580,237,7,-1,,587,717
4,1,11,1,1,0,480,580,237,7,-1,,587,717
5,1,11,1,1,1,480,580,237,7,95, ,587,717
2,1,12,0,0,0,715,468,4,197,-1,,665,719
3,1,12,1,0,0,715,468,4,197,-1,,665,719
4,1,12,1,1,0,715,468,4,197,-1,,665,719
5,1,12,1,1,1,715,468,4,197,95, ,665,719
2,1,13,0,0,0,480,583,1,80,-1,,663,481
3,1,13,1,0,0,480,583,1,80,-1,,663,481
4,1,13,1,1,0,480,583,1,80,-1,,663,481
5,1,13,1,1,1,480,583,1,80,95, ,663,481
2,1,14,0,0,0,1103,471,3,196,-1,,667,1106
3,1,14,1,0,0,1103,471,3,196,-1,,667,1106
4,1,14,1,1,0,1103,471,3,196,-1,,667,1106
5,1,14,1,1,1,1103,471,3,196,95, ,667,1106
2,1,15,0,0,0,70,657,1562,13,-1,,670,1632
3,1,15,1,0,0,70,657,1562,13,-1,,670,1632
4,1,15,1,1,0,70,657,1562,13,-1,,670,1632
5,1,15,1,1,1,70,657,1562,13,95, ,670,1632
2,1,16,0,0,0,65,728,1564,12,-1,,740,1629
3,1,16,1,0,0,65,728,1564,12,-1,,740,1629
4,1,16,1,1,0,65,728,1564,12,-1,,740,1629
5,1,16,1,1,1,65,728,1564,12,95, ,740,1629
2,1,17,0,0,0,253,660,10,1074,-1,,1734,263
3,1,17,1,0,0,253,660,10,1074,-1,,1734,263
4,1,17,1,1,0,253,660,10,1074,-1,,1734,263
5,1,17,1,1,1,253,660,10,1074,95, ,1734,263
2,1,18,0,0,0,930,664,11,1074,-1,,1738,941
3,1,18,1,0,0,930,664,11,1074,-1,,1738,941
4,1,18,1,1,0,930,664,11,1074,-1,,1738,941
5,1,18,1,1,1,930,664,11,1074,95, ,1738,941
2,1,19,0,0,0,1125,665,10,1073,-1,,1738,1135
3,1,19,1,0,0,1125,665,10,1073,-1,,1738,1135
4,1,19,1,1,0,1125,665,10,1073,-1,,1738,1135
5,1,19,1,1,1,1125,665,10,1073,95, ,1738,1135
2,1,20,0,0,0,1278,675,11,1061,-1,,1736,1289
3,1,20,1,0,0,1278,675,11,1061,-1,,1736,1289
4,1,20,1,1,0,1278,675,11,1061,-1,,1736,1289
5,1,20,1,1,1,1278,675,11,1061,95, ,1736,1289
2,1,21,0,0,0,1431,667,10,1073,-1,,1740,1441
3,1,21,1,0,0,1431,667,10,1073,-1,,1740,1441
4,1,21,1,1,0,1431,667,10,1073,-1,,1740,1441
5,1,21,1,1,1,1431,667,10,1073,95, ,1740,1441
2,1,22,0,0,0,1514,667,11,1070,-1,,1737,1525
3,1,22,1,0,0,1514,667,11,1070,-1,,1737,1525
4,1,22,1,1,0,1514,667,11,1070,-1,,1737,1525
5,1,22,1,1,1,1514,667,11,1070,95, ,1737,1525
2,1,23,0,0,0,61,1730,1568,10,-1,,1740,1629
3,1,23,1,0,0,61,1730,1568,10,-1,,1740,1629
4,1,23,1,1,0,61,1730,1568,10,-1,,1740,1629
5,1,23,1,1,1,61,1730,1568,10,95, ,1740,1629
2,1,24,0,0,0,61,124,11,1676,-1,,1800,72
3,1,24,1,0,0,61,124,11,1676,-1,,1800,72
4,1,24,1,1,0,61,124,11,1676,-1,,1800,72
5,1,24,1,1,1,61,124,11,1676,95, ,1800,72
2,1,25,0,0,0,795,1734,1,86,-1,,1820,796
3,1,25,1,0,0,795,1734,1,86,-1,,1820,796
4,1,25,1,1,0,795,1734,1,86,-1,,1820,796
5,1,25,1,1,1,795,1734,1,86,95, ,1820,796
2,1,26,0,0,0,1002,1736,2,85,-1,,1821,1004
3,1,26,1,0,0,1002,1736,2,85,-1,,1821,1004
4,1,26,1,1,0,1002,1736,2,85,-1,,1821,1004
5,1,26,1,1,1,1002,1736,2,85,95, ,1821,1004
2,1,27,0,0,0,1209,1741,4,81,-1,,1822,1213
3,1,27,1,0,0,1209,1741,4,81,-1,,1822,1213
4,1,27,1,1,0,1209,1741,4,81,-1,,1822,1213
5,1,27,1,1,1,1209,1741,4,81,95, ,1822,1213
2,1,28,0,0,0,82,1814,1547,10,-1,,1824,1629
3,1,28,1,0,0,82,1814,1547,10,-1,,1824,1629
4,1,28,1,1,0,82,1814,1547,10,-1,,1824,1629
5,1,28,1,1,1,82,1814,1547,10,95, ,1824,1629
2,1,29,0,0,0,62,104,1571,1750,-1,,1854,1633
3,1,29,1,0,0,62,104,1571,1746,-1,,1850,1633
4,1,29,1,1,0,153,104,1480,35,-1,,139,1633
5,1,29,1,1,1,153,104,74,23,95,Page:,127,227
5,1,29,1,1,2,253,104,12,19,94,1,123,265
5,1,29,1,1,3,484,106,44,19,96,530,125,528
5,1,29,1,1,4,818,105,132,23,96,RAPPORT,128,950
5,1,29,1,1,5,960,106,35,22,92,DE,128,995
5,1,29,1,1,6,1006,106,213,24,92,CHARGEMENT,130,1219
5,1,29,1,1,7,1200,101,17,38,91,-,139,1217
5,1,29,1,1,8,1228,109,137,22,91,VEHICULE,131,1365
5,1,29,1,1,9,1374,122,9,3,92,-,125,1383
5,1,29,1,1,10,1392,110,241,29,91,CONNAISSEMENT,139,1633
4,1,29,1,2,0,141,134,534,25,-1,,159,675
5,1,29,1,2,1,141,134,110,17,88,DOCUMENT,151,251
5,1,29,1,2,2,257,136,81,15,77,NUMBER,151,338
5,1,29,1,2,3,366,138,62,18,77,1667,156,428
5,1,29,1,2,4,539,134,36,24,74,DAFE,158,575
5,1,29,1,2,5,585,130,90,40,44,DEXBEDITION,170,675
4,1,29,1,3,0,140,154,173,16,-1,,170,313
5,1,29,1,3,1,140,154,12,15,96,No,169,152
5,1,29,1,3,2,171,154,24,15,95,DU,169,195
5,1,29,1,3,3,203,155,110,15,95,DOCUMENT,170,313
4,1,29,1,4,0,153,158,1460,44,-1,,202,1613
5,1,29,1,4,1,153,158,10,11,92,Â°,169,163
5,1,29,1,4,2,525,164,137,38,59,mm/dd/yy,202,662
5,1,29,1,4,3,802,171,28,21,96,24,192,830
5,1,29,1,4,4,842,171,78,22,96,HOUR,193,920
5,1,29,1,4,5,931,172,117,21,23,NUMBER,193,1048
5,1,29,1,4,6,1048,163,4,38,23,_,201,1052
5,1,29,1,4,7,1069,170,70,21,20,(403),191,1139
5,1,29,1,4,8,1149,171,128,19,20,296-3000,190,1277
5,1,29,1,4,9,1313,174,139,22,75,~NUMERO,196,1452
5,1,29,1,4,10,1461,175,30,21,95,24,196,1491
5,1,29,1,4,11,1501,174,112,22,96,HEURES,196,1613
4,1,29,1,5,0,153,196,1223,29,-1,,225,1376
5,1,29,1,5,1,153,196,110,19,95,0114755,215,263
5,1,29,1,5,2,284,196,93,20,96,10/002,216,377
5,1,29,1,5,3,532,198,128,20,95,10/08/24,218,660
5,1,29,1,5,4,1052,202,233,23,93,COLLECT,225,1285
5,1,29,1,5,5,1182,198,15,35,89,-,233,1197
5,1,29,1,5,6,1208,202,77,23,88,FRAIS,225,1285
5,1,29,1,5,7,1294,204,82,21,91,VIRES,225,1376
4,1,29,1,6,0,82,226,1535,35,-1,,261,1617
5,1,29,1,6,1,82,226,197,15,73,CONSIGNEE/CUSTOMER,241,279
5,1,29,1,6,2,285,234,4,3,92,-,237,289
5,1,29,1,6,3,295,228,182,14,64,DESTINATAIRE/CLIENT,242,477
5,1,29,1,6,4,691,227,17,25,0,NOD,252,708
5,1,29,1,6,5,713,241,127,12,0,ETAMLISeeteNT,253,840
5,1,29,1,6,6,851,223,12,34,91,|,257,863
5,1,29,1,6,7,866,232,101,13,90,CONSIGNOR,245,967
5,1,29,1,6,8,973,239,5,3,90,-,242,978
5,1,29,1,6,9,984,232,104,14,92,EXPEDITEUR,246,1088
5,1,29,1,6,10,1464,226,153,35,20,EEN,261,1617
4,1,29,1,7,0,149,254,1426,30,-1,,284,1575
5,1,29,1,7,1,149,254,182,25,86,Mississauga,279,331
5,1,29,1,7,2,348,257,80,19,96,Lubes,276,428
5,1,29,1,7,3,448,259,97,18,96,Center,277,545
5,1,29,1,7,4,682,259,160,20,92,0000081523,279,842
5,1,29,1,7,5,862,260,182,24,90,|Mississauga,284,1044
5,1,29,1,7,6,1063,262,80,19,95,Lubes,281,1143
5,1,29,1,7,7,1163,263,99,18,96,Center,281,1262
5,1,29,1,7,8,1465,264,110,19,92,0081523,283,1575
4,1,29,1,8,0,151,286,1012,25,-1,,311,1163
5,1,29,1,8,1,151,286,45,19,96,385,305,196
5,1,29,1,8,2,217,288,146,18,96,Southdown,306,363
5,1,29,1,8,3,381,288,65,19,96,Road,307,446
5,1,29,1,8,4,682,290,160,19,84,0000000104,309,842
5,1,29,1,8,5,864,292,45,18,79,|385,310,909
5,1,29,1,8,6,931,292,147,18,96,Southdown,310,1078
5,1,29,1,8,7,1096,292,67,19,96,Road,311,1163
4,1,29,1,9,0,149,316,1060,29,-1,,345,1209
5,1,29,1,9,1,149,316,175,24,91,"Missisauga,",340,324
5,1,29,1,9,2,348,319,32,18,93,ON,337,380
5,1,29,1,9,3,398,319,94,19,1,L5J2y2,338,492
5,1,29,1,9,4,861,320,177,25,92,"Missisauga,",345,1038
5,1,29,1,9,5,1063,324,32,18,93,ON,342,1095
5,1,29,1,9,6,1112,324,97,18,18,L5J2yÂ¥2,342,1209
4,1,29,1,10,0,283,401,565,15,-1,,416,848
5,1,29,1,10,1,283,401,61,11,93,RELEASE,412,344
5,1,29,1,10,2,349,402,47,13,62,(C-af-A),415,396
5,1,29,1,10,3,401,402,59,11,96,NUMBER,413,460
5,1,29,1,10,4,571,403,79,11,92,CUSTOMER,414,650
5,1,29,1,10,5,654,404,76,11,96,PURCHASE,415,730
5,1,29,1,10,6,735,404,49,11,96,ORDER,415,784
5,1,29,1,10,7,789,404,59,12,96,NUMBER,416,848
4,1,29,1,11,0,621,417,190,12,-1,,429,811
5,1,29,1,11,1,621,417,17,11,92,No,428,638
5,1,29,1,11,2,643,417,17,11,96,DE,428,660
5,1,29,1,11,3,666,417,68,12,96,DEMANDE,429,734
5,1,29,1,11,4,739,418,18,11,96,DU,429,757
5,1,29,1,11,5,762,418,49,11,94,CLIENT,429,811
4,1,29,1,12,0,274,444,1,12,-1,,456,275
5,1,29,1,12,1,274,444,1,12,82,|,456,275
4,1,29,1,13,0,81,474,1337,19,-1,,493,1418
5,1,29,1,13,1,81,474,73,14,92,CARRIER,488,154
5,1,29,1,13,2,159,481,5,3,91,-,484,164
5,1,29,1,13,3,169,474,136,14,91,TRANSPORTEUR,488,305
5,1,29,1,13,4,736,476,70,14,55,VEHICLE,490,806
5,1,29,1,13,5,813,476,71,14,55,NUMBER,490,884
5,1,29,1,13,6,926,477,70,13,40,LICENSE,490,996
5,1,29,1,13,7,1002,477,70,14,96,NUMBER,491,1072
5,1,29,1,13,8,1134,478,79,14,96,ADDRESS,492,1213
5,1,29,1,13,9,1220,478,21,14,96,OF,492,1241
5,1,29,1,13,10,1248,479,57,13,96,METER,492,1305
5,1,29,1,13,11,1310,480,35,12,96,AND,492,1345
5,1,29,1,13,12,1350,480,68,13,96,TRADER,493,1418
4,1,29,1,14,0,151,498,1332,23,-1,,521,1483
5,1,29,1,14,1,151,499,129,18,96,SEABOARD,517,280
5,1,29,1,14,2,298,500,97,21,96,LIQUID,521,395
5,1,29,1,14,3,413,500,130,19,96,CARRIERS,519,543
5,1,29,1,14,4,580,501,111,19,95,0101317,520,691
5,1,29,1,14,5,708,488,13,37,92,|,525,721
5,1,29,1,14,6,740,498,136,14,48,NoOUVEHICULE,512,876
5,1,29,1,14,7,926,499,71,13,34,NOMBRE,512,997
5,1,29,1,14,8,1004,500,21,12,62,DE,512,1025
5,1,29,1,14,9,1032,500,62,13,62,PERMIS,513,1094
5,1,29,1,14,10,1102,488,7,37,92,|,525,1109
5,1,29,1,14,11,1120,500,91,14,44,LâAORESSE,514,1211
5,1,29,1,14,12,1218,501,22,13,94,DE,514,1240
5,1,29,1,14,13,1246,501,57,13,94,METRE,514,1303
5,1,29,1,14,14,1309,488,20,37,95,ET,525,1329
5,1,29,1,14,15,1340,502,17,12,93,DE,514,1357
5,1,29,1,14,16,1362,502,121,13,90,COMMERCANT,515,1483
4,1,29,1,15,0,151,528,1324,30,-1,,558,1475
5,1,29,1,15,1,151,528,27,18,95,55,546,178
5,1,29,1,15,2,197,529,84,19,96,ARROW,548,281
5,1,29,1,15,3,298,530,32,17,96,RD,547,330
5,1,29,1,15,4,728,532,80,18,91,H1346,550,808
5,1,29,1,15,5,1113,535,98,18,96,Suncor,553,1211
5,1,29,1,15,6,1229,536,100,22,96,Energy,558,1329
5,1,29,1,15,7,1346,536,129,18,96,Products,554,1475
4,1,29,1,16,0,148,559,1278,27,-1,,586,1426
5,1,29,1,16,1,148,559,82,19,94,North,578,230
5,1,29,1,16,2,248,559,66,19,96,York,578,314
5,1,29,1,16,3,730,563,78,19,96,91328,582,808
5,1,29,1,16,4,1113,565,62,19,95,3275,584,1175
5,1,29,1,16,5,1195,565,116,19,96,Rebecca,584,1311
5,1,29,1,16,6,1330,567,96,19,95,Street,586,1426
4,1,29,1,17,0,155,620,204,22,-1,,642,359
5,1,29,1,17,1,155,620,68,22,3,(416),642,223
5,1,29,1,17,2,233,620,126,20,3,642-0515,640,359
4,1,29,1,18,0,989,675,617,16,-1,,691,1606
5,1,29,1,18,1,989,675,67,13,92,FACTOR,688,1056
5,1,29,1,18,2,1164,676,93,13,96,MEASURED,689,1257
5,1,29,1,18,3,1309,677,32,12,92,NET,689,1341
5,1,29,1,18,4,1347,677,57,13,92,LITRES,690,1404
5,1,29,1,18,5,1536,678,70,13,95,DENSITY,691,1606
4,1,29,1,19,0,80,680,1526,31,-1,,711,1606
5,1,29,1,19,1,80,680,143,13,60,PRODUCTMETER,693,223
5,1,29,1,19,2,989,694,77,14,92,FACTEUR,708,1066
5,1,29,1,19,3,1178,695,57,14,96,LITRES,709,1235
5,1,29,1,19,4,1309,696,104,13,12,correcTep,709,1413
5,1,29,1,19,5,1441,688,62,14,66,|TEMPC,702,1503
5,1,29,1,19,6,1512,684,9,36,96,|,720,1521
5,1,29,1,19,7,1536,697,70,14,56,pense,711,1606
4,1,29,1,20,0,80,696,1512,45,-1,,741,1592
5,1,29,1,20,1,80,707,135,14,88,PRODUIT/METER,721,215
5,1,29,1,20,2,371,696,80,13,0,RSs,709,451
5,1,29,1,20,3,458,696,44,13,0,eee,709,502
5,1,29,1,20,4,535,696,34,14,28,TaN,710,569
5,1,29,1,20,5,591,697,63,14,3,DESI,711,654
5,1,29,1,20,6,664,698,142,13,0,TONDUPRODUTT,711,806
5,1,29,1,20,7,988,713,26,14,74,API,727,1014
5,1,29,1,20,8,1019,714,53,13,74,TABLE,727,1072
5,1,29,1,20,9,1164,715,93,14,93,MESUREES,729,1257
5,1,29,1,20,10,1333,716,62,13,46,TO18C,729,1395
5,1,29,1,20,11,1442,716,85,25,0,[CELSIUS,741,1527
5,1,29,1,20,12,1536,717,56,17,0,klum,734,1592
4,1,29,1,21,0,149,743,1424,27,-1,,770,1573
5,1,29,1,21,1,149,743,95,19,93,103265,762,244
5,1,29,1,21,2,255,739,18,34,93,|,773,273
5,1,29,1,21,3,280,745,48,18,94,NOT,763,328
5,1,29,1,21,4,346,746,147,17,96,REGULATED,763,493
5,1,29,1,21,5,511,747,82,17,96,UNDER,764,593
5,1,29,1,21,6,611,747,49,18,96,TDG,765,660
5,1,29,1,21,7,979,748,95,19,95,0.9615,767,1074
5,1,29,1,21,8,1162,750,79,19,96,25000,769,1241
5,1,29,1,21,9,1312,749,80,20,96,24038,769,1392
5,1,29,1,21,10,1446,751,127,19,65,65.4|913,770,1573
4,1,29,1,22,0,147,774,929,23,-1,,797,1076
5,1,29,1,22,1,147,774,96,18,91,MTR222,792,243
5,1,29,1,22,2,256,770,14,31,92,|,801,270
5,1,29,1,22,3,280,776,64,17,92,HVGO,793,344
5,1,29,1,22,4,959,780,49,17,91,API,797,1008
5,1,29,1,22,5,1029,779,47,18,78,54B,797,1076
4,1,29,1,23,0,149,834,1423,27,-1,,861,1572
5,1,29,1,23,1,149,834,94,19,94,103265,853,243
5,1,29,1,23,2,258,830,15,34,94,|,864,273
5,1,29,1,23,3,279,836,49,18,95,NOT,854,328
5,1,29,1,23,4,345,837,147,18,95,REGULATED,855,492
5,1,29,1,23,5,510,838,82,17,96,UNDER,855,592
5,1,29,1,23,6,610,838,49,18,96,TDG,856,659
5,1,29,1,23,7,979,839,95,19,96,0.9618,858,1074
5,1,29,1,23,8,1162,840,78,19,96,25003,859,1240
5,1,29,1,23,9,1312,841,79,18,96,24048,859,1391
5,1,29,1,23,10,1446,842,126,19,0,64.9913,861,1572
4,1,29,1,24,0,147,865,928,24,-1,,889,1075
5,1,29,1,24,1,147,865,96,18,89,MTR221,883,243
5,1,29,1,24,2,255,861,11,32,72,|),893,266
5,1,29,1,24,3,279,867,64,18,90,HVGO,885,343
5,1,29,1,24,4,959,871,48,17,91,API,888,1007
5,1,29,1,24,5,1028,870,47,19,75,54B,889,1075
4,1,29,1,25,0,310,1417,379,25,-1,,1442,689
5,1,29,1,25,1,310,1418,80,18,96,Total,1436,390
5,1,29,1,25,2,409,1417,97,20,96,Litres,1437,506
5,1,29,1,25,3,526,1419,33,23,96,by,1442,559
5,1,29,1,25,4,577,1419,112,19,96,Product,1438,689
4,1,29,1,26,0,278,1447,1110,25,-1,,1472,1388
5,1,29,1,26,1,278,1447,94,20,95,103265,1467,372
5,1,29,1,26,2,476,1449,65,19,91,HVGO,1468,541
5,1,29,1,26,3,1160,1452,78,19,95,50003,1471,1238
5,1,29,1,26,4,1310,1453,78,19,96,48086,1472,1388
4,1,29,1,27,0,62,1736,1509,39,-1,,1775,1571
5,1,29,1,27,1,62,1739,1,3,96,|,1742,63
5,1,29,1,27,2,76,1738,61,14,87,DRIVER,1752,137
5,1,29,1,27,3,142,1739,95,14,92,SIGNATURE,1753,237
5,1,29,1,27,4,243,1747,3,2,89,-,1749,246
5,1,29,1,27,5,254,1740,95,13,96,SIGNATURE,1753,349
5,1,29,1,27,6,355,1740,22,13,93,DU,1753,377
5,1,29,1,27,7,383,1740,117,14,90,CONDUCTEUR,1754,500
5,1,29,1,27,8,858,1736,65,39,42,ARRIVE,1775,923
5,1,29,1,27,9,1027,1740,72,25,67,DEBUT,1765,1099
5,1,29,1,27,10,1077,1736,22,41,67,DU,1777,1099
5,1,29,1,27,11,1102,1740,99,26,54,GHARGEMENT,1766,1201
5,1,29,1,27,12,1207,1736,21,41,40,|,1777,1228
5,1,29,1,27,13,1244,1741,149,26,3,FINDUGHRRGEMENT,1767,1393
5,1,29,1,27,14,1504,1742,67,26,0,âDepaRT,1768,1571
4,1,29,1,28,0,62,1788,1493,22,-1,,1810,1555
5,1,29,1,28,1,62,1806,1,3,93,|,1809,63
5,1,29,1,28,2,859,1788,78,20,96,05:50,1808,937
5,1,29,1,28,3,1059,1790,78,18,96,05:52,1808,1137
5,1,29,1,28,4,1276,1790,79,19,95,06:08,1809,1355
5,1,29,1,28,5,1476,1791,79,19,95,06:08,1810,1555
4,1,29,1,29,0,76,1813,1495,41,-1,,1854,1571
5,1,29,1,29,1,76,1820,61,13,96,DRIVER,1833,137
5,1,29,1,29,2,142,1820,47,13,89,NAME,1833,189
5,1,29,1,29,3,194,1827,5,3,89,-,1830,199
5,1,29,1,29,4,205,1820,36,14,96,NOM,1834,241
5,1,29,1,29,5,248,1820,22,14,92,DU,1834,270
5,1,29,1,29,6,276,1821,117,14,65,CONDUCTEUR,1835,393
5,1,29,1,29,7,594,1813,58,41,89,ORIVER,1854,652
5,1,29,1,29,8,665,1823,68,27,72,NUMBER,1850,733
5,1,29,1,29,9,1282,1826,53,13,95,TOTAL,1839,1335
5,1,29,1,29,10,1341,1826,94,14,93,QUANTITY,1840,1435
5,1,29,1,29,11,1428,1816,9,34,91,-,1850,1437
5,1,29,1,29,12,1440,1826,61,14,89,QUANT.,1840,1501
5,1,29,1,29,13,1506,1827,65,13,93,TOTALE,1840,1571
4,1,29,1,30,0,580,1836,147,14,-1,,1850,727
5,1,29,1,30,1,580,1836,20,14,96,No,1850,600
5,1,29,1,30,2,610,1826,20,34,89,DU,1860,630
5,1,29,1,30,3,634,1837,93,13,72,CONBUCTE,1850,727
2,1,30,0,0,0,83,1876,308,77,-1,,1953,391
3,1,30,1,0,0,83,1876,308,61,-1,,1937,391
4,1,30,1,1,0,142,1876,249,21,-1,,1897,391
5,1,30,1,1,1,142,1876,133,20,91,Amrinder,1896,275
5,1,30,1,1,2,310,1877,81,20,82,Singh,1897,391
4,1,30,1,2,0,83,1908,250,11,-1,,1919,333
5,1,30,1,2,1,83,1908,68,11,96,PRODUCT,1919,151
5,1,30,1,2,2,223,1908,36,11,79,TANK,1919,259
5,1,30,1,2,3,264,1908,69,11,24,CAPACITY,1919,333
4,1,30,1,3,0,86,1920,236,22,-1,,1942,322
5,1,30,1,3,1,86,1920,61,22,96,PRODUIT,1942,147
5,1,30,1,3,2,226,1925,96,12,87,CONTENANCE,1937,322
3,1,30,2,0,0,224,1941,103,12,-1,,1953,327
4,1,30,2,1,0,224,1941,103,12,-1,,1953,327
5,1,30,2,1,1,224,1941,18,12,92,DU,1953,242
5,1,30,2,1,2,248,1942,79,11,79,RESERVIOR,1953,327
2,1,31,0,0,0,275,1886,35,20,-1,,1906,310
3,1,31,1,0,0,275,1886,35,20,-1,,1906,310
4,1,31,1,1,0,275,1886,35,20,-1,,1906,310
5,1,31,1,1,1,275,1886,35,20,95, ,1906,310
2,1,32,0,0,0,56,1886,254,21,-1,,1907,310
3,1,32,1,0,0,56,1886,254,21,-1,,1907,310
4,1,32,1,1,0,56,1886,254,21,-1,,1907,310
5,1,32,1,1,1,56,1886,254,21,95,  ,1907,310
2,1,33,0,0,0,56,1904,553,7,-1,,1911,609
3,1,33,1,0,0,56,1904,553,7,-1,,1911,609
4,1,33,1,1,0,56,1904,553,7,-1,,1911,609
5,1,33,1,1,1,56,1904,553,7,95, ,1911,609
2,1,34,0,0,0,392,1926,67,28,-1,,1954,459
3,1,34,1,0,0,392,1926,67,28,-1,,1954,459
4,1,34,1,1,0,392,1926,67,11,-1,,1937,459
5,1,34,1,1,1,392,1926,67,11,66,MEASURE,1937,459
4,1,34,1,2,0,394,1942,63,12,-1,,1954,457
5,1,34,1,2,1,394,1942,63,12,85,DEAUICM,1954,457
2,1,35,0,0,0,391,1886,218,21,-1,,1907,609
3,1,35,1,0,0,391,1886,218,21,-1,,1907,609
4,1,35,1,1,0,391,1886,218,21,-1,,1907,609
5,1,35,1,1,1,391,1886,218,21,95,  ,1907,609
2,1,36,0,0,0,375,1909,205,14,-1,,1923,580
3,1,36,1,0,0,375,1909,205,14,-1,,1923,580
4,1,36,1,1,0,375,1909,205,14,-1,,1923,580
5,1,36,1,1,1,375,1909,49,12,76,WATER,1921,424
5,1,36,1,1,2,429,1909,46,12,88,DIP/CM,1921,475
5,1,36,1,1,3,481,1915,2,8,96,|,1923,483
5,1,36,1,1,4,488,1910,56,11,96,BEFORE,1921,544
5,1,36,1,1,5,549,1910,31,11,96,DIPS,1921,580
2,1,37,0,0,0,604,1880,217,75,-1,,1955,821
3,1,37,1,0,0,604,1880,217,75,-1,,1955,821
4,1,37,1,1,0,609,1880,128,19,-1,,1899,737
5,1,37,1,1,1,609,1880,128,19,96,56017265,1899,737
4,1,37,1,2,0,604,1910,217,12,-1,,1922,821
5,1,37,1,2,1,604,1910,45,11,91,AFTER,1921,649
5,1,37,1,2,2,654,1910,31,11,39,DIPS.,1921,685
5,1,37,1,2,3,698,1900,9,32,68,|,1932,707
5,1,37,1,2,4,713,1911,52,11,96,ENDING,1922,765
5,1,37,1,2,5,771,1911,50,11,96,INVENT,1922,821
4,1,37,1,3,0,612,1927,197,12,-1,,1939,809
5,1,37,1,3,1,612,1927,67,11,88,APRESLE,1938,679
5,1,37,1,3,2,695,1917,19,31,54,|,1948,714
5,1,37,1,3,3,726,1927,83,12,88,INVENTAIRE,1939,809
4,1,37,1,4,0,610,1943,179,12,-1,,1955,789
5,1,37,1,4,1,610,1943,75,12,90,JAUGEAGE,1955,685
5,1,37,1,4,2,742,1944,47,11,89,APRES,1955,789
2,1,38,0,0,0,480,1920,93,37,-1,,1957,573
3,1,38,1,0,0,480,1920,93,37,-1,,1957,573
4,1,38,1,1,0,480,1920,88,29,-1,,1949,568
5,1,38,1,1,1,480,1924,2,25,91,|,1949,482
5,1,38,1,1,2,502,1920,41,27,93,AVANT,1947,543
5,1,38,1,1,3,552,1927,16,10,91,LE,1937,568
4,1,38,1,2,0,480,1943,93,14,-1,,1957,573
5,1,38,1,2,1,480,1950,2,7,59,|,1957,482
5,1,38,1,2,2,499,1943,74,12,59,JAUGEAGE,1955,573
2,1,39,0,0,0,866,1911,67,28,-1,,1939,933
3,1,39,1,0,0,866,1911,67,28,-1,,1939,933
4,1,39,1,1,0,866,1911,67,12,-1,,1923,933
5,1,39,1,1,1,866,1911,67,12,96,PRODUCT,1923,933
4,1,39,1,2,0,868,1928,62,11,-1,,1939,930
5,1,39,1,2,1,868,1928,62,11,95,PRODUIT,1939,930
2,1,40,0,0,0,730,1837,493,33,-1,,1870,1223
3,1,40,1,0,0,730,1837,493,33,-1,,1870,1223
4,1,40,1,1,0,730,1837,493,33,-1,,1870,1223
5,1,40,1,1,1,730,1837,39,14,0,âF'*,1851,769
5,1,40,1,1,2,778,1840,93,22,96,Volume,1862,871
5,1,40,1,1,3,880,1842,113,21,96,corrected,1863,993
5,1,40,1,1,4,1004,1843,21,20,95,to,1863,1025
5,1,40,1,1,5,1037,1842,28,22,95,15,1864,1065
5,1,40,1,1,6,1075,1842,102,28,93,Degrees,1870,1177
5,1,40,1,1,7,1187,1842,18,22,84,C,1864,1205
5,1,40,1,1,8,1214,1842,9,10,84,*,1852,1223
2,1,41,0,0,0,737,1886,555,22,-1,,1908,1292
3,1,41,1,0,0,737,1886,555,22,-1,,1908,1292
4,1,41,1,1,0,737,1886,555,22,-1,,1908,1292
5,1,41,1,1,1,737,1886,555,22,95,   ,1908,1292
2,1,42,0,0,0,1004,1929,105,28,-1,,1957,1109
3,1,42,1,0,0,1004,1929,105,28,-1,,1957,1109
4,1,42,1,1,0,1007,1929,96,11,-1,,1940,1103
5,1,42,1,1,1,1007,1929,96,11,91,CONTENANCE,1940,1103
4,1,42,1,2,0,1004,1945,105,12,-1,,1957,1109
5,1,42,1,2,1,1004,1945,19,12,92,OU,1957,1023
5,1,42,1,2,2,1028,1945,81,12,90,RESERVIOR,1957,1109
2,1,43,0,0,0,1004,1912,111,11,-1,,1923,1115
3,1,43,1,0,0,1004,1912,111,11,-1,,1923,1115
4,1,43,1,1,0,1004,1912,111,11,-1,,1923,1115
5,1,43,1,1,1,1004,1912,37,11,95,TANK,1923,1041
5,1,43,1,1,2,1045,1912,70,11,70,CAPACITY,1923,1115
2,1,44,0,0,0,1171,1929,68,28,-1,,1957,1239
3,1,44,1,0,0,1171,1929,68,28,-1,,1957,1239
4,1,44,1,1,0,1171,1929,68,12,-1,,1941,1239
5,1,44,1,1,1,1171,1929,68,12,95,MEASURE,1941,1239
4,1,44,1,2,0,1174,1946,63,11,-1,,1957,1237
5,1,44,1,2,1,1174,1946,63,11,54,DEAUICM,1957,1237
2,1,45,0,0,0,1292,1852,196,50,-1,,1902,1488
3,1,45,1,0,0,1292,1852,196,50,-1,,1902,1488
4,1,45,1,1,0,1292,1852,196,20,-1,,1872,1488
5,1,45,1,1,1,1292,1852,78,19,96,50003,1871,1370
5,1,45,1,1,2,1391,1852,97,20,96,Litres,1872,1488
4,1,45,1,2,0,1292,1883,126,19,-1,,1902,1418
5,1,45,1,2,1,1292,1883,78,19,40,43903,1902,1370
5,1,45,1,2,2,1391,1883,27,19,39,kg,1902,1418
2,1,46,0,0,0,1157,1913,212,45,-1,,1958,1369
3,1,46,1,0,0,1157,1913,212,45,-1,,1958,1369
4,1,46,1,1,0,1157,1913,212,12,-1,,1925,1369
5,1,46,1,1,1,1157,1913,50,11,93,WATER,1924,1207
5,1,46,1,1,2,1212,1913,47,11,88,DIP/CM|,1924,1259
5,1,46,1,1,3,1277,1913,56,12,84,SEFORE,1925,1333
5,1,46,1,1,4,1338,1914,31,11,96,DIPS,1925,1369
4,1,46,1,2,0,1284,1930,67,11,-1,,1941,1351
5,1,46,1,2,1,1284,1930,47,11,95,AVANT,1941,1331
5,1,46,1,2,2,1336,1930,15,11,86,LE,1941,1351
4,1,46,1,3,0,1282,1947,75,11,-1,,1958,1357
5,1,46,1,3,1,1282,1947,75,11,91,JAUGEAGE,1958,1357
2,1,47,0,0,0,1418,1886,216,25,-1,,1911,1634
3,1,47,1,0,0,1418,1886,216,25,-1,,1911,1634
4,1,47,1,1,0,1418,1886,216,25,-1,,1911,1634
5,1,47,1,1,1,1418,1886,216,25,95,    ,1911,1634
2,1,48,0,0,0,1388,1914,81,45,-1,,1959,1469
3,1,48,1,0,0,1388,1914,81,45,-1,,1959,1469
4,1,48,1,1,0,1388,1914,81,11,-1,,1925,1469
5,1,48,1,1,1,1388,1914,45,11,96,AFTER,1925,1433
5,1,48,1,1,2,1438,1914,31,11,63,DIPS,1925,1469
4,1,48,1,2,0,1393,1930,67,11,-1,,1941,1460
5,1,48,1,2,1,1393,1930,46,11,92,APRES,1941,1439
5,1,48,1,2,2,1444,1930,16,11,93,LE,1941,1460
4,1,48,1,3,0,1393,1947,75,12,-1,,1959,1468
5,1,48,1,3,1,1393,1947,75,12,88,JAUGEAGE,1959,1468
2,1,49,0,0,0,1625,136,12,1767,-1,,1903,1637
3,1,49,1,0,0,1625,136,12,1767,-1,,1903,1637
4,1,49,1,1,0,1625,136,12,1767,-1,,1903,1637
5,1,49,1,1,1,1625,136,12,1767,95, ,1903,1637
2,1,50,0,0,0,1499,1914,108,45,-1,,1959,1607
3,1,50,1,0,0,1499,1914,108,45,-1,,1959,1607
4,1,50,1,1,0,1499,1914,108,11,-1,,1925,1607
5,1,50,1,1,1,1499,1914,52,11,96,ENDING,1925,1551
5,1,50,1,1,2,1556,1914,51,11,96,INVENT,1925,1607
4,1,50,1,2,0,1513,1931,82,12,-1,,1943,1595
5,1,50,1,2,1,1513,1931,82,12,91,INVENTAIRE,1943,1595
4,1,50,1,3,0,1526,1947,47,12,-1,,1959,1573
5,1,50,1,3,1,1526,1947,47,12,91,APRES,1959,1573
2,1,51,0,0,0,90,1955,1535,11,-1,,1966,1625
3,1,51,1,0,0,90,1955,1535,11,-1,,1966,1625
4,1,51,1,1,0,90,1955,1535,11,-1,,1966,1625
5,1,51,1,1,1,90,1955,1535,11,95, ,1966,1625
2,1,52,0,0,0,64,2016,1546,11,-1,,2027,1610
3,1,52,1,0,0,64,2016,1546,11,-1,,2027,1610
4,1,52,1,1,0,64,2016,1546,11,-1,,2027,1610
5,1,52,1,1,1,64,2016,1546,11,95, ,2027,1610
2,1,53,0,0,0,1261,1964,4,72,-1,,2036,1265
3,1,53,1,0,0,1261,1964,4,72,-1,,2036,1265
4,1,53,1,1,0,1261,1964,4,72,-1,,2036,1265
5,1,53,1,1,1,1261,1964,4,72,89,|,2036,1265
2,1,54,0,0,0,64,2078,1560,11,-1,,2089,1624
3,1,54,1,0,0,64,2078,1560,11,-1,,2089,1624
4,1,54,1,1,0,64,2078,1560,11,-1,,2089,1624
5,1,54,1,1,1,64,2078,1560,11,95, ,2089,1624
2,1,55,0,0,0,169,1902,7,238,-1,,2140,176
3,1,55,1,0,0,169,1902,7,238,-1,,2140,176
4,1,55,1,1,0,169,1902,7,238,-1,,2140,176
5,1,55,1,1,1,169,1902,7,238,95, ,2140,176
2,1,56,0,0,0,39,2158,346,17,-1,,2175,385
3,1,56,1,0,0,39,2158,346,17,-1,,2175,385
4,1,56,1,1,0,39,2158,346,17,-1,,2175,385
5,1,56,1,1,1,39,2158,12,13,66,A,2171,51
5,1,56,1,1,2,55,2158,52,13,66,Suncor,2171,107
5,1,56,1,1,3,113,2158,65,13,92,business,2171,178
5,1,56,1,1,4,183,2158,5,13,92,/,2171,188
5,1,56,1,1,5,194,2158,30,13,92,Une,2171,224
5,1,56,1,1,6,229,2158,74,17,86,entreprise,2175,303
5,1,56,1,1,7,308,2158,19,14,96,de,2172,327
5,1,56,1,1,8,332,2158,53,14,96,Suncor,2172,385
2,1,57,0,0,0,590,1912,4,230,-1,,2142,594
3,1,57,1,0,0,590,1912,4,230,-1,,2142,594
4,1,57,1,1,0,590,1912,4,230,-1,,2142,594
5,1,57,1,1,1,590,1912,4,230,95, ,2142,594
2,1,58,0,0,0,950,1907,4,236,-1,,2143,954
3,1,58,1,0,0,950,1907,4,236,-1,,2143,954
4,1,58,1,1,0,950,1907,4,236,-1,,2143,954
5,1,58,1,1,1,950,1907,4,236,95, ,2143,954
2,1,59,0,0,0,1150,1964,4,180,-1,,2144,1154
3,1,59,1,0,0,1150,1964,4,180,-1,,2144,1154
4,1,59,1,1,0,1150,1964,4,180,-1,,2144,1154
5,1,59,1,1,1,1150,1964,4,180,95, ,2144,1154
2,1,60,0,0,0,1373,1908,4,237,-1,,2145,1377
3,1,60,1,0,0,1373,1908,4,237,-1,,2145,1377
4,1,60,1,1,0,1373,1908,4,237,-1,,2145,1377
5,1,60,1,1,1,1373,1908,4,237,95, ,2145,1377
2,1,61,0,0,0,56,1911,1578,244,-1,,2155,1634
3,1,61,1,0,0,56,1911,1578,244,-1,,2155,1634
4,1,61,1,1,0,56,1911,1578,244,-1,,2155,1634
5,1,61,1,1,1,56,1911,1578,244,95, ,2155,1634
2,1,62,0,0,0,1553,2161,111,16,-1,,2177,1664
3,1,62,1,0,0,1553,2161,111,16,-1,,2177,1664
4,1,62,1,1,0,1553,2161,111,16,-1,,2177,1664
5,1,62,1,1,1,1553,2161,54,13,64,412791,2174,1607
5,1,62,1,1,2,1612,2161,52,16,96,(05/17),2177,1664
1,1,0,0,0,0,0,0,1700,2200,-1,,2200,1700
2,1,1,0,0,0,764,36,179,35,-1,,71,943
3,1,1,1,0,0,764,36,179,35,-1,,71,943
4,1,1,1,1,0,764,36,179,35,-1,,71,943
5,1,1,1,1,1,764,38,119,33,19,2YUOFo,71,883
5,1,1,1,1,2,899,36,44,32,76,YE,68,943
2,1,2,0,0,0,913,76,612,24,-1,,100,1525
3,1,2,1,0,0,913,76,612,24,-1,,100,1525
4,1,2,1,1,0,913,76,612,24,-1,,100,1525
5,1,2,1,1,1,913,76,117,21,96,VEHICLE,97,1030
5,1,2,1,1,2,1041,77,122,21,96,LOADING,98,1163
5,1,2,1,1,3,1174,78,114,21,93,REPORT,99,1288
5,1,2,1,1,4,1285,72,14,38,92,-,110,1299
5,1,2,1,1,5,1314,78,55,21,96,BILL,99,1369
5,1,2,1,1,6,1378,78,37,22,93,OF,100,1415
5,1,2,1,1,7,1426,79,99,21,92,LADING,100,1525
2,1,3,0,0,0,68,122,1566,12,-1,,134,1634
3,1,3,1,0,0,68,122,1566,12,-1,,134,1634
4,1,3,1,1,0,68,122,1566,12,-1,,134,1634
5,1,3,1,1,1,68,122,1566,12,95, ,134,1634
2,1,4,0,0,0,481,126,2,97,-1,,223,483
3,1,4,1,0,0,481,126,2,97,-1,,223,483
4,1,4,1,1,0,481,126,2,97,-1,,223,483
5,1,4,1,1,1,481,126,2,97,95, ,223,483
2,1,5,0,0,0,67,217,632,6,-1,,223,699
3,1,5,1,0,0,67,217,632,6,-1,,223,699
4,1,5,1,1,0,67,217,632,6,-1,,223,699
5,1,5,1,1,1,67,217,632,6,95, ,223,699
2,1,6,0,0,0,675,222,2,63,-1,,285,677
3,1,6,1,0,0,675,222,2,63,-1,,285,677
4,1,6,1,1,0,675,222,2,63,-1,,285,677
5,1,6,1,1,1,675,222,2,63,95, ,285,677
2,1,7,0,0,0,824,223,809,6,-1,,229,1633
3,1,7,1,0,0,824,223,809,6,-1,,229,1633
4,1,7,1,1,0,824,223,809,6,-1,,229,1633
5,1,7,1,1,1,824,223,809,6,95, ,229,1633
2,1,8,0,0,0,275,395,580,5,-1,,400,855
3,1,8,1,0,0,275,395,580,5,-1,,400,855
4,1,8,1,1,0,275,395,580,5,-1,,400,855
5,1,8,1,1,1,275,395,580,5,95, ,400,855
2,1,9,0,0,0,563,397,3,71,-1,,468,566
3,1,9,1,0,0,563,397,3,71,-1,,468,566
4,1,9,1,1,0,563,397,3,71,-1,,468,566
5,1,9,1,1,1,563,397,3,71,95, ,468,566
2,1,10,0,0,0,854,223,2,247,-1,,470,856
3,1,10,1,0,0,854,223,2,247,-1,,470,856
4,1,10,1,1,0,854,223,2,247,-1,,470,856
5,1,10,1,1,1,854,223,2,247,95, ,470,856
2,1,11,0,0,0,1452,227,1,62,-1,,289,1453
3,1,11,1,0,0,1452,227,1,62,-1,,289,1453
4,1,11,1,1,0,1452,227,1,62,-1,,289,1453
5,1,11,1,1,1,1452,227,1,62,95, ,289,1453
2,1,12,0,0,0,1452,288,181,2,-1,,290,1633
3,1,12,1,0,0,1452,288,181,2,-1,,290,1633
4,1,12,1,1,0,1452,288,181,2,-1,,290,1633
5,1,12,1,1,1,1452,288,181,2,95, ,290,1633
2,1,13,0,0,0,66,462,1567,10,-1,,472,1633
3,1,13,1,0,0,66,462,1567,10,-1,,472,1633
4,1,13,1,1,0,66,462,1567,10,-1,,472,1633
5,1,13,1,1,1,66,462,1567,10,95, ,472,1633
2,1,14,0,0,0,480,582,237,4,-1,,586,717
3,1,14,1,0,0,480,582,237,4,-1,,586,717
4,1,14,1,1,0,480,582,237,4,-1,,586,717
5,1,14,1,1,1,480,582,237,4,95, ,586,717
2,1,15,0,0,0,480,583,1,79,-1,,662,481
3,1,15,1,0,0,480,583,1,79,-1,,662,481
4,1,15,1,1,0,480,583,1,79,-1,,662,481
5,1,15,1,1,1,480,583,1,79,95, ,662,481
2,1,16,0,0,0,715,467,3,197,-1,,664,718
3,1,16,1,0,0,715,467,3,197,-1,,664,718
4,1,16,1,1,0,715,467,3,197,-1,,664,718
5,1,16,1,1,1,715,467,3,197,95, ,664,718
2,1,17,0,0,0,65,657,1567,10,-1,,667,1632
3,1,17,1,0,0,65,657,1567,10,-1,,667,1632
4,1,17,1,1,0,65,657,1567,10,-1,,667,1632
5,1,17,1,1,1,65,657,1567,10,95, ,667,1632
2,1,18,0,0,0,65,123,5,894,-1,,1017,70
3,1,18,1,0,0,65,123,5,894,-1,,1017,70
4,1,18,1,1,0,65,123,5,894,-1,,1017,70
5,1,18,1,1,1,65,123,5,894,95, ,1017,70
2,1,19,0,0,0,127,728,1505,9,-1,,737,1632
3,1,19,1,0,0,127,728,1505,9,-1,,737,1632
4,1,19,1,1,0,127,728,1505,9,-1,,737,1632
5,1,19,1,1,1,127,728,1505,9,95, ,737,1632
2,1,20,0,0,0,256,662,5,1071,-1,,1733,261
3,1,20,1,0,0,256,662,5,1071,-1,,1733,261
4,1,20,1,1,0,256,662,5,1071,-1,,1733,261
5,1,20,1,1,1,256,662,5,1071,95, ,1733,261
2,1,21,0,0,0,1129,664,4,1072,-1,,1736,1133
3,1,21,1,0,0,1129,664,4,1072,-1,,1736,1133
4,1,21,1,1,0,1129,664,4,1072,-1,,1736,1133
5,1,21,1,1,1,1129,664,4,1072,95, ,1736,1133
2,1,22,0,0,0,1282,664,4,1073,-1,,1737,1286
3,1,22,1,0,0,1282,664,4,1073,-1,,1737,1286
4,1,22,1,1,0,1282,664,4,1073,-1,,1737,1286
5,1,22,1,1,1,1282,664,4,1073,95, ,1737,1286
2,1,23,0,0,0,934,675,4,1058,-1,,1733,938
3,1,23,1,0,0,934,675,4,1058,-1,,1733,938
4,1,23,1,1,0,934,675,4,1058,-1,,1733,938
5,1,23,1,1,1,934,675,4,1058,95, ,1733,938
2,1,24,0,0,0,1435,665,5,1072,-1,,1737,1440
3,1,24,1,0,0,1435,665,5,1072,-1,,1737,1440
4,1,24,1,1,0,1435,665,5,1072,-1,,1737,1440
5,1,24,1,1,1,1435,665,5,1072,95, ,1737,1440
2,1,25,0,0,0,1517,665,5,1072,-1,,1737,1522
3,1,25,1,0,0,1517,665,5,1072,-1,,1737,1522
4,1,25,1,1,0,1517,665,5,1072,-1,,1737,1522
5,1,25,1,1,1,1517,665,5,1072,95, ,1737,1522
2,1,26,0,0,0,63,1730,1567,7,-1,,1737,1630
3,1,26,1,0,0,63,1730,1567,7,-1,,1737,1630
4,1,26,1,1,0,63,1730,1567,7,-1,,1737,1630
5,1,26,1,1,1,63,1730,1567,7,95, ,1737,1630
2,1,27,0,0,0,64,123,6,1747,-1,,1870,70
3,1,27,1,0,0,64,123,6,1747,-1,,1870,70
4,1,27,1,1,0,64,123,6,1747,-1,,1870,70
5,1,27,1,1,1,64,123,6,1747,95, ,1870,70
2,1,28,0,0,0,57,1883,89,21,-1,,1904,146
3,1,28,1,0,0,57,1883,89,21,-1,,1904,146
4,1,28,1,1,0,57,1883,89,21,-1,,1904,146
5,1,28,1,1,1,57,1883,89,21,95, ,1904,146
2,1,29,0,0,0,1003,1734,2,85,-1,,1819,1005
3,1,29,1,0,0,1003,1734,2,85,-1,,1819,1005
4,1,29,1,1,0,1003,1734,2,85,-1,,1819,1005
5,1,29,1,1,1,1003,1734,2,85,95, ,1819,1005
2,1,30,0,0,0,1211,1736,3,84,-1,,1820,1214
3,1,30,1,0,0,1211,1736,3,84,-1,,1820,1214
4,1,30,1,1,0,1211,1736,3,84,-1,,1820,1214
5,1,30,1,1,1,1211,1736,3,84,95, ,1820,1214
2,1,31,0,0,0,117,1814,1510,7,-1,,1821,1627
3,1,31,1,0,0,117,1814,1510,7,-1,,1821,1627
4,1,31,1,1,0,117,1814,1510,7,-1,,1821,1627
5,1,31,1,1,1,117,1814,1510,7,95, ,1821,1627
2,1,32,0,0,0,57,1883,554,23,-1,,1906,611
3,1,32,1,0,0,57,1883,554,23,-1,,1906,611
4,1,32,1,1,0,57,1883,554,23,-1,,1906,611
5,1,32,1,1,1,57,1883,554,23,95,   ,1906,611
2,1,33,0,0,0,425,1883,186,22,-1,,1905,611
3,1,33,1,0,0,425,1883,186,22,-1,,1905,611
4,1,33,1,1,0,425,1883,186,22,-1,,1905,611
5,1,33,1,1,1,425,1883,186,22,95,  ,1905,611
2,1,34,0,0,0,85,1908,68,28,-1,,1936,153
3,1,34,1,0,0,85,1908,68,28,-1,,1936,153
4,1,34,1,1,0,85,1908,68,11,-1,,1919,153
5,1,34,1,1,1,85,1908,68,11,96,PRODUCT,1919,153
4,1,34,1,2,0,88,1925,61,11,-1,,1936,149
5,1,34,1,2,1,88,1925,61,11,93,PRODUIT,1936,149
2,1,35,0,0,0,225,1908,110,45,-1,,1953,335
3,1,35,1,0,0,225,1908,110,45,-1,,1953,335
4,1,35,1,1,0,225,1908,110,12,-1,,1920,335
5,1,35,1,1,1,225,1908,36,12,70,TANK,1920,261
5,1,35,1,1,2,266,1909,69,11,96,CAPACITY,1920,335
4,1,35,1,2,0,228,1925,95,11,-1,,1936,323
5,1,35,1,2,1,228,1925,95,11,45,CONTENANCE,1936,323
4,1,35,1,3,0,226,1941,103,12,-1,,1953,329
5,1,35,1,3,1,226,1941,18,12,87,DU,1953,244
5,1,35,1,3,2,249,1941,80,12,87,RESERVIOR,1953,329
2,1,36,0,0,0,376,1909,101,44,-1,,1953,477
3,1,36,1,0,0,376,1909,101,44,-1,,1953,477
4,1,36,1,1,0,376,1909,101,11,-1,,1920,477
5,1,36,1,1,1,376,1909,50,11,79,WATER,1920,426
5,1,36,1,1,2,430,1909,47,11,66,DIP/CM,1920,477
4,1,36,1,2,0,394,1926,67,11,-1,,1937,461
5,1,36,1,2,1,394,1926,67,11,57,MEASURE:,1937,461
4,1,36,1,3,0,396,1941,63,12,-1,,1953,459
5,1,36,1,3,1,396,1941,63,12,59,DEAUICM,1953,459
2,1,37,0,0,0,490,1910,92,44,-1,,1954,582
3,1,37,1,0,0,490,1910,92,44,-1,,1954,582
4,1,37,1,1,0,490,1910,92,11,-1,,1921,582
5,1,37,1,1,1,490,1910,56,11,95,BEFORE,1921,546
5,1,37,1,1,2,551,1910,31,11,86,DIPS,1921,582
4,1,37,1,2,0,504,1926,65,11,-1,,1937,569
5,1,37,1,2,1,504,1926,45,11,92,AVANT,1937,549
5,1,37,1,2,2,554,1927,15,10,96,LE,1937,569
4,1,37,1,3,0,500,1942,75,12,-1,,1954,575
5,1,37,1,3,1,500,1942,75,12,89,JAUGEAGE,1954,575
2,1,38,0,0,0,606,1910,81,44,-1,,1954,687
3,1,38,1,0,0,606,1910,81,44,-1,,1954,687
4,1,38,1,1,0,606,1910,81,12,-1,,1922,687
5,1,38,1,1,1,606,1910,45,12,96,AFTER,1922,651
5,1,38,1,1,2,656,1910,31,12,94,DIPS,1922,687
4,1,38,1,2,0,614,1927,67,10,-1,,1937,681
5,1,38,1,2,1,614,1927,47,10,91,APRES,1937,661
5,1,38,1,2,2,666,1927,15,10,94,LE,1937,681
4,1,38,1,3,0,611,1943,76,11,-1,,1954,687
5,1,38,1,3,1,611,1943,76,11,44,"JAUGEAGE,",1954,687
2,1,39,0,0,0,738,1883,556,23,-1,,1906,1294
3,1,39,1,0,0,738,1883,556,23,-1,,1906,1294
4,1,39,1,1,0,738,1883,556,23,-1,,1906,1294
5,1,39,1,1,1,738,1883,556,23,95,   ,1906,1294
2,1,40,0,0,0,714,1910,109,45,-1,,1955,823
3,1,40,1,0,0,714,1910,109,45,-1,,1955,823
4,1,40,1,1,0,714,1910,109,12,-1,,1922,823
5,1,40,1,1,1,714,1910,53,12,94,ENDING,1922,767
5,1,40,1,1,2,772,1911,51,11,94,INVENT,1922,823
4,1,40,1,2,0,728,1927,83,11,-1,,1938,811
5,1,40,1,2,1,728,1927,83,11,0,INVENTAIRE,1938,811
4,1,40,1,3,0,744,1943,47,12,-1,,1955,791
5,1,40,1,3,1,744,1943,47,12,67,APRES,1955,791
2,1,41,0,0,0,867,1911,68,27,-1,,1938,935
3,1,41,1,0,0,867,1911,68,27,-1,,1938,935
4,1,41,1,1,0,867,1911,68,11,-1,,1922,935
5,1,41,1,1,1,867,1911,68,11,96,PRODUCT,1922,935
4,1,41,1,2,0,870,1928,61,10,-1,,1938,931
5,1,41,1,2,1,870,1928,61,10,96,PRODUIT,1938,931
2,1,42,0,0,0,1006,1912,110,43,-1,,1955,1116
3,1,42,1,0,0,1006,1912,110,43,-1,,1955,1116
4,1,42,1,1,0,1006,1912,110,11,-1,,1923,1116
5,1,42,1,1,1,1006,1912,37,11,95,TANK,1923,1043
5,1,42,1,1,2,1046,1912,70,11,95,CAPACITY,1923,1116
4,1,42,1,2,0,1008,1928,97,11,-1,,1939,1105
5,1,42,1,2,1,1008,1928,97,11,65,CONTENANCE,1939,1105
4,1,42,1,3,0,1006,1944,105,11,-1,,1955,1111
5,1,42,1,3,1,1006,1944,19,11,93,DU,1955,1025
5,1,42,1,3,2,1030,1944,81,11,92,RESERVIOR,1955,1111
2,1,43,0,0,0,1158,1912,103,44,-1,,1956,1261
3,1,43,1,0,0,1158,1912,103,44,-1,,1956,1261
4,1,43,1,1,0,1158,1912,103,12,-1,,1924,1261
5,1,43,1,1,1,1158,1912,50,12,63,WATER,1924,1208
5,1,43,1,1,2,1213,1912,48,12,82,DIP/CM,1924,1261
4,1,43,1,2,0,1173,1929,68,10,-1,,1939,1241
5,1,43,1,2,1,1173,1929,68,10,96,MEASURE,1939,1241
4,1,43,1,3,0,1176,1945,63,11,-1,,1956,1239
5,1,43,1,3,1,1176,1945,63,11,51,DEAUICM,1956,1239
2,1,44,0,0,0,1279,1912,92,45,-1,,1957,1371
3,1,44,1,0,0,1279,1912,92,45,-1,,1957,1371
4,1,44,1,1,0,1279,1912,92,12,-1,,1924,1371
5,1,44,1,1,1,1279,1912,56,12,96,BEFORE,1924,1335
5,1,44,1,1,2,1340,1913,31,11,86,DIPS,1924,1371
4,1,44,1,2,0,1286,1929,67,10,-1,,1939,1353
5,1,44,1,2,1,1286,1929,47,10,93,AVANT,1939,1333
5,1,44,1,2,2,1337,1930,16,9,90,LE,1939,1353
4,1,44,1,3,0,1284,1945,75,12,-1,,1957,1359
5,1,44,1,3,1,1284,1945,75,12,91,JAUGEAGE,1957,1359
2,1,45,0,0,0,1373,1883,19,25,-1,,1908,1392
3,1,45,1,0,0,1373,1883,19,25,-1,,1908,1392
4,1,45,1,1,0,1373,1883,19,25,-1,,1908,1392
5,1,45,1,1,1,1373,1883,19,25,95,    ,1908,1392
2,1,46,0,0,0,63,102,1568,1797,-1,,1899,1631
3,1,46,1,0,0,63,102,1568,1797,-1,,1899,1631
4,1,46,1,1,0,151,102,1480,27,-1,,129,1631
5,1,46,1,1,1,151,104,75,22,95,Page:,126,226
5,1,46,1,1,2,251,102,12,19,92,1,121,263
5,1,46,1,1,3,482,104,45,19,96,530,123,527
5,1,46,1,1,4,817,103,132,22,96,RAPPORT,125,949
5,1,46,1,1,5,959,104,35,21,93,DE,125,994
5,1,46,1,1,6,1004,104,197,23,91,CHARGEMENT,127,1201
5,1,46,1,1,7,1210,118,6,3,90,-,121,1216
5,1,46,1,1,8,1226,106,137,22,90,VEHICULE,128,1363
5,1,46,1,1,9,1374,118,7,4,90,-,122,1381
5,1,46,1,1,10,1390,106,241,23,91,CONNAISSEMENT,129,1631
4,1,46,1,2,0,140,130,534,26,-1,,156,674
5,1,46,1,2,1,140,132,110,15,93,DOCUMENT,147,250
5,1,46,1,2,2,257,133,80,15,83,NUMBER,148,337
5,1,46,1,2,3,366,134,61,18,83,1671,152,427
5,1,46,1,2,4,538,130,36,25,84,DATE,155,574
5,1,46,1,2,5,584,131,54,24,44,DENPED,155,638
5,1,46,1,2,6,647,132,27,24,56,ION,156,674
4,1,46,1,3,0,140,151,173,15,-1,,166,313
5,1,46,1,3,1,140,151,11,14,96,No,165,151
5,1,46,1,3,2,170,151,25,15,94,BU,166,195
5,1,46,1,3,3,203,152,110,14,96,DOCUMENT,166,313
4,1,46,1,4,0,153,154,1460,43,-1,,197,1613
5,1,46,1,4,1,153,154,10,11,0,;,165,163
5,1,46,1,4,2,524,160,142,37,93,mm/dd/yy,197,666
5,1,46,1,4,3,802,168,28,21,93,24,189,830
5,1,46,1,4,4,841,168,79,21,95,HOUR,189,920
5,1,46,1,4,5,931,168,117,22,16,NUMBER,190,1048
5,1,46,1,4,6,1050,163,3,34,16,_,197,1053
5,1,46,1,4,7,1069,168,69,20,15,(403),188,1138
5,1,46,1,4,8,1148,168,129,19,15,296-3000,187,1277
5,1,46,1,4,9,1313,171,138,22,51,-~NUMERO,193,1451
5,1,46,1,4,10,1461,172,29,20,96,24,192,1490
5,1,46,1,4,11,1501,172,112,21,96,HEURES,193,1613
4,1,46,1,5,0,152,192,1224,30,-1,,222,1376
5,1,46,1,5,1,152,192,110,18,96,0114757,210,262
5,1,46,1,5,2,283,192,93,20,95,10/002,212,376
5,1,46,1,5,3,531,194,129,20,96,10/08/24,214,660
5,1,46,1,5,4,1052,200,233,22,93,COLLECT,222,1285
5,1,46,1,5,5,1181,189,16,38,91,-,227,1197
5,1,46,1,5,6,1209,200,74,22,91,FRAIS,222,1283
5,1,46,1,5,7,1294,201,82,21,90,VIRES,222,1376
4,1,46,1,6,0,81,223,1510,34,-1,,257,1591
5,1,46,1,6,1,81,223,197,14,91,CONSIGNEE/CUSTOMER,237,278
5,1,46,1,6,2,284,232,5,2,88,-,234,289
5,1,46,1,6,3,295,224,181,15,84,DESTINATAIRE/CLIENT,239,476
5,1,46,1,6,4,690,224,17,25,0,Sept,249,707
5,1,46,1,6,5,712,238,127,11,0,Raeeetenr,249,839
5,1,46,1,6,6,851,220,11,33,93,|,253,862
5,1,46,1,6,7,865,228,101,14,92,CONSIGNOR,242,966
5,1,46,1,6,8,972,236,5,2,92,-,238,977
5,1,46,1,6,9,983,229,105,14,93,EXPEDITEUR,243,1088
5,1,46,1,6,10,1467,223,67,34,0,TOOXTEN,257,1534
5,1,46,1,6,11,1545,223,46,34,0,NOME,257,1591
4,1,46,1,7,0,149,251,1426,29,-1,,280,1575
5,1,46,1,7,1,149,251,182,25,95,Mississauga,276,331
5,1,46,1,7,2,348,253,79,20,95,Lubes,273,427
5,1,46,1,7,3,446,256,98,17,96,Center,273,544
5,1,46,1,7,4,681,256,161,19,93,0000081523,275,842
5,1,46,1,7,5,861,256,183,24,90,|Mississauga,280,1044
5,1,46,1,7,6,1062,258,81,19,96,Lubes,277,1143
5,1,46,1,7,7,1162,260,99,17,95,Center,277,1261
5,1,46,1,7,8,1464,260,111,19,95,0081523,279,1575
4,1,46,1,8,0,151,282,1011,26,-1,,308,1162
5,1,46,1,8,1,151,282,45,20,96,385,302,196
5,1,46,1,8,2,217,283,145,20,96,Southdown,303,362
5,1,46,1,8,3,380,284,66,19,96,Road,303,446
5,1,46,1,8,4,681,286,227,20,83,0000000104|385,306,908
5,1,46,1,8,5,930,288,147,19,96,Southdown,307,1077
5,1,46,1,8,6,1095,289,67,19,96,Road,308,1162
4,1,46,1,9,0,149,312,1060,30,-1,,342,1209
5,1,46,1,9,1,149,312,175,25,90,"Missisauga,",337,324
5,1,46,1,9,2,348,316,31,18,92,ON,334,379
5,1,46,1,9,3,397,316,95,18,19,L5d2y2,334,492
5,1,46,1,9,4,861,318,176,24,91,"Missisauga,",342,1037
5,1,46,1,9,5,1062,320,32,18,93,ON,338,1094
5,1,46,1,9,6,1112,320,97,19,39,L572Â¥2,339,1209
4,1,46,1,10,0,283,399,565,15,-1,,414,848
5,1,46,1,10,1,283,399,60,12,93,RELEASE,411,343
5,1,46,1,10,2,348,400,48,14,92,(C-of-A),414,396
5,1,46,1,10,3,401,400,59,11,95,NUMBER,411,460
5,1,46,1,10,4,571,401,78,11,95,CUSTOMER,412,649
5,1,46,1,10,5,654,402,76,11,96,PURCHASE,413,730
5,1,46,1,10,6,735,402,49,11,95,ORDER,413,784
5,1,46,1,10,7,789,402,59,12,95,NUMBER,414,848
4,1,46,1,11,0,621,416,190,11,-1,,427,811
5,1,46,1,11,1,621,416,17,10,95,No,426,638
5,1,46,1,11,2,642,416,18,11,95,DE,427,660
5,1,46,1,11,3,665,416,69,11,95,DEMANDE,427,734
5,1,46,1,11,4,739,416,18,11,94,DU,427,757
5,1,46,1,11,5,762,416,49,11,92,CLIENT,427,811
4,1,46,1,12,0,80,473,1337,18,-1,,491,1417
5,1,46,1,12,1,80,473,73,13,92,CARRIER,486,153
5,1,46,1,12,2,159,480,5,3,90,-,483,164
5,1,46,1,12,3,169,474,136,14,90,TRANSPORTEUR,488,305
5,1,46,1,12,4,736,474,70,14,96,VEHICLE,488,806
5,1,46,1,12,5,813,475,71,13,84,NUMBER,488,884
5,1,46,1,12,6,925,476,71,13,28,LICENSE,489,996
5,1,46,1,12,7,1002,476,70,14,96,NUMBER,490,1072
5,1,46,1,12,8,1134,476,79,14,96,ADDRESS,490,1213
5,1,46,1,12,9,1220,476,21,14,96,OF,490,1241
5,1,46,1,12,10,1248,477,57,13,96,METER,490,1305
5,1,46,1,12,11,1310,478,35,13,96,AND,491,1345
5,1,46,1,12,12,1350,478,67,13,96,TRADER,491,1417
4,1,46,1,13,0,150,497,1332,22,-1,,519,1482
5,1,46,1,13,1,150,499,113,17,95,PREMIER,516,263
5,1,46,1,13,2,281,500,64,17,96,BULK,517,345
5,1,46,1,13,3,364,500,112,18,96,SYSTEMS,518,476
5,1,46,1,13,4,580,500,112,19,96,5000234,519,692
5,1,46,1,13,5,710,488,15,35,92,|,523,725
5,1,46,1,13,6,740,497,136,14,88,NoDUVEHICULE,511,876
5,1,46,1,13,7,902,488,16,35,37,=,523,918
5,1,46,1,13,8,926,498,71,14,57,NOMBRE,512,997
5,1,46,1,13,9,1003,499,21,13,57,DE,512,1024
5,1,46,1,13,10,1031,499,62,13,81,PERMIS,512,1093
5,1,46,1,13,11,1101,488,6,35,91,|,523,1107
5,1,46,1,13,12,1120,499,91,13,74,L'ADRESSE,512,1211
5,1,46,1,13,13,1218,500,21,12,96,DE,512,1239
5,1,46,1,13,14,1246,500,57,13,95,METRE,513,1303
5,1,46,1,13,15,1309,500,20,13,95,ET,513,1329
5,1,46,1,13,16,1334,500,22,14,93,DE,514,1356
5,1,46,1,13,17,1362,500,120,14,92,COMMERCANT,514,1482
4,1,46,1,14,0,150,528,1325,29,-1,,557,1475
5,1,46,1,14,1,150,528,28,18,96,25,546,178
5,1,46,1,14,2,198,528,115,24,95,Gormley,552,313
5,1,46,1,14,3,332,529,160,19,96,Industrial,548,492
5,1,46,1,14,4,512,532,31,16,96,Dr,548,543
5,1,46,1,14,5,730,531,94,19,95,919322,550,824
5,1,46,1,14,6,1112,534,98,18,96,Suncor,552,1210
5,1,46,1,14,7,1229,536,99,21,95,Energy,557,1328
5,1,46,1,14,8,1346,534,129,20,96,Products,554,1475
4,1,46,1,15,0,149,555,1277,33,-1,,588,1426
5,1,46,1,15,1,149,555,114,33,96,GORMLEY,588,263
5,1,46,1,15,2,729,562,78,19,89,51202,581,807
5,1,46,1,15,3,1112,564,63,19,96,3275,583,1175
5,1,46,1,15,4,1194,564,117,20,95,Rebecca,584,1311
5,1,46,1,15,5,1330,566,96,18,96,Street,584,1426
4,1,46,1,16,0,155,620,203,21,-1,,641,358
5,1,46,1,16,1,155,620,68,21,51,(226),641,223
5,1,46,1,16,2,233,620,125,19,51,338-5962,639,358
4,1,46,1,17,0,989,664,618,34,-1,,698,1607
5,1,46,1,17,1,989,674,67,14,96,FACTOR,688,1056
5,1,46,1,17,2,1164,664,93,34,96,MEASURED,698,1257
5,1,46,1,17,3,1309,675,32,13,92,NET,688,1341
5,1,46,1,17,4,1347,675,57,13,92,LITRES,688,1404
5,1,46,1,17,5,1536,676,71,13,96,DENSITY,689,1607
4,1,46,1,18,0,80,679,1527,29,-1,,708,1607
5,1,46,1,18,1,80,679,142,14,81,PRODUCTIMETER,693,222
5,1,46,1,18,2,574,703,5,2,43,.,705,579
5,1,46,1,18,3,989,692,77,14,93,FACTEUR,706,1066
5,1,46,1,18,4,1178,693,57,14,96,LITRES,707,1235
5,1,46,1,18,5,1308,694,105,13,43,correcteD,707,1413
5,1,46,1,18,6,1442,687,61,12,0,|'EMPC,699,1503
5,1,46,1,18,7,1513,683,9,33,92,|,716,1522
5,1,46,1,18,8,1536,695,71,13,74,pensite,708,1607
4,1,46,1,19,0,66,695,1527,42,-1,,737,1593
5,1,46,1,19,1,66,727,6,3,87,|,730,72
5,1,46,1,19,2,84,706,131,24,86,PRODUIT/METER,730,215
5,1,46,1,19,3,371,695,80,13,0,BRS,708,451
5,1,46,1,19,4,458,695,111,14,28,Oe,709,569
5,1,46,1,19,5,496,691,18,41,11,On,732,514
5,1,46,1,19,6,527,695,42,14,6,TENS,709,569
5,1,46,1,19,7,586,696,140,13,0,DESCRIPTIONDU,709,726
5,1,46,1,19,8,733,697,73,13,29,PRODUIT,710,806
5,1,46,1,19,9,988,712,26,13,74,API,725,1014
5,1,46,1,19,10,1019,712,53,13,74,TABLE,725,1072
5,1,46,1,19,11,1164,712,93,14,93,MESUREES,726,1257
5,1,46,1,19,12,1268,730,18,7,3,|,737,1286
5,1,46,1,19,13,1333,713,62,14,65,TO15C,727,1395
5,1,46,1,19,14,1442,714,85,15,22,_|CELSIUSH,729,1527
5,1,46,1,19,15,1536,714,57,17,40,kg/cum,731,1593
4,1,46,1,20,0,150,741,1423,26,-1,,767,1573
5,1,46,1,20,1,150,741,94,19,88,103265,760,244
5,1,46,1,20,2,256,737,15,34,88,|,771,271
5,1,46,1,20,3,279,743,49,18,96,NOT,761,328
5,1,46,1,20,4,346,744,147,17,96,REGULATED,761,493
5,1,46,1,20,5,510,745,83,18,96,UNDER,763,593
5,1,46,1,20,6,611,745,49,18,96,TDG,763,660
5,1,46,1,20,7,979,746,94,19,93,0.9612,765,1073
5,1,46,1,20,8,1162,747,79,18,96,25001,765,1241
5,1,46,1,20,9,1312,747,79,19,96,24031,766,1391
5,1,46,1,20,10,1446,748,61,19,3,65.7,767,1507
5,1,46,1,20,11,1529,748,44,19,3,/913,767,1573
4,1,46,1,21,0,147,772,929,23,-1,,795,1076
5,1,46,1,21,1,147,772,96,19,92,MTR222,791,243
5,1,46,1,21,2,255,768,16,32,93,|,800,271
5,1,46,1,21,3,279,774,65,18,90,HVGO,792,344
5,1,46,1,21,4,959,778,48,17,92,API,795,1007
5,1,46,1,21,5,1029,777,47,18,85,54B,795,1076
4,1,46,1,22,0,149,833,1424,24,-1,,857,1573
5,1,46,1,22,1,149,833,94,18,93,103265,851,243
5,1,46,1,22,2,257,829,15,33,93,|,862,272
5,1,46,1,22,3,279,834,49,19,96,NOT,853,328
5,1,46,1,22,4,345,835,147,18,96,REGULATED,853,492
5,1,46,1,22,5,510,835,82,18,96,UNDER,853,592
5,1,46,1,22,6,610,836,49,19,96,TDG,855,659
5,1,46,1,22,7,979,837,94,18,95,0.9615,855,1073
5,1,46,1,22,8,1162,838,79,19,96,23000,857,1241
5,1,46,1,22,9,1312,838,79,19,96,22115,857,1391
5,1,46,1,22,10,1446,839,61,18,0,65.4,857,1507
5,1,46,1,22,11,1528,839,45,18,0,/913,857,1573
4,1,46,1,23,0,147,864,928,22,-1,,886,1075
5,1,46,1,23,1,147,864,96,18,90,MTR221,882,243
5,1,46,1,23,2,254,860,16,31,93,|,891,270
5,1,46,1,23,3,279,865,64,18,90,HVGO,883,343
5,1,46,1,23,4,959,869,48,17,93,API,886,1007
5,1,46,1,23,5,1028,868,47,18,90,54B,886,1075
4,1,46,1,24,0,637,984,100,43,-1,,1027,737
5,1,46,1,24,1,637,984,41,41,22,FE,1025,678
5,1,46,1,24,2,689,1000,48,27,22,TR,1027,737
4,1,46,1,25,0,688,1042,79,35,-1,,1077,767
5,1,46,1,25,1,688,1042,79,35,54,Date,1077,767
4,1,46,1,26,0,429,1078,399,54,-1,,1132,828
5,1,46,1,26,1,429,1078,59,34,40,Sn,1112,488
5,1,46,1,26,2,501,1104,12,3,40,-,1107,513
5,1,46,1,26,3,525,1082,125,41,46,"ESSA,",1123,650
5,1,46,1,26,4,684,1095,144,37,70,68-10-94,1132,828
4,1,46,1,27,0,530,1137,129,38,-1,,1175,659
5,1,46,1,27,1,530,1137,34,26,0,T.,1163,564
5,1,46,1,27,2,571,1148,58,24,21,dor,1172,629
5,1,46,1,27,3,636,1157,23,18,58,w,1175,659
4,1,46,1,28,0,935,1379,1,10,-1,,1389,936
5,1,46,1,28,1,935,1379,1,10,73,|,1389,936
4,1,46,1,29,0,311,1416,379,24,-1,,1440,690
5,1,46,1,29,1,311,1416,79,19,96,Total,1435,390
5,1,46,1,29,2,410,1416,97,20,95,Litres,1436,507
5,1,46,1,29,3,526,1417,34,23,96,by,1440,560
5,1,46,1,29,4,578,1418,112,18,96,Product,1436,690
4,1,46,1,30,0,280,1443,1110,34,-1,,1477,1390
5,1,46,1,30,1,280,1447,94,19,92,103265,1466,374
5,1,46,1,30,2,472,1443,70,34,89,HVGO,1477,542
5,1,46,1,30,3,1161,1450,79,19,96,48001,1469,1240
5,1,46,1,30,4,1310,1451,80,19,95,46146,1470,1390
4,1,46,1,31,0,63,1720,3,11,-1,,1731,66
5,1,46,1,31,1,63,1720,3,11,88,L,1731,66
4,1,46,1,32,0,64,1734,1507,30,-1,,1764,1571
5,1,46,1,32,1,64,1734,1,5,91,|,1739,65
5,1,46,1,32,2,82,1738,52,14,78,DRVER,1752,134
5,1,46,1,32,3,144,1739,205,13,78,SIGNATURE,1752,349
5,1,46,1,32,4,243,1724,10,55,78,-,1779,253
5,1,46,1,32,5,261,1734,88,18,43,SIGNATURE,1752,349
5,1,46,1,32,6,356,1740,22,12,64,DU,1752,378
5,1,46,1,32,7,384,1740,116,13,38,CONDUCTEUR,1753,500
5,1,46,1,32,8,864,1738,61,24,33,BRE,1762,925
5,1,46,1,32,9,1028,1752,27,11,0,oes,1763,1055
5,1,46,1,32,10,1056,1739,145,24,0,URS,1763,1201
5,1,46,1,32,11,1211,1725,20,55,59,|,1780,1231
5,1,46,1,32,12,1245,1739,149,24,5,RUPEE,1763,1394
5,1,46,1,32,13,1505,1740,66,24,50,a,1764,1571
4,1,46,1,33,0,64,1786,1491,22,-1,,1808,1555
5,1,46,1,33,1,64,1802,1,6,92,|,1808,65
5,1,46,1,33,2,860,1786,78,19,95,06:57,1805,938
5,1,46,1,33,3,1060,1787,79,19,94,06:59,1806,1139
5,1,46,1,33,4,1278,1787,77,19,94,07:15,1806,1355
5,1,46,1,33,5,1477,1788,78,19,94,07:15,1807,1555
4,1,46,1,34,0,63,1813,1509,36,-1,,1849,1572
5,1,46,1,34,1,63,1813,5,4,37,|,1817,68
5,1,46,1,34,2,77,1814,61,18,43,DRIVER,1832,138
5,1,46,1,34,3,144,1819,46,13,93,NAME,1832,190
5,1,46,1,34,4,196,1825,5,3,92,-,1828,201
5,1,46,1,34,5,206,1819,37,13,96,NOM,1832,243
5,1,46,1,34,6,250,1819,21,13,89,DU,1832,271
5,1,46,1,34,7,278,1819,116,14,89,CONDUCTEUR,1833,394
5,1,46,1,34,8,596,1820,61,14,92,DRIVER,1834,657
5,1,46,1,34,9,663,1821,71,27,18,NUVBER,1848,734
5,1,46,1,34,10,1216,1839,9,10,0,.,1849,1225
5,1,46,1,34,11,1283,1823,54,13,95,TOTAL,1836,1337
5,1,46,1,34,12,1342,1823,83,14,93,QUANTITY,1837,1425
5,1,46,1,34,13,1431,1830,5,2,89,-,1832,1436
5,1,46,1,34,14,1442,1823,61,14,91,QUANT.,1837,1503
5,1,46,1,34,15,1508,1823,64,14,92,TOTALE,1837,1572
4,1,46,1,35,0,582,1835,907,34,-1,,1869,1489
5,1,46,1,35,1,582,1835,19,13,79,Na,1848,601
5,1,46,1,35,2,608,1835,22,13,85,DU,1848,630
5,1,46,1,35,3,636,1835,135,14,57,CONDUCTEUR!*,1849,771
5,1,46,1,35,4,780,1838,93,22,96,Volume,1860,873
5,1,46,1,35,5,882,1839,113,22,96,corrected,1861,995
5,1,46,1,35,6,1006,1841,21,20,96,to,1861,1027
5,1,46,1,35,7,1038,1839,28,22,96,15,1861,1066
5,1,46,1,35,8,1076,1839,103,28,92,Degrees,1867,1179
5,1,46,1,35,9,1188,1839,19,22,90,C,1861,1207
5,1,46,1,35,10,1294,1850,79,18,96,48001,1868,1373
5,1,46,1,35,11,1392,1848,97,21,96,Litres,1869,1489
4,1,46,1,36,0,146,1877,1273,22,-1,,1899,1419
5,1,46,1,36,1,146,1877,163,18,91,GURLALDEEP,1895,309
5,1,46,1,36,2,346,1878,79,18,72,SINGH,1896,425
5,1,46,1,36,3,611,1878,127,19,96,56018353,1897,738
5,1,46,1,36,4,1294,1880,79,19,60,42131,1899,1373
5,1,46,1,36,5,1392,1880,27,19,60,kg,1899,1419
2,1,47,0,0,0,1628,133,6,1767,-1,,1900,1634
3,1,47,1,0,0,1628,133,6,1767,-1,,1900,1634
4,1,47,1,1,0,1628,133,6,1767,-1,,1900,1634
5,1,47,1,1,1,1628,133,6,1767,95, ,1900,1634
2,1,48,0,0,0,1419,1883,216,25,-1,,1908,1635
3,1,48,1,0,0,1419,1883,216,25,-1,,1908,1635
4,1,48,1,1,0,1419,1883,216,25,-1,,1908,1635
5,1,48,1,1,1,1419,1883,216,25,95,    ,1908,1635
2,1,49,0,0,0,1389,1913,81,44,-1,,1957,1470
3,1,49,1,0,0,1389,1913,81,44,-1,,1957,1470
4,1,49,1,1,0,1389,1913,81,11,-1,,1924,1470
5,1,49,1,1,1,1389,1913,46,11,95,AFTER,1924,1435
5,1,49,1,1,2,1439,1913,31,11,65,DIPS,1924,1470
4,1,49,1,2,0,1394,1930,68,10,-1,,1940,1462
5,1,49,1,2,1,1394,1930,47,10,70,APRES,1940,1441
5,1,49,1,2,2,1446,1930,16,10,96,LE,1940,1462
4,1,49,1,3,0,1394,1945,76,12,-1,,1957,1470
5,1,49,1,3,1,1394,1945,76,12,67,"JAUGEAGE,",1957,1470
2,1,50,0,0,0,1500,1913,109,44,-1,,1957,1609
3,1,50,1,0,0,1500,1913,109,44,-1,,1957,1609
4,1,50,1,1,0,1500,1913,109,12,-1,,1925,1609
5,1,50,1,1,1,1500,1913,53,11,96,ENDING,1924,1553
5,1,50,1,1,2,1558,1913,51,12,91,INVENT,1925,1609
4,1,50,1,2,0,1514,1930,82,11,-1,,1941,1596
5,1,50,1,2,1,1514,1930,82,11,91,INVENTAIRE,1941,1596
4,1,50,1,3,0,1528,1946,46,11,-1,,1957,1574
5,1,50,1,3,1,1528,1946,46,11,15,APRES,1957,1574
2,1,51,0,0,0,75,1956,1551,8,-1,,1964,1626
3,1,51,1,0,0,75,1956,1551,8,-1,,1964,1626
4,1,51,1,1,0,75,1956,1551,8,-1,,1964,1626
5,1,51,1,1,1,75,1956,1551,8,95, ,1964,1626
2,1,52,0,0,0,1486,1964,3,59,-1,,2023,1489
3,1,52,1,0,0,1486,1964,3,59,-1,,2023,1489
4,1,52,1,1,0,1486,1964,3,59,-1,,2023,1489
5,1,52,1,1,1,1486,1964,3,59,91,|,2023,1489
2,1,53,0,0,0,66,2018,1560,8,-1,,2026,1626
3,1,53,1,0,0,66,2018,1560,8,-1,,2026,1626
4,1,53,1,1,0,66,2018,1560,8,-1,,2026,1626
5,1,53,1,1,1,66,2018,1560,8,95, ,2026,1626
2,1,54,0,0,0,95,2080,1531,8,-1,,2088,1626
3,1,54,1,0,0,95,2080,1531,8,-1,,2088,1626
4,1,54,1,1,0,95,2080,1531,8,-1,,2088,1626
5,1,54,1,1,1,95,2080,1531,8,95, ,2088,1626
2,1,55,0,0,0,172,1902,4,238,-1,,2140,176
3,1,55,1,0,0,172,1902,4,238,-1,,2140,176
4,1,55,1,1,0,172,1902,4,238,-1,,2140,176
5,1,55,1,1,1,172,1902,4,238,95, ,2140,176
2,1,56,0,0,0,482,1903,3,238,-1,,2141,485
3,1,56,1,0,0,482,1903,3,238,-1,,2141,485
4,1,56,1,1,0,482,1903,3,238,-1,,2141,485
5,1,56,1,1,1,482,1903,3,238,95, ,2141,485
2,1,57,0,0,0,42,2162,344,17,-1,,2179,386
3,1,57,1,0,0,42,2162,344,17,-1,,2179,386
4,1,57,1,1,0,42,2162,344,17,-1,,2179,386
5,1,57,1,1,1,42,2162,10,13,92,A,2175,52
5,1,57,1,1,2,57,2162,53,13,96,Suncor,2175,110
5,1,57,1,1,3,115,2162,66,13,89,business,2175,181
5,1,57,1,1,4,186,2162,5,13,89,/,2175,191
5,1,57,1,1,5,196,2163,29,12,93,Une,2175,225
5,1,57,1,1,6,232,2163,73,16,60,entraprise,2179,305
5,1,57,1,1,7,311,2163,18,12,96,de,2175,329
5,1,57,1,1,8,334,2163,52,12,91,Suncor,2175,386
2,1,58,0,0,0,703,1904,4,238,-1,,2142,707
3,1,58,1,0,0,703,1904,4,238,-1,,2142,707
4,1,58,1,1,0,703,1904,4,238,-1,,2142,707
5,1,58,1,1,1,703,1904,4,238,95, ,2142,707
2,1,59,0,0,0,952,1904,4,238,-1,,2142,956
3,1,59,1,0,0,952,1904,4,238,-1,,2142,956
4,1,59,1,1,0,952,1904,4,238,-1,,2142,956
5,1,59,1,1,1,952,1904,4,238,95, ,2142,956
2,1,60,0,0,0,1264,1906,3,238,-1,,2144,1267
3,1,60,1,0,0,1264,1906,3,238,-1,,2144,1267
4,1,60,1,1,0,1264,1906,3,238,-1,,2144,1267
5,1,60,1,1,1,1264,1906,3,238,95, ,2144,1267
2,1,61,0,0,0,1153,1906,3,237,-1,,2143,1156
3,1,61,1,0,0,1153,1906,3,237,-1,,2143,1156
4,1,61,1,1,0,1153,1906,3,237,-1,,2143,1156
5,1,61,1,1,1,1153,1906,3,237,95, ,2143,1156
2,1,62,0,0,0,57,1908,1578,246,-1,,2154,1635
3,1,62,1,0,0,57,1908,1578,246,-1,,2154,1635
4,1,62,1,1,0,57,1908,1578,246,-1,,2154,1635
5,1,62,1,1,1,57,1908,1578,246,95, ,2154,1635
2,1,63,0,0,0,1375,1907,3,237,-1,,2144,1378
3,1,63,1,0,0,1375,1907,3,237,-1,,2144,1378
4,1,63,1,1,0,1375,1907,3,237,-1,,2144,1378
5,1,63,1,1,1,1375,1907,3,237,95, ,2144,1378
2,1,64,0,0,0,1554,2164,111,17,-1,,2181,1665
3,1,64,1,0,0,1554,2164,111,17,-1,,2181,1665
4,1,64,1,1,0,1554,2164,111,17,-1,,2181,1665
5,1,64,1,1,1,1554,2164,55,13,66,4112791,2177,1609
5,1,64,1,1,2,1614,2164,51,17,91,(05/17),2181,1665
1,1,0,0,0,0,0,0,1700,2200,-1,,2200,1700
2,1,1,0,0,0,911,78,613,24,-1,,102,1524
3,1,1,1,0,0,911,78,613,24,-1,,102,1524
4,1,1,1,1,0,911,78,613,24,-1,,102,1524
5,1,1,1,1,1,911,78,118,21,96,VEHICLE,99,1029
5,1,1,1,1,2,1040,78,122,22,96,LOADING,100,1162
5,1,1,1,1,3,1172,80,113,21,93,REPORT,101,1285
5,1,1,1,1,4,1283,74,14,38,92,-,112,1297
5,1,1,1,1,5,1312,80,55,21,96,BILL,101,1367
5,1,1,1,1,6,1377,80,35,21,92,OF,101,1412
5,1,1,1,1,7,1423,80,101,22,92,LADING,102,1524
2,1,2,0,0,0,816,104,812,26,-1,,130,1628
3,1,2,1,0,0,816,104,812,26,-1,,130,1628
4,1,2,1,1,0,816,104,812,26,-1,,130,1628
5,1,2,1,1,1,816,104,131,23,96,RAPPORT,127,947
5,1,2,1,1,2,958,106,35,21,91,DE,127,993
5,1,2,1,1,3,1003,106,196,22,91,CHARGEMENT,128,1199
5,1,2,1,1,4,1208,119,8,3,89,-,122,1216
5,1,2,1,1,5,1224,107,138,22,89,VEHICULE,129,1362
5,1,2,1,1,6,1371,120,9,3,91,-,123,1380
5,1,2,1,1,7,1389,108,239,22,91,CONNAISSEMENT,130,1628
2,1,3,0,0,0,76,111,1556,39,-1,,150,1632
3,1,3,1,0,0,76,111,1556,39,-1,,150,1632
4,1,3,1,1,0,76,111,1556,39,-1,,150,1632
5,1,3,1,1,1,76,111,1556,39,95, ,150,1632
2,1,4,0,0,0,752,129,11,92,-1,,221,763
3,1,4,1,0,0,752,129,11,92,-1,,221,763
4,1,4,1,1,0,752,129,11,35,-1,,164,763
5,1,4,1,1,1,752,129,11,35,95,  ,164,763
4,1,4,1,2,0,752,164,11,57,-1,,221,763
5,1,4,1,2,1,752,164,11,57,95,  ,221,763
2,1,5,0,0,0,480,130,1,75,-1,,205,481
3,1,5,1,0,0,480,130,1,75,-1,,205,481
4,1,5,1,1,0,480,130,1,75,-1,,205,481
5,1,5,1,1,1,480,130,1,75,95, ,205,481
2,1,6,0,0,0,821,219,647,17,-1,,236,1468
3,1,6,1,0,0,821,219,647,17,-1,,236,1468
4,1,6,1,1,0,821,219,647,17,-1,,236,1468
5,1,6,1,1,1,821,219,647,17,95, ,236,1468
2,1,7,0,0,0,84,215,588,16,-1,,231,672
3,1,7,1,0,0,84,215,588,16,-1,,231,672
4,1,7,1,1,0,84,215,588,16,-1,,231,672
5,1,7,1,1,1,84,215,588,16,95, ,231,672
2,1,8,0,0,0,669,221,20,67,-1,,288,689
3,1,8,1,0,0,669,221,20,67,-1,,288,689
4,1,8,1,1,0,669,221,20,27,-1,,248,689
5,1,8,1,1,1,669,221,20,27,95, ,248,689
4,1,8,1,2,0,669,248,10,40,-1,,288,679
5,1,8,1,2,1,669,248,10,40,95,   ,288,679
2,1,9,0,0,0,841,281,12,9,-1,,290,853
3,1,9,1,0,0,841,281,12,9,-1,,290,853
4,1,9,1,1,0,841,281,12,9,-1,,290,853
5,1,9,1,1,1,841,281,12,9,95,  ,290,853
2,1,10,0,0,0,272,392,579,15,-1,,407,851
3,1,10,1,0,0,272,392,579,15,-1,,407,851
4,1,10,1,1,0,272,392,579,15,-1,,407,851
5,1,10,1,1,1,272,392,579,15,95, ,407,851
2,1,11,0,0,0,65,104,1567,398,-1,,502,1632
3,1,11,1,0,0,65,104,1567,398,-1,,502,1632
4,1,11,1,1,0,69,104,456,27,-1,,131,525
5,1,11,1,1,1,69,125,6,2,0,_,127,75
5,1,11,1,1,2,150,105,74,23,95,Page:,128,224
5,1,11,1,1,3,248,104,13,19,69,1,123,261
5,1,11,1,1,4,480,106,45,25,96,530,131,525
4,1,11,1,2,0,139,133,534,25,-1,,158,673
5,1,11,1,2,1,139,134,108,15,90,DOCUMENT,149,247
5,1,11,1,2,2,254,136,82,14,77,NUMBER,150,336
5,1,11,1,2,3,364,136,60,18,77,1673,154,424
5,1,11,1,2,4,537,133,37,24,93,DATE,157,574
5,1,11,1,2,5,576,133,97,25,80,DEXPEDITION,158,673
4,1,11,1,3,0,138,152,172,16,-1,,168,310
5,1,11,1,3,1,138,152,12,15,96,No,167,150
5,1,11,1,3,2,169,153,24,14,96,DU,167,193
5,1,11,1,3,3,201,153,109,15,96,DOCUMENT,168,310
4,1,11,1,4,0,151,156,1459,44,-1,,200,1610
5,1,11,1,4,1,151,156,10,11,92,Â°,167,161
5,1,11,1,4,2,523,162,137,38,83,mm/dd/yy,200,660
5,1,11,1,4,3,800,170,29,21,95,24,191,829
5,1,11,1,4,4,840,170,79,21,93,HOUR,191,919
5,1,11,1,4,5,929,171,208,21,82,NUMBER_(403),192,1137
5,1,11,1,4,6,1147,170,127,18,87,296-3000,188,1274
5,1,11,1,4,7,1311,173,139,21,76,-NUMERO,194,1450
5,1,11,1,4,8,1459,174,29,20,95,24,194,1488
5,1,11,1,4,9,1499,174,111,21,95,HEURES,195,1610
4,1,11,1,5,0,150,193,1224,31,-1,,224,1374
5,1,11,1,5,1,150,193,110,20,96,0114758,213,260
5,1,11,1,5,2,281,194,93,20,96,10/002,214,374
5,1,11,1,5,3,530,196,128,20,95,10/08/24,216,658
5,1,11,1,5,4,1051,202,231,21,92,COLLECT,223,1282
5,1,11,1,5,5,1181,198,15,35,92,-,233,1196
5,1,11,1,5,6,1210,202,72,21,88,FRAIS,223,1282
5,1,11,1,5,7,1292,203,82,21,91,VIRES,224,1374
4,1,11,1,6,0,65,220,1549,36,-1,,256,1614
5,1,11,1,6,1,65,220,3,6,62,|,226,68
5,1,11,1,6,2,72,220,203,20,69,CONSIGNEE/CUSTOMER,240,275
5,1,11,1,6,3,281,234,5,2,92,-,236,286
5,1,11,1,6,4,292,227,182,14,91,DESTINATAIRE/CLIENT,241,474
5,1,11,1,6,5,689,240,16,11,95,No,251,705
5,1,11,1,6,6,710,226,127,30,49,D'ETABLISSEMENT,256,837
5,1,11,1,6,7,864,230,101,14,92,CONSIGNOR,244,965
5,1,11,1,6,8,970,238,6,2,91,-,240,976
5,1,11,1,6,9,982,231,105,14,91,EXPEDITEUR,245,1087
5,1,11,1,6,10,1466,244,17,11,93,No,255,1483
5,1,11,1,6,11,1488,244,126,12,80,D'ETABLISSEMENT,256,1614
4,1,11,1,7,0,65,249,1507,34,-1,,283,1572
5,1,11,1,7,1,65,249,2,10,96,|,259,67
5,1,11,1,7,2,147,254,181,24,96,Mississauga,278,328
5,1,11,1,7,3,346,256,80,19,96,Lubes,275,426
5,1,11,1,7,4,445,258,98,18,95,Center,276,543
5,1,11,1,7,5,680,258,160,20,91,0000081523,278,840
5,1,11,1,7,6,860,258,183,25,89,|Mississauga,283,1043
5,1,11,1,7,7,1061,260,81,20,96,Lubes,280,1142
5,1,11,1,7,8,1161,262,98,18,96,Center,280,1259
5,1,11,1,7,9,1463,262,109,20,96,0081523,282,1572
4,1,11,1,8,0,149,286,1011,25,-1,,311,1160
5,1,11,1,8,1,149,286,45,19,96,385,305,194
5,1,11,1,8,2,215,286,146,20,96,Southdown,306,361
5,1,11,1,8,3,378,287,66,20,96,Road,307,444
5,1,11,1,8,4,679,290,228,19,73,0000000104|385,309,907
5,1,11,1,8,5,928,291,148,19,96,Southdown,310,1076
5,1,11,1,8,6,1095,292,65,19,96,Road,311,1160
4,1,11,1,9,0,147,316,1059,29,-1,,345,1206
5,1,11,1,9,1,147,316,174,24,90,"Missisauga,",340,321
5,1,11,1,9,2,346,319,31,18,92,ON,337,377
5,1,11,1,9,3,395,318,95,20,39,L5J2yY2,338,490
5,1,11,1,9,4,860,320,176,25,91,"Missisauga,",345,1036
5,1,11,1,9,5,1061,323,33,18,93,ON,341,1094
5,1,11,1,9,6,1111,322,95,20,18,L5J2yÂ¥2,342,1206
4,1,11,1,10,0,280,402,525,28,-1,,430,805
5,1,11,1,10,1,280,402,61,11,92,RELEASE,413,341
5,1,11,1,10,2,347,402,47,14,73,(C-of-A),416,394
5,1,11,1,10,3,399,402,59,12,85,NUMBER,414,458
5,1,11,1,10,4,562,409,1,21,95,|,430,563
5,1,11,1,10,5,569,404,59,25,11,eT,429,628
5,1,11,1,10,6,644,404,15,25,23,DE,429,659
5,1,11,1,10,7,666,404,66,25,18,PEE,429,732
5,1,11,1,10,8,738,404,67,25,0,DUCie,429,805
4,1,11,1,11,0,735,453,897,49,-1,,502,1632
5,1,11,1,11,1,735,476,71,14,96,VEHICLE,490,806
5,1,11,1,11,2,812,476,71,14,65,"NUMBER,",490,883
5,1,11,1,11,3,924,477,71,14,95,LICENSE,491,995
5,1,11,1,11,4,1001,478,71,13,85,NUMBER,491,1072
5,1,11,1,11,5,1133,478,79,14,96,ADDRESS,492,1212
5,1,11,1,11,6,1218,478,21,14,96,OF,492,1239
5,1,11,1,11,7,1246,478,57,14,95,METER,492,1303
5,1,11,1,11,8,1308,479,34,13,96,AND,492,1342
5,1,11,1,11,9,1348,480,68,12,95,TRADER,492,1416
5,1,11,1,11,10,1625,453,7,49,38,|,502,1632
2,1,12,0,0,0,271,399,3,69,-1,,468,274
3,1,12,1,0,0,271,399,3,69,-1,,468,274
4,1,12,1,1,0,271,399,3,69,-1,,468,274
5,1,12,1,1,1,271,399,3,69,95, ,468,274
2,1,13,0,0,0,849,225,9,246,-1,,471,858
3,1,13,1,0,0,849,225,9,246,-1,,471,858
4,1,13,1,1,0,849,225,9,246,-1,,471,858
5,1,13,1,1,1,849,225,9,246,95, ,471,858
2,1,14,0,0,0,1449,229,4,63,-1,,292,1453
3,1,14,1,0,0,1449,229,4,63,-1,,292,1453
4,1,14,1,1,0,1449,229,4,63,-1,,292,1453
5,1,14,1,1,1,1449,229,4,63,95, ,292,1453
2,1,15,0,0,0,1450,288,182,7,-1,,295,1632
3,1,15,1,0,0,1450,288,182,7,-1,,295,1632
4,1,15,1,1,0,1450,288,182,7,-1,,295,1632
5,1,15,1,1,1,1450,288,182,7,95, ,295,1632
2,1,16,0,0,0,96,449,1533,41,-1,,490,1629
3,1,16,1,0,0,96,449,1533,41,-1,,490,1629
4,1,16,1,1,0,96,449,1533,41,-1,,490,1629
5,1,16,1,1,1,96,449,1533,41,95, ,490,1629
2,1,17,0,0,0,79,474,224,16,-1,,490,303
3,1,17,1,0,0,79,474,224,16,-1,,490,303
4,1,17,1,1,0,79,474,224,16,-1,,490,303
5,1,17,1,1,1,79,474,73,14,92,CARRIER,488,152
5,1,17,1,1,2,157,482,5,2,92,-,484,162
5,1,17,1,1,3,167,475,136,15,65,TRANSPORTEUR,490,303
2,1,18,0,0,0,149,500,541,22,-1,,522,690
3,1,18,1,0,0,149,500,541,22,-1,,522,690
4,1,18,1,1,0,149,500,541,22,-1,,522,690
5,1,18,1,1,1,149,500,128,18,95,SEABOARD,518,277
5,1,18,1,1,2,295,501,98,21,96,LIQUID,522,393
5,1,18,1,1,3,411,501,131,19,95,CARRIERS,520,542
5,1,18,1,1,4,579,501,111,19,95,0101317,520,690
2,1,19,0,0,0,478,581,237,8,-1,,589,715
3,1,19,1,0,0,478,581,237,8,-1,,589,715
4,1,19,1,1,0,478,581,237,8,-1,,589,715
5,1,19,1,1,1,478,581,237,8,95, ,589,715
2,1,20,0,0,0,711,471,7,194,-1,,665,718
3,1,20,1,0,0,711,471,7,194,-1,,665,718
4,1,20,1,1,0,711,471,7,194,-1,,665,718
5,1,20,1,1,1,711,471,7,194,95, ,665,718
2,1,21,0,0,0,739,498,136,14,-1,,512,875
3,1,21,1,0,0,739,498,136,14,-1,,512,875
4,1,21,1,1,0,739,498,136,14,-1,,512,875
5,1,21,1,1,1,739,499,20,13,96,No,512,759
5,1,21,1,1,2,764,498,23,14,91,DU,512,787
5,1,21,1,1,3,792,499,83,13,90,VEHICULE,512,875
2,1,22,0,0,0,924,500,556,15,-1,,515,1480
3,1,22,1,0,0,924,500,556,15,-1,,515,1480
4,1,22,1,1,0,924,500,556,15,-1,,515,1480
5,1,22,1,1,1,924,500,72,13,96,NOMBRE,513,996
5,1,22,1,1,2,1002,500,22,13,93,DE,513,1024
5,1,22,1,1,3,1031,500,62,14,92,PERMIS,514,1093
5,1,22,1,1,4,1097,496,10,27,85,|,523,1107
5,1,22,1,1,5,1119,500,90,14,85,L'ADRESSE,514,1209
5,1,22,1,1,6,1216,501,22,13,96,DE,514,1238
5,1,22,1,1,7,1244,501,57,13,96,METRE,514,1301
5,1,22,1,1,8,1308,502,19,12,95,ET,514,1327
5,1,22,1,1,9,1333,502,21,13,93,DE,515,1354
5,1,22,1,1,10,1360,502,120,13,93,COMMERCANT,515,1480
2,1,23,0,0,0,1099,471,8,195,-1,,666,1107
3,1,23,1,0,0,1099,471,8,195,-1,,666,1107
4,1,23,1,1,0,1099,471,8,195,-1,,666,1107
5,1,23,1,1,1,1099,471,8,195,95, ,666,1107
2,1,24,0,0,0,64,643,1567,41,-1,,684,1631
3,1,24,1,0,0,64,643,1567,41,-1,,684,1631
4,1,24,1,1,0,64,643,1567,41,-1,,684,1631
5,1,24,1,1,1,64,643,1567,41,95, ,684,1631
2,1,25,0,0,0,64,712,1564,41,-1,,753,1628
3,1,25,1,0,0,64,712,1564,41,-1,,753,1628
4,1,25,1,1,0,64,712,1564,41,-1,,753,1628
5,1,25,1,1,1,64,712,1564,41,95, ,753,1628
2,1,26,0,0,0,475,584,9,179,-1,,763,484
3,1,26,1,0,0,475,584,9,179,-1,,763,484
4,1,26,1,1,0,475,584,9,179,-1,,763,484
5,1,26,1,1,1,475,584,9,179,95, ,763,484
2,1,27,0,0,0,49,125,34,1264,-1,,1389,83
3,1,27,1,0,0,49,125,34,1264,-1,,1389,83
4,1,27,1,1,0,49,125,34,1264,-1,,1389,83
5,1,27,1,1,1,49,125,34,1264,95, ,1389,83
2,1,28,0,0,0,242,660,31,1075,-1,,1735,273
3,1,28,1,0,0,242,660,31,1075,-1,,1735,273
4,1,28,1,1,0,242,660,31,1075,-1,,1735,273
5,1,28,1,1,1,242,660,31,1075,95, ,1735,273
2,1,29,0,0,0,1502,666,33,1073,-1,,1739,1535
3,1,29,1,0,0,1502,666,33,1073,-1,,1739,1535
4,1,29,1,1,0,1502,666,33,1073,-1,,1739,1535
5,1,29,1,1,1,1502,666,33,1073,95, ,1739,1535
2,1,30,0,0,0,1420,666,32,1073,-1,,1739,1452
3,1,30,1,0,0,1420,666,32,1073,-1,,1739,1452
4,1,30,1,1,0,1420,666,32,1073,-1,,1739,1452
5,1,30,1,1,1,1420,666,32,1073,95, ,1739,1452
2,1,31,0,0,0,1267,665,32,1073,-1,,1738,1299
3,1,31,1,0,0,1267,665,32,1073,-1,,1738,1299
4,1,31,1,1,0,1267,665,32,1073,-1,,1738,1299
5,1,31,1,1,1,1267,665,32,1073,95, ,1738,1299
2,1,32,0,0,0,1113,664,34,1071,-1,,1735,1147
3,1,32,1,0,0,1113,664,34,1071,-1,,1735,1147
4,1,32,1,1,0,1113,664,34,1071,-1,,1735,1147
5,1,32,1,1,1,1113,664,34,1071,95, ,1735,1147
2,1,33,0,0,0,920,674,30,1063,-1,,1737,950
3,1,33,1,0,0,920,674,30,1063,-1,,1737,950
4,1,33,1,1,0,920,674,30,1063,-1,,1737,950
5,1,33,1,1,1,920,674,30,1063,95, ,1737,950
2,1,34,0,0,0,63,1713,1567,43,-1,,1756,1630
3,1,34,1,0,0,63,1713,1567,43,-1,,1756,1630
4,1,34,1,1,0,63,1713,1567,43,-1,,1756,1630
5,1,34,1,1,1,63,1713,1567,43,95, ,1756,1630
2,1,35,0,0,0,76,529,1530,1280,-1,,1809,1606
3,1,35,1,0,0,76,529,1530,1280,-1,,1809,1606
4,1,35,1,1,0,149,529,1325,29,-1,,558,1474
5,1,35,1,1,1,149,529,28,19,95,55,548,177
5,1,35,1,1,2,196,531,82,17,95,ARROW,548,278
5,1,35,1,1,3,295,531,31,17,96,RD,548,326
5,1,35,1,1,4,726,533,81,19,89,H1346,552,807
5,1,35,1,1,5,1112,536,96,18,96,Suncor,554,1208
5,1,35,1,1,6,1227,536,99,22,96,Energy,558,1326
5,1,35,1,1,7,1345,535,129,19,96,Products,554,1474
4,1,35,1,2,0,147,560,1277,25,-1,,585,1424
5,1,35,1,2,1,147,560,81,18,96,North,578,228
5,1,35,1,2,2,245,560,65,19,96,York,579,310
5,1,35,1,2,3,728,563,79,19,95,91328,582,807
5,1,35,1,2,4,1111,565,62,19,95,3275,584,1173
5,1,35,1,2,5,1193,566,116,18,95,Rebecca,584,1309
5,1,35,1,2,6,1328,567,96,18,96,Street,585,1424
4,1,35,1,3,0,146,590,525,27,-1,,617,671
5,1,35,1,3,1,146,590,50,19,86,MOM,609,196
5,1,35,1,3,2,214,591,44,19,89,2L4,610,258
5,1,35,1,3,3,488,591,40,25,15,CERF,616,528
5,1,35,1,3,4,534,591,17,25,37,SD,616,551
5,1,35,1,3,5,557,591,114,26,8,RANSPORTEUR,617,671
4,1,35,1,4,0,153,621,204,21,-1,,642,357
5,1,35,1,4,1,153,621,204,21,91,(416)642-0515,642,357
4,1,35,1,5,0,988,671,618,25,-1,,696,1606
5,1,35,1,5,1,988,674,67,14,96,FACTOR,688,1055
5,1,35,1,5,2,1163,671,92,25,93,MEASURED,696,1255
5,1,35,1,5,3,1308,676,32,12,92,NET,688,1340
5,1,35,1,5,4,1345,676,57,12,89,LITRES,688,1402
5,1,35,1,5,5,1535,677,71,12,96,DENSITY,689,1606
4,1,35,1,6,0,79,676,1526,36,-1,,712,1605
5,1,35,1,6,1,79,680,21,13,9,Me,693,100
5,1,35,1,6,2,120,676,101,36,0,deialiad,712,221
5,1,35,1,6,3,573,703,5,2,35,.,705,578
5,1,35,1,6,4,988,693,77,13,91,FACTEUR,706,1065
5,1,35,1,6,5,1176,693,57,14,95,LITRES,707,1233
5,1,35,1,6,6,1307,694,104,13,35,correcTeo,707,1411
5,1,35,1,6,7,1440,687,62,12,85,|TEMPC,699,1502
5,1,35,1,6,8,1510,682,12,35,90,|,717,1522
5,1,35,1,6,9,1535,695,70,13,0,Censite,708,1605
4,1,35,1,7,0,79,695,1512,43,-1,,738,1591
5,1,35,1,7,1,79,696,135,35,60,PRODUIT/METER,731,214
5,1,35,1,7,2,370,695,80,14,27,BSI,709,450
5,1,35,1,7,3,457,696,53,13,0,DESSS,709,510
5,1,35,1,7,4,527,696,40,13,44,HON,709,567
5,1,35,1,7,5,585,696,111,14,28,DESSRISTION,710,696
5,1,35,1,7,6,703,697,102,13,26,DUFHODUTT,710,805
5,1,35,1,7,7,987,712,26,13,25,API,725,1013
5,1,35,1,7,8,1019,712,52,13,25,TABLE,725,1071
5,1,35,1,7,9,1163,713,91,14,91,MESUREES,727,1254
5,1,35,1,7,10,1331,713,63,14,46,TOISC,727,1394
5,1,35,1,7,11,1410,702,14,40,20,â,742,1424
5,1,35,1,7,12,1440,714,86,24,43,|CELSIUSG,738,1526
5,1,35,1,7,13,1534,714,57,17,43,kg/cum,731,1591
4,1,35,1,8,0,149,737,1423,31,-1,,768,1572
5,1,35,1,8,1,149,742,92,19,95,103265,761,241
5,1,35,1,8,2,255,738,15,34,95,|,772,270
5,1,35,1,8,3,278,744,48,19,96,NOT,763,326
5,1,35,1,8,4,344,745,148,18,96,REGULATED,763,492
5,1,35,1,8,5,510,746,82,17,95,UNDER,763,592
5,1,35,1,8,6,609,746,49,19,96,TDG,765,658
5,1,35,1,8,7,935,737,1,13,77,|,750,936
5,1,35,1,8,8,978,747,95,19,95,0.9619,766,1073
5,1,35,1,8,9,1161,748,78,19,96,24999,767,1239
5,1,35,1,8,10,1310,748,79,19,95,24047,767,1389
5,1,35,1,8,11,1445,749,61,18,11,64.8,767,1506
5,1,35,1,8,12,1528,749,44,19,11,/913,768,1572
4,1,35,1,9,0,145,774,930,23,-1,,797,1075
5,1,35,1,9,1,145,774,96,19,92,MTR222,793,241
5,1,35,1,9,2,255,770,14,32,92,|,802,269
5,1,35,1,9,3,278,775,64,18,89,HVGO,793,342
5,1,35,1,9,4,958,779,49,18,83,API,797,1007
5,1,35,1,9,5,1028,778,47,19,43,543,797,1075
4,1,35,1,10,0,148,835,1423,26,-1,,861,1571
5,1,35,1,10,1,148,835,93,20,96,103265,855,241
5,1,35,1,10,2,256,831,15,33,95,|,864,271
5,1,35,1,10,3,277,837,49,18,95,NOT,855,326
5,1,35,1,10,4,344,838,148,18,95,REGULATED,856,492
5,1,35,1,10,5,509,839,83,17,96,UNDER,856,592
5,1,35,1,10,6,609,839,49,18,96,TDG,857,658
5,1,35,1,10,7,978,839,95,19,95,0.9621,858,1073
5,1,35,1,10,8,1161,840,78,19,96,24999,859,1239
5,1,35,1,10,9,1310,841,78,19,96,24052,860,1388
5,1,35,1,10,10,1445,841,61,19,5,64.5,860,1506
5,1,35,1,10,11,1527,842,44,19,5,/913,861,1571
4,1,35,1,11,0,145,866,930,23,-1,,889,1075
5,1,35,1,11,1,145,866,96,19,91,MTR221,885,241
5,1,35,1,11,2,253,862,14,32,92,|,894,267
5,1,35,1,11,3,277,868,65,18,91,HVGO,886,342
5,1,35,1,11,4,958,872,48,17,87,API,889,1006
5,1,35,1,11,5,1028,871,47,18,64,54B,889,1075
4,1,35,1,12,0,311,1418,378,24,-1,,1442,689
5,1,35,1,12,1,311,1419,79,19,94,Total,1438,390
5,1,35,1,12,2,410,1418,97,20,96,Litres,1438,507
5,1,35,1,12,3,526,1420,33,22,96,by,1442,559
5,1,35,1,12,4,577,1420,112,19,96,Product,1439,689
4,1,35,1,13,0,280,1449,1108,22,-1,,1471,1388
5,1,35,1,13,1,280,1449,93,19,96,103265,1468,373
5,1,35,1,13,2,476,1451,65,18,91,HVGO,1469,541
5,1,35,1,13,3,1160,1452,80,19,95,49998,1471,1240
5,1,35,1,13,4,1310,1452,78,19,96,48099,1471,1388
4,1,35,1,14,0,76,1740,1495,26,-1,,1766,1571
5,1,35,1,14,1,76,1740,61,13,95,DRIVER,1753,137
5,1,35,1,14,2,144,1740,95,14,93,SIGNATURE,1754,239
5,1,35,1,14,3,244,1748,5,2,92,-,1750,249
5,1,35,1,14,4,254,1740,95,14,94,SIGNATURE,1754,349
5,1,35,1,14,5,356,1742,21,12,93,DU,1754,377
5,1,35,1,14,6,384,1742,117,13,92,CONDUCTEUR,1755,501
5,1,35,1,14,7,864,1740,60,25,7,ARRIVE,1765,924
5,1,35,1,14,8,1028,1740,73,25,9,DEBUTDU,1765,1101
5,1,35,1,14,9,1102,1740,99,25,60,CHARGEMENT,1765,1201
5,1,35,1,14,10,1210,1736,11,40,93,|,1776,1221
5,1,35,1,14,11,1245,1740,22,25,37,FIN,1765,1267
5,1,35,1,14,12,1268,1740,125,26,52,DUCHARGEMENT,1766,1393
5,1,35,1,14,13,1505,1741,66,25,47,Dear,1766,1571
4,1,35,1,15,0,860,1788,695,21,-1,,1809,1555
5,1,35,1,15,1,860,1788,77,19,94,07:13,1807,937
5,1,35,1,15,2,1060,1789,78,18,88,07:17,1807,1138
5,1,35,1,15,3,1277,1790,78,18,95,07:34,1808,1355
5,1,35,1,15,4,1477,1790,78,19,95,07:34,1809,1555
2,1,36,0,0,0,1210,1736,4,86,-1,,1822,1214
3,1,36,1,0,0,1210,1736,4,86,-1,,1822,1214
4,1,36,1,1,0,1210,1736,4,86,-1,,1822,1214
5,1,36,1,1,1,1210,1736,4,86,95, ,1822,1214
2,1,37,0,0,0,1002,1736,4,84,-1,,1820,1006
3,1,37,1,0,0,1002,1736,4,84,-1,,1820,1006
4,1,37,1,1,0,1002,1736,4,84,-1,,1820,1006
5,1,37,1,1,1,1002,1736,4,84,95, ,1820,1006
2,1,38,0,0,0,82,1797,1548,43,-1,,1840,1630
3,1,38,1,0,0,82,1797,1548,43,-1,,1840,1630
4,1,38,1,1,0,82,1797,1548,43,-1,,1840,1630
5,1,38,1,1,1,82,1797,1548,43,95, ,1840,1630
2,1,39,0,0,0,76,1820,318,15,-1,,1835,394
3,1,39,1,0,0,76,1820,318,15,-1,,1835,394
4,1,39,1,1,0,76,1820,318,15,-1,,1835,394
5,1,39,1,1,1,76,1820,61,14,96,DRIVER,1834,137
5,1,39,1,1,2,144,1821,46,13,93,NAME,1834,190
5,1,39,1,1,3,195,1828,5,2,92,-,1830,200
5,1,39,1,1,4,206,1820,37,14,96,NOM,1834,243
5,1,39,1,1,5,250,1821,21,14,92,DU,1835,271
5,1,39,1,1,6,277,1822,117,13,90,CONDUCTEUR,1835,394
2,1,40,0,0,0,714,1911,108,46,-1,,1957,822
3,1,40,1,0,0,714,1911,108,46,-1,,1957,822
4,1,40,1,1,0,714,1911,108,12,-1,,1923,822
5,1,40,1,1,1,714,1911,53,12,96,ENDING,1923,767
5,1,40,1,1,2,772,1912,50,11,96,INVENT,1923,822
4,1,40,1,2,0,728,1929,83,12,-1,,1941,811
5,1,40,1,2,1,728,1929,83,12,12,INVENTAIRE.,1941,811
4,1,40,1,3,0,744,1945,47,12,-1,,1957,791
5,1,40,1,3,1,744,1945,47,12,91,APRES,1957,791
2,1,41,0,0,0,490,1911,197,48,-1,,1959,687
3,1,41,1,0,0,490,1911,197,48,-1,,1959,687
4,1,41,1,1,0,490,1911,197,12,-1,,1923,687
5,1,41,1,1,1,490,1911,55,12,89,BEFORE,1923,545
5,1,41,1,1,2,550,1911,31,12,89,DIPS,1923,581
5,1,41,1,1,3,590,1907,8,24,94,|,1931,598
5,1,41,1,1,4,606,1911,45,12,95,AFTER,1923,651
5,1,41,1,1,5,656,1911,31,12,89,DIPS,1923,687
4,1,41,1,2,0,503,1928,178,12,-1,,1940,681
5,1,41,1,2,1,503,1928,46,11,96,AVANT,1939,549
5,1,41,1,2,2,554,1928,15,11,96,LE,1939,569
5,1,41,1,2,3,614,1928,46,11,90,APRES,1939,660
5,1,41,1,2,4,665,1928,16,12,92,LE,1940,681
4,1,41,1,3,0,500,1945,187,14,-1,,1959,687
5,1,41,1,3,1,500,1945,75,12,89,JAUGEAGE,1957,575
5,1,41,1,3,2,593,1957,2,2,65,|,1959,595
5,1,41,1,3,3,612,1945,75,12,66,JAUGEAGE,1957,687
2,1,42,0,0,0,376,1910,101,46,-1,,1956,477
3,1,42,1,0,0,376,1910,101,46,-1,,1956,477
4,1,42,1,1,0,376,1910,101,12,-1,,1922,477
5,1,42,1,1,1,376,1910,49,12,79,WATER,1922,425
5,1,42,1,1,2,430,1911,47,11,89,DIPICM,1922,477
4,1,42,1,2,0,394,1927,67,12,-1,,1939,461
5,1,42,1,2,1,394,1927,67,12,64,MEASURE.,1939,461
4,1,42,1,3,0,396,1944,63,12,-1,,1956,459
5,1,42,1,3,1,396,1944,63,12,81,DEAUICM,1956,459
2,1,43,0,0,0,224,1910,110,45,-1,,1955,334
3,1,43,1,0,0,224,1910,110,45,-1,,1955,334
4,1,43,1,1,0,224,1910,110,11,-1,,1921,334
5,1,43,1,1,1,224,1910,37,11,85,TANK,1921,261
5,1,43,1,1,2,266,1910,68,11,95,CAPACITY,1921,334
4,1,43,1,2,0,228,1927,95,12,-1,,1939,323
5,1,43,1,2,1,228,1927,95,12,90,CONTENANCE,1939,323
4,1,43,1,3,0,225,1944,104,11,-1,,1955,329
5,1,43,1,3,1,225,1944,18,11,93,OU,1955,243
5,1,43,1,3,2,249,1944,80,11,91,RESERVIOR,1955,329
2,1,44,0,0,0,84,1909,68,28,-1,,1937,152
3,1,44,1,0,0,84,1909,68,28,-1,,1937,152
4,1,44,1,1,0,84,1909,68,12,-1,,1921,152
5,1,44,1,1,1,84,1909,68,12,96,PRODUCT,1921,152
4,1,44,1,2,0,88,1926,61,11,-1,,1937,149
5,1,44,1,2,1,88,1926,61,11,96,PRODUIT,1937,149
2,1,45,0,0,0,762,1840,463,28,-1,,1868,1225
3,1,45,1,0,0,762,1840,463,28,-1,,1868,1225
4,1,45,1,1,0,762,1840,463,28,-1,,1868,1225
5,1,45,1,1,1,762,1840,9,9,92,*,1849,771
5,1,45,1,1,2,780,1840,92,22,96,Volume,1862,872
5,1,45,1,1,3,882,1840,113,22,95,corrected,1862,995
5,1,45,1,1,4,1005,1842,22,21,96,to,1863,1027
5,1,45,1,1,5,1038,1841,27,22,96,15,1863,1065
5,1,45,1,1,6,1076,1841,102,27,93,Degrees,1868,1178
5,1,45,1,1,7,1188,1841,18,23,75,C,1864,1206
5,1,45,1,1,8,1216,1841,9,9,75,*,1850,1225
2,1,46,0,0,0,1283,1824,288,78,-1,,1902,1571
3,1,46,1,0,0,1283,1824,288,78,-1,,1902,1571
4,1,46,1,1,0,1283,1824,288,15,-1,,1839,1571
5,1,46,1,1,1,1283,1824,54,14,96,TOTAL,1838,1337
5,1,46,1,1,2,1342,1825,83,14,93,QUANTITY,1839,1425
5,1,46,1,1,3,1430,1832,5,2,92,-,1834,1435
5,1,46,1,1,4,1441,1825,61,14,91,QUANT.,1839,1502
5,1,46,1,1,5,1508,1825,63,14,91,TOTALE,1839,1571
4,1,46,1,2,0,1293,1851,80,19,-1,,1870,1373
5,1,46,1,2,1,1293,1851,80,19,96,49998,1870,1373
4,1,46,1,3,0,1293,1882,79,20,-1,,1902,1372
5,1,46,1,3,1,1293,1882,79,20,89,43914,1902,1372
2,1,47,0,0,0,1278,1914,93,45,-1,,1959,1371
3,1,47,1,0,0,1278,1914,93,45,-1,,1959,1371
4,1,47,1,1,0,1278,1914,93,11,-1,,1925,1371
5,1,47,1,1,1,1278,1914,56,11,96,BEFORE,1925,1334
5,1,47,1,1,2,1339,1914,32,11,89,DIPS,1925,1371
4,1,47,1,2,0,1286,1931,67,11,-1,,1942,1353
5,1,47,1,2,1,1286,1931,47,11,85,AVANT,1942,1333
5,1,47,1,2,2,1337,1931,16,11,85,LE,1942,1353
4,1,47,1,3,0,1284,1947,75,12,-1,,1959,1359
5,1,47,1,3,1,1284,1947,75,12,92,JAUGEAGE,1959,1359
2,1,48,0,0,0,1605,135,50,1768,-1,,1903,1655
3,1,48,1,0,0,1605,135,50,1768,-1,,1903,1655
4,1,48,1,1,0,1605,135,50,1768,-1,,1903,1655
5,1,48,1,1,1,1605,135,50,1768,95, ,1903,1655
2,1,49,0,0,0,1500,1914,107,45,-1,,1959,1607
3,1,49,1,0,0,1500,1914,107,45,-1,,1959,1607
4,1,49,1,1,0,1500,1914,107,12,-1,,1926,1607
5,1,49,1,1,1,1500,1914,53,11,96,ENDING,1925,1553
5,1,49,1,1,2,1558,1914,49,12,96,INVENT,1926,1607
4,1,49,1,2,0,1514,1931,82,12,-1,,1943,1596
5,1,49,1,2,1,1514,1931,82,12,3,"INVENTAIRE,",1943,1596
4,1,49,1,3,0,1527,1948,46,11,-1,,1959,1573
5,1,49,1,3,1,1527,1948,46,11,92,APRES,1959,1573
2,1,50,0,0,0,1388,1914,81,45,-1,,1959,1469
3,1,50,1,0,0,1388,1914,81,45,-1,,1959,1469
4,1,50,1,1,0,1388,1914,81,11,-1,,1925,1469
5,1,50,1,1,1,1388,1914,46,11,95,AFTER,1925,1434
5,1,50,1,1,2,1438,1914,31,11,77,DIPS,1925,1469
4,1,50,1,2,0,1394,1931,67,12,-1,,1943,1461
5,1,50,1,2,1,1394,1931,47,12,91,APRES,1943,1441
5,1,50,1,2,2,1446,1931,15,12,91,LE,1943,1461
4,1,50,1,3,0,1394,1948,75,11,-1,,1959,1469
5,1,50,1,3,1,1394,1948,75,11,91,JAUGEAGE,1959,1469
2,1,51,0,0,0,1158,1913,102,46,-1,,1959,1260
3,1,51,1,0,0,1158,1913,102,46,-1,,1959,1260
4,1,51,1,1,0,1158,1913,102,12,-1,,1925,1260
5,1,51,1,1,1,1158,1913,50,12,93,WATER,1925,1208
5,1,51,1,1,2,1212,1913,48,12,29,DIP/CM.,1925,1260
4,1,51,1,2,0,1172,1930,69,11,-1,,1941,1241
5,1,51,1,2,1,1172,1930,69,11,54,MEASURE.,1941,1241
4,1,51,1,3,0,1176,1947,63,12,-1,,1959,1239
5,1,51,1,3,1,1176,1947,63,12,79,DEAU/CM,1959,1239
2,1,52,0,0,0,1005,1913,110,45,-1,,1958,1115
3,1,52,1,0,0,1005,1913,110,45,-1,,1958,1115
4,1,52,1,1,0,1005,1913,110,12,-1,,1925,1115
5,1,52,1,1,1,1005,1913,37,11,79,TANK,1924,1042
5,1,52,1,1,2,1046,1913,69,12,96,CAPACITY,1925,1115
4,1,52,1,2,0,1008,1930,97,11,-1,,1941,1105
5,1,52,1,2,1,1008,1930,97,11,43,CONTENANCE,1941,1105
4,1,52,1,3,0,1006,1947,105,11,-1,,1958,1111
5,1,52,1,3,1,1006,1947,19,10,92,DU,1957,1025
5,1,52,1,3,2,1030,1947,81,11,80,RESERVIOR,1958,1111
2,1,53,0,0,0,867,1912,68,29,-1,,1941,935
3,1,53,1,0,0,867,1912,68,29,-1,,1941,935
4,1,53,1,1,0,867,1912,68,11,-1,,1923,935
5,1,53,1,1,1,867,1912,68,11,96,PRODUCT,1923,935
4,1,53,1,2,0,870,1929,61,12,-1,,1941,931
5,1,53,1,2,1,870,1929,61,12,96,PRODUIT,1941,931
2,1,54,0,0,0,66,1941,1558,42,-1,,1983,1624
3,1,54,1,0,0,66,1941,1558,42,-1,,1983,1624
4,1,54,1,1,0,66,1941,1558,42,-1,,1983,1624
5,1,54,1,1,1,66,1941,1558,42,95, ,1983,1624
2,1,55,0,0,0,71,2003,1555,43,-1,,2046,1626
3,1,55,1,0,0,71,2003,1555,43,-1,,2046,1626
4,1,55,1,1,0,71,2003,1555,43,-1,,2046,1626
5,1,55,1,1,1,71,2003,1555,43,95, ,2046,1626
2,1,56,0,0,0,66,2064,1559,43,-1,,2107,1625
3,1,56,1,0,0,66,2064,1559,43,-1,,2107,1625
4,1,56,1,1,0,66,2064,1559,43,-1,,2107,1625
5,1,56,1,1,1,66,2064,1559,43,95, ,2107,1625
2,1,57,0,0,0,480,1905,6,236,-1,,2141,486
3,1,57,1,0,0,480,1905,6,236,-1,,2141,486
4,1,57,1,1,0,480,1905,6,236,-1,,2141,486
5,1,57,1,1,1,480,1905,6,236,95, ,2141,486
2,1,58,0,0,0,369,1904,7,238,-1,,2142,376
3,1,58,1,0,0,369,1904,7,238,-1,,2142,376
4,1,58,1,1,0,369,1904,7,238,-1,,2142,376
5,1,58,1,1,1,369,1904,7,238,95, ,2142,376
2,1,59,0,0,0,170,1904,8,238,-1,,2142,178
3,1,59,1,0,0,170,1904,8,238,-1,,2142,178
4,1,59,1,1,0,170,1904,8,238,-1,,2142,178
5,1,59,1,1,1,170,1904,8,238,95, ,2142,178
2,1,60,0,0,0,41,2159,345,16,-1,,2175,386
3,1,60,1,0,0,41,2159,345,16,-1,,2175,386
4,1,60,1,1,0,41,2159,345,16,-1,,2175,386
5,1,60,1,1,1,41,2159,11,13,95,A,2172,52
5,1,60,1,1,2,57,2159,53,14,95,Suncor,2173,110
5,1,60,1,1,3,115,2159,66,14,93,business,2173,181
5,1,60,1,1,4,186,2159,5,14,93,/,2173,191
5,1,60,1,1,5,196,2159,29,14,93,Une,2173,225
5,1,60,1,1,6,231,2160,74,15,93,entreprise,2175,305
5,1,60,1,1,7,311,2160,18,14,95,de,2174,329
5,1,60,1,1,8,334,2160,52,14,95,Suncor,2174,386
2,1,61,0,0,0,57,1819,1578,336,-1,,2155,1635
3,1,61,1,0,0,57,1819,1578,336,-1,,2155,1635
4,1,61,1,1,0,57,1819,1578,336,-1,,2155,1635
5,1,61,1,1,1,57,1819,1578,336,95, ,2155,1635
2,1,62,0,0,0,1483,1908,8,237,-1,,2145,1491
3,1,62,1,0,0,1483,1908,8,237,-1,,2145,1491
4,1,62,1,1,0,1483,1908,8,237,-1,,2145,1491
5,1,62,1,1,1,1483,1908,8,237,95, ,2145,1491
2,1,63,0,0,0,1374,1908,6,237,-1,,2145,1380
3,1,63,1,0,0,1374,1908,6,237,-1,,2145,1380
4,1,63,1,1,0,1374,1908,6,237,-1,,2145,1380
5,1,63,1,1,1,1374,1908,6,237,95, ,2145,1380
2,1,64,0,0,0,1150,1907,8,237,-1,,2144,1158
3,1,64,1,0,0,1150,1907,8,237,-1,,2144,1158
4,1,64,1,1,0,1150,1907,8,237,-1,,2144,1158
5,1,64,1,1,1,1150,1907,8,237,95, ,2144,1158
2,1,65,0,0,0,1262,1908,7,237,-1,,2145,1269
3,1,65,1,0,0,1262,1908,7,237,-1,,2145,1269
4,1,65,1,1,0,1262,1908,7,237,-1,,2145,1269
5,1,65,1,1,1,1262,1908,7,237,95, ,2145,1269
2,1,66,0,0,0,951,1907,6,237,-1,,2144,957
3,1,66,1,0,0,951,1907,6,237,-1,,2144,957
4,1,66,1,1,0,951,1907,6,237,-1,,2144,957
5,1,66,1,1,1,951,1907,6,237,95, ,2144,957
2,1,67,0,0,0,1554,2161,111,17,-1,,2178,1665
3,1,67,1,0,0,1554,2161,111,17,-1,,2178,1665
4,1,67,1,1,0,1554,2161,111,17,-1,,2178,1665
5,1,67,1,1,1,1554,2161,54,13,32,11279L,2174,1608
5,1,67,1,1,2,1614,2161,51,17,96,(05/17),2178,1665
1,1,0,0,0,0,0,0,1700,2200,-1,,2200,1700
2,1,1,0,0,0,551,30,202,47,-1,,77,753
3,1,1,1,0,0,551,30,202,47,-1,,77,753
4,1,1,1,1,0,551,30,202,47,-1,,77,753
5,1,1,1,1,1,551,31,36,41,52,2,72,587
5,1,1,1,1,2,602,30,151,47,52,4090497,77,753
2,1,2,0,0,0,912,78,612,24,-1,,102,1524
3,1,2,1,0,0,912,78,612,24,-1,,102,1524
4,1,2,1,1,0,912,78,612,24,-1,,102,1524
5,1,2,1,1,1,912,78,117,22,95,VEHICLE,100,1029
5,1,2,1,1,2,1040,78,122,22,95,LOADING,100,1162
5,1,2,1,1,3,1172,79,114,22,93,REPORT,101,1286
5,1,2,1,1,4,1294,92,9,3,93,-,95,1303
5,1,2,1,1,5,1313,80,55,21,95,BILL,101,1368
5,1,2,1,1,6,1377,80,36,21,93,OF,101,1413
5,1,2,1,1,7,1424,80,100,22,92,LADING,102,1524
2,1,3,0,0,0,73,123,1560,17,-1,,140,1633
3,1,3,1,0,0,73,123,1560,17,-1,,140,1633
4,1,3,1,1,0,73,123,1560,17,-1,,140,1633
5,1,3,1,1,1,73,123,1560,17,95, ,140,1633
2,1,4,0,0,0,822,225,810,10,-1,,235,1632
3,1,4,1,0,0,822,225,810,10,-1,,235,1632
4,1,4,1,1,0,822,225,810,10,-1,,235,1632
5,1,4,1,1,1,822,225,810,10,95, ,235,1632
2,1,5,0,0,0,65,222,633,9,-1,,231,698
3,1,5,1,0,0,65,222,633,9,-1,,231,698
4,1,5,1,1,0,65,222,633,9,-1,,231,698
5,1,5,1,1,1,65,222,633,9,95, ,231,698
2,1,6,0,0,0,1450,230,2,62,-1,,292,1452
3,1,6,1,0,0,1450,230,2,62,-1,,292,1452
4,1,6,1,1,0,1450,230,2,62,-1,,292,1452
5,1,6,1,1,1,1450,230,2,62,95, ,292,1452
2,1,7,0,0,0,673,227,2,63,-1,,290,675
3,1,7,1,0,0,673,227,2,63,-1,,290,675
4,1,7,1,1,0,673,227,2,63,-1,,290,675
5,1,7,1,1,1,673,227,2,63,95, ,290,675
2,1,8,0,0,0,1451,290,181,3,-1,,293,1632
3,1,8,1,0,0,1451,290,181,3,-1,,293,1632
4,1,8,1,1,0,1451,290,181,3,-1,,293,1632
5,1,8,1,1,1,1451,290,181,3,95, ,293,1632
2,1,9,0,0,0,673,287,181,4,-1,,291,854
3,1,9,1,0,0,673,287,181,4,-1,,291,854
4,1,9,1,1,0,673,287,181,4,-1,,291,854
5,1,9,1,1,1,673,287,181,4,95, ,291,854
2,1,10,0,0,0,272,397,582,7,-1,,404,854
3,1,10,1,0,0,272,397,582,7,-1,,404,854
4,1,10,1,1,0,272,397,582,7,-1,,404,854
5,1,10,1,1,1,272,397,582,7,95, ,404,854
2,1,11,0,0,0,851,228,5,243,-1,,471,856
3,1,11,1,0,0,851,228,5,243,-1,,471,856
4,1,11,1,1,0,851,228,5,243,-1,,471,856
5,1,11,1,1,1,851,228,5,243,95, ,471,856
2,1,12,0,0,0,271,399,3,70,-1,,469,274
3,1,12,1,0,0,271,399,3,70,-1,,469,274
4,1,12,1,1,0,271,399,3,70,-1,,469,274
5,1,12,1,1,1,271,399,3,70,95, ,469,274
2,1,13,0,0,0,98,462,1534,16,-1,,478,1632
3,1,13,1,0,0,98,462,1534,16,-1,,478,1632
4,1,13,1,1,0,98,462,1534,16,-1,,478,1632
5,1,13,1,1,1,98,462,1534,16,95, ,478,1632
2,1,14,0,0,0,479,584,237,5,-1,,589,716
3,1,14,1,0,0,479,584,237,5,-1,,589,716
4,1,14,1,1,0,479,584,237,5,-1,,589,716
5,1,14,1,1,1,479,584,237,5,95, ,589,716
2,1,15,0,0,0,713,469,4,194,-1,,663,717
3,1,15,1,0,0,713,469,4,194,-1,,663,717
4,1,15,1,1,0,713,469,4,194,-1,,663,717
5,1,15,1,1,1,713,469,4,194,95, ,663,717
2,1,16,0,0,0,1101,471,4,196,-1,,667,1105
3,1,16,1,0,0,1101,471,4,196,-1,,667,1105
4,1,16,1,1,0,1101,471,4,196,-1,,667,1105
5,1,16,1,1,1,1101,471,4,196,95, ,667,1105
2,1,17,0,0,0,479,586,1,79,-1,,665,480
3,1,17,1,0,0,479,586,1,79,-1,,665,480
4,1,17,1,1,0,479,586,1,79,-1,,665,480
5,1,17,1,1,1,479,586,1,79,95, ,665,480
2,1,18,0,0,0,64,656,1567,18,-1,,674,1631
3,1,18,1,0,0,64,656,1567,18,-1,,674,1631
4,1,18,1,1,0,64,656,1567,18,-1,,674,1631
5,1,18,1,1,1,64,656,1567,18,95, ,674,1631
2,1,19,0,0,0,65,725,1566,18,-1,,743,1631
3,1,19,1,0,0,65,725,1566,18,-1,,743,1631
4,1,19,1,1,0,65,725,1566,18,-1,,743,1631
5,1,19,1,1,1,65,725,1566,18,95, ,743,1631
2,1,20,0,0,0,1510,667,17,1063,-1,,1730,1527
3,1,20,1,0,0,1510,667,17,1063,-1,,1730,1527
4,1,20,1,1,0,1510,667,17,1063,-1,,1730,1527
5,1,20,1,1,1,1510,667,17,1063,95, ,1730,1527
2,1,21,0,0,0,1428,666,15,1074,-1,,1740,1443
3,1,21,1,0,0,1428,666,15,1074,-1,,1740,1443
4,1,21,1,1,0,1428,666,15,1074,-1,,1740,1443
5,1,21,1,1,1,1428,666,15,1074,95, ,1740,1443
2,1,22,0,0,0,927,665,16,1073,-1,,1738,943
3,1,22,1,0,0,927,665,16,1073,-1,,1738,943
4,1,22,1,1,0,927,665,16,1073,-1,,1738,943
5,1,22,1,1,1,927,665,16,1073,95, ,1738,943
2,1,23,0,0,0,1122,666,15,1073,-1,,1739,1137
3,1,23,1,0,0,1122,666,15,1073,-1,,1739,1137
4,1,23,1,1,0,1122,666,15,1073,-1,,1739,1137
5,1,23,1,1,1,1122,666,15,1073,95, ,1739,1137
2,1,24,0,0,0,249,662,16,1071,-1,,1733,265
3,1,24,1,0,0,249,662,16,1071,-1,,1733,265
4,1,24,1,1,0,249,662,16,1071,-1,,1733,265
5,1,24,1,1,1,249,662,16,1071,95, ,1733,265
2,1,25,0,0,0,1275,670,16,1070,-1,,1740,1291
3,1,25,1,0,0,1275,670,16,1070,-1,,1740,1291
4,1,25,1,1,0,1275,670,16,1070,-1,,1740,1291
5,1,25,1,1,1,1275,670,16,1070,95, ,1740,1291
2,1,26,0,0,0,63,1726,1566,21,-1,,1747,1629
3,1,26,1,0,0,63,1726,1566,21,-1,,1747,1629
4,1,26,1,1,0,63,1726,1566,21,-1,,1747,1629
5,1,26,1,1,1,63,1726,1566,21,95, ,1747,1629
2,1,27,0,0,0,1419,1737,3,86,-1,,1823,1422
3,1,27,1,0,0,1419,1737,3,86,-1,,1823,1422
4,1,27,1,1,0,1419,1737,3,86,-1,,1823,1422
5,1,27,1,1,1,1419,1737,3,86,95, ,1823,1422
2,1,28,0,0,0,1211,1737,2,85,-1,,1822,1213
3,1,28,1,0,0,1211,1737,2,85,-1,,1822,1213
4,1,28,1,1,0,1211,1737,2,85,-1,,1822,1213
5,1,28,1,1,1,1211,1737,2,85,95, ,1822,1213
2,1,29,0,0,0,1002,1736,2,85,-1,,1821,1004
3,1,29,1,0,0,1002,1736,2,85,-1,,1821,1004
4,1,29,1,1,0,1002,1736,2,85,-1,,1821,1004
5,1,29,1,1,1,1002,1736,2,85,95, ,1821,1004
2,1,30,0,0,0,795,1736,1,85,-1,,1821,796
3,1,30,1,0,0,795,1736,1,85,-1,,1821,796
4,1,30,1,1,0,795,1736,1,85,-1,,1821,796
5,1,30,1,1,1,795,1736,1,85,95, ,1821,796
2,1,31,0,0,0,82,1810,1547,18,-1,,1828,1629
3,1,31,1,0,0,82,1810,1547,18,-1,,1828,1629
4,1,31,1,1,0,82,1810,1547,18,-1,,1828,1629
5,1,31,1,1,1,82,1810,1547,18,95, ,1828,1629
2,1,32,0,0,0,1618,135,24,1769,-1,,1904,1642
3,1,32,1,0,0,1618,135,24,1769,-1,,1904,1642
4,1,32,1,1,0,1618,135,24,1769,-1,,1904,1642
5,1,32,1,1,1,1618,135,24,1769,95, ,1904,1642
2,1,33,0,0,0,64,106,1566,1796,-1,,1902,1630
3,1,33,1,0,0,64,106,1566,1796,-1,,1902,1630
4,1,33,1,1,0,150,106,1480,24,-1,,130,1630
5,1,33,1,1,1,150,107,74,23,95,Page:,130,224
5,1,33,1,1,2,248,106,12,19,88,1,125,260
5,1,33,1,1,3,481,108,45,18,96,530,126,526
5,1,33,1,1,4,816,106,132,21,96,RAPPORT,127,948
5,1,33,1,1,5,958,106,35,22,92,DE,128,993
5,1,33,1,1,6,1004,106,195,22,91,CHARGEMENT,128,1199
5,1,33,1,1,7,1208,119,8,3,92,-,122,1216
5,1,33,1,1,8,1225,107,137,22,91,VEHICULE,129,1362
5,1,33,1,1,9,1372,120,8,3,92,-,123,1380
5,1,33,1,1,10,1389,108,241,22,90,CONNAISSEMENT,130,1630
4,1,33,1,2,0,138,134,535,25,-1,,159,673
5,1,33,1,2,1,138,136,109,15,96,DOCUMENT,151,247
5,1,33,1,2,2,254,137,82,15,89,NUMBER,152,336
5,1,33,1,2,3,364,138,61,18,89,1677,156,425
5,1,33,1,2,4,537,134,38,25,16,pa,159,575
5,1,33,1,2,5,576,134,97,25,19,Aas,159,673
4,1,33,1,3,0,138,156,172,15,-1,,171,310
5,1,33,1,3,1,138,156,11,14,96,No,170,149
5,1,33,1,3,2,168,156,25,14,92,DU,170,193
5,1,33,1,3,3,201,156,109,15,95,DOCUMENT,171,310
4,1,33,1,4,0,151,131,1460,75,-1,,206,1611
5,1,33,1,4,1,151,160,10,10,90,Â°,170,161
5,1,33,1,4,2,480,131,2,75,95,|,206,482
5,1,33,1,4,3,523,164,137,34,96,mm/dd/yy,198,660
5,1,33,1,4,4,800,172,29,20,94,24,192,829
5,1,33,1,4,5,840,172,79,21,94,HOUR,193,919
5,1,33,1,4,6,930,172,118,21,65,NUMBER,193,1048
5,1,33,1,4,7,1069,170,206,22,65,(403)296-3000,192,1275
5,1,33,1,4,8,1311,174,139,21,56,-NUMERO,195,1450
5,1,33,1,4,9,1459,174,29,21,96,24,195,1488
5,1,33,1,4,10,1499,174,112,22,96,HEURES,196,1611
4,1,33,1,5,0,150,197,1224,28,-1,,225,1374
5,1,33,1,5,1,150,197,110,19,96,0114760,216,260
5,1,33,1,5,2,281,197,93,21,96,10/002,218,374
5,1,33,1,5,3,530,198,128,21,95,10/08/24,219,658
5,1,33,1,5,4,1051,203,231,22,91,COLLECT,225,1282
5,1,33,1,5,5,1180,196,15,34,91,-,230,1195
5,1,33,1,5,6,1208,203,72,22,91,FRAIS,225,1280
5,1,33,1,5,7,1292,204,82,21,91,VIRES,225,1374
4,1,33,1,6,0,65,229,1549,27,-1,,256,1614
5,1,33,1,6,1,65,244,2,6,85,|,250,67
5,1,33,1,6,2,79,229,197,14,91,CONSIGNEE/CUSTOMER,243,276
5,1,33,1,6,3,281,237,5,3,90,-,240,286
5,1,33,1,6,4,292,230,182,14,91,DESTINATAIRE/CLIENT,244,474
5,1,33,1,6,5,689,229,17,25,0,Boo,254,706
5,1,33,1,6,6,710,233,128,21,0,abLiSeetient.,254,838
5,1,33,1,6,7,852,224,9,34,93,|,258,861
5,1,33,1,6,8,864,232,101,14,83,CONSIGNOR,246,965
5,1,33,1,6,9,970,240,6,2,83,-,242,976
5,1,33,1,6,10,982,233,106,14,93,EXPEDITEUR,247,1088
5,1,33,1,6,11,1466,226,70,34,40,LOCATON,260,1536
5,1,33,1,6,12,1544,226,52,34,0,RORRER,260,1596
5,1,33,1,6,13,1606,246,8,10,23,|,256,1614
4,1,33,1,7,0,65,255,1508,29,-1,,284,1573
5,1,33,1,7,1,65,255,2,2,96,|,257,67
5,1,33,1,7,2,147,257,181,24,96,Mississauga,281,328
5,1,33,1,7,3,346,259,79,19,96,Lubes,278,425
5,1,33,1,7,4,445,260,98,18,96,Center,278,543
5,1,33,1,7,5,679,260,161,19,89,0000081523,279,840
5,1,33,1,7,6,860,260,183,24,88,|Mississauga,284,1043
5,1,33,1,7,7,1061,262,81,19,96,Lubes,281,1142
5,1,33,1,7,8,1161,263,98,18,96,Center,281,1259
5,1,33,1,7,9,1463,263,110,19,96,0081523,282,1573
4,1,33,1,8,0,149,288,1012,23,-1,,311,1161
5,1,33,1,8,1,149,288,45,19,96,385,307,194
5,1,33,1,8,2,215,289,145,19,96,Southdown,308,360
5,1,33,1,8,3,378,290,66,18,96,Road,308,444
5,1,33,1,8,4,679,291,228,19,84,0000000104|385,310,907
5,1,33,1,8,5,929,292,148,19,95,Southdown,311,1077
5,1,33,1,8,6,1095,292,66,19,95,Road,311,1161
4,1,33,1,9,0,147,318,1059,27,-1,,345,1206
5,1,33,1,9,1,147,318,174,24,91,"Missisauga,",342,321
5,1,33,1,9,2,346,321,31,18,93,ON,339,377
5,1,33,1,9,3,395,320,95,19,46,L5J2YÂ¥2,339,490
5,1,33,1,9,4,860,321,177,24,91,"Missisauga,",345,1037
5,1,33,1,9,5,1061,324,33,17,93,ON,341,1094
5,1,33,1,9,6,1111,323,95,19,21,L5J2YÂ¥2,342,1206
4,1,33,1,10,0,280,403,567,14,-1,,417,847
5,1,33,1,10,1,280,403,61,11,93,RELEASE,414,341
5,1,33,1,10,2,346,403,49,14,87,(C-of-A},417,395
5,1,33,1,10,3,399,403,59,12,79,NUMBER,415,458
5,1,33,1,10,4,569,404,79,12,91,CUSTOMER,416,648
5,1,33,1,10,5,653,404,76,12,96,PURCHASE,416,729
5,1,33,1,10,6,734,405,49,11,95,ORDER,416,783
5,1,33,1,10,7,788,405,59,11,14,NUMER,416,847
4,1,33,1,11,0,619,418,191,12,-1,,430,810
5,1,33,1,11,1,619,418,17,11,94,No,429,636
5,1,33,1,11,2,641,418,18,11,96,DE,429,659
5,1,33,1,11,3,664,418,69,11,88,DEMANDE,429,733
5,1,33,1,11,4,737,418,19,12,96,DU,430,756
5,1,33,1,11,5,761,419,49,11,96,CLIENT,430,810
4,1,33,1,12,0,562,440,1,21,-1,,461,563
5,1,33,1,12,1,562,440,1,21,90,|,461,563
4,1,33,1,13,0,71,466,1345,26,-1,,492,1416
5,1,33,1,13,1,71,466,81,24,50,"""CARRIER",490,152
5,1,33,1,13,2,157,484,5,2,87,-,486,162
5,1,33,1,13,3,167,477,136,14,92,TRANSPORTEUR,491,303
5,1,33,1,13,4,735,476,71,14,90,VEHICLE,490,806
5,1,33,1,13,5,812,477,71,13,90,NUMBER,490,883
5,1,33,1,13,6,924,478,71,14,55,LICENSE,492,995
5,1,33,1,13,7,1001,478,71,14,96,NUMBER,492,1072
5,1,33,1,13,8,1133,478,79,14,96,ADDRESS,492,1212
5,1,33,1,13,9,1218,478,22,14,96,OF,492,1240
5,1,33,1,13,10,1246,479,57,13,96,METER,492,1303
5,1,33,1,13,11,1308,479,35,13,96,AND,492,1343
5,1,33,1,13,12,1348,479,68,13,96,TRADER,492,1416
4,1,33,1,14,0,149,500,1332,22,-1,,522,1481
5,1,33,1,14,1,149,502,112,18,96,PREMIER,520,261
5,1,33,1,14,2,279,503,64,17,96,BULK,520,343
5,1,33,1,14,3,362,503,113,18,96,SYSTEMS,521,475
5,1,33,1,14,4,579,503,111,19,94,5000234,522,690
5,1,33,1,14,5,707,490,15,36,93,|,526,722
5,1,33,1,14,6,739,500,136,13,25,NoDUVEHICULE,513,875
5,1,33,1,14,7,902,490,12,36,39,=,526,914
5,1,33,1,14,8,924,500,73,14,55,NOMBRE,514,997
5,1,33,1,14,9,1002,501,22,13,55,DE,514,1024
5,1,33,1,14,10,1031,501,62,13,91,PERMIS,514,1093
5,1,33,1,14,11,1100,490,6,36,90,|,526,1106
5,1,33,1,14,12,1119,501,91,13,52,L'AORESSE,514,1210
5,1,33,1,14,13,1216,501,22,13,94,DE,514,1238
5,1,33,1,14,14,1244,501,57,13,93,METRE,514,1301
5,1,33,1,14,15,1308,502,20,12,39,&T,514,1328
5,1,33,1,14,16,1333,502,21,12,93,DE,514,1354
5,1,33,1,14,17,1361,502,120,13,92,COMMERCANT,515,1481
4,1,33,1,15,0,149,531,1325,27,-1,,558,1474
5,1,33,1,15,1,149,531,28,19,95,25,550,177
5,1,33,1,15,2,197,531,114,23,95,Gormley,554,311
5,1,33,1,15,3,330,531,160,20,96,Industrial,551,490
5,1,33,1,15,4,511,534,31,17,96,Dr,551,542
5,1,33,1,15,5,728,534,95,18,95,919322,552,823
5,1,33,1,15,6,1113,536,95,18,96,Suncor,554,1208
5,1,33,1,15,7,1228,537,98,21,96,Energy,558,1326
5,1,33,1,15,8,1345,536,129,18,96,Products,554,1474
4,1,33,1,16,0,147,558,1277,32,-1,,590,1424
5,1,33,1,16,1,147,558,114,32,96,GORMLEY,590,261
5,1,33,1,16,2,728,564,78,19,95,51202,583,806
5,1,33,1,16,3,1112,566,61,18,96,3275,584,1173
5,1,33,1,16,4,1193,566,116,19,95,Rebecca,585,1309
5,1,33,1,16,5,1328,567,96,19,96,Street,586,1424
4,1,33,1,17,0,147,592,524,26,-1,,618,671
5,1,33,1,17,1,147,592,95,20,90,LOH1GO,612,242
5,1,33,1,17,2,488,592,37,26,24,GENT,618,525
5,1,33,1,17,3,535,592,18,26,58,DU,618,553
5,1,33,1,17,4,557,592,114,26,29,TRANSPORTEUR,618,671
4,1,33,1,18,0,153,623,204,21,-1,,644,357
5,1,33,1,18,1,153,623,204,21,92,(226)338-5962,644,357
4,1,33,1,19,0,988,675,618,14,-1,,689,1606
5,1,33,1,19,1,988,675,67,13,96,FACTOR,688,1055
5,1,33,1,19,2,1164,676,92,13,94,MEASURED,689,1256
5,1,33,1,19,3,1308,676,32,13,74,NET,689,1340
5,1,33,1,19,4,1345,676,57,13,65,LITRES.,689,1402
5,1,33,1,19,5,1535,677,71,12,95,DENSITY,689,1606
4,1,33,1,20,0,79,678,1526,35,-1,,713,1605
5,1,33,1,20,1,79,678,142,35,17,PRODUCTIMETER!,713,221
5,1,33,1,20,2,574,705,4,2,39,.,707,578
5,1,33,1,20,3,988,693,78,14,92,FACTEUR,707,1066
5,1,33,1,20,4,1176,694,57,14,96,LITRES,708,1233
5,1,33,1,20,5,1307,695,105,14,10,correctep,709,1412
5,1,33,1,20,6,1440,688,62,13,60,[TEMPC,701,1502
5,1,33,1,20,7,1509,684,13,34,93,|,718,1522
5,1,33,1,20,8,1535,695,70,14,28,pensite,709,1605
4,1,33,1,21,0,79,697,1512,40,-1,,737,1591
5,1,33,1,21,1,79,699,135,34,72,PRODUIT/METER,733,214
5,1,33,1,21,2,370,697,80,14,0,PROG,711,450
5,1,33,1,21,3,437,693,11,41,34,|,734,448
5,1,33,1,21,4,456,697,112,14,36,DESCRIPTION:,711,568
5,1,33,1,21,5,585,698,111,13,52,DESCRIPTION,711,696
5,1,33,1,21,6,703,698,22,13,37,DU,711,725
5,1,33,1,21,7,732,699,73,13,37,PRODUIT,712,805
5,1,33,1,21,8,987,713,26,14,68,API,727,1013
5,1,33,1,21,9,1019,713,52,14,68,TABLE,727,1071
5,1,33,1,21,10,1164,703,96,34,48,MESUREES.,737,1260
5,1,33,1,21,11,1332,714,62,14,45,TO15C,728,1394
5,1,33,1,21,12,1410,704,15,34,42,â,738,1425
5,1,33,1,21,13,1440,715,70,13,14,[CELSIUS,728,1510
5,1,33,1,21,14,1534,715,57,17,0,kg/ouwm,732,1591
4,1,33,1,22,0,149,744,1423,25,-1,,769,1572
5,1,33,1,22,1,149,744,92,19,96,103265,763,241
5,1,33,1,22,2,257,740,15,33,94,|,773,272
5,1,33,1,22,3,278,746,48,18,96,NOT,764,326
5,1,33,1,22,4,344,747,148,18,95,REGULATED,765,492
5,1,33,1,22,5,510,748,82,17,96,UNDER,765,592
5,1,33,1,22,6,610,748,49,17,96,TDG,765,659
5,1,33,1,22,7,978,748,95,19,81,0.9612,767,1073
5,1,33,1,22,8,1161,748,79,19,96,25000,767,1240
5,1,33,1,22,9,1311,749,79,19,96,24030,768,1390
5,1,33,1,22,10,1445,749,61,19,0,65.7,768,1506
5,1,33,1,22,11,1528,749,44,20,0,/913,769,1572
4,1,33,1,23,0,64,773,1011,24,-1,,797,1075
5,1,33,1,23,1,64,773,2,8,94,|,781,66
5,1,33,1,23,2,146,775,95,19,92,MTR222,794,241
5,1,33,1,23,3,254,771,16,32,91,|,803,270
5,1,33,1,23,4,278,777,65,18,89,HVGO,795,343
5,1,33,1,23,5,958,780,49,17,92,API,797,1007
5,1,33,1,23,6,1029,779,46,18,80,54B,797,1075
4,1,33,1,24,0,149,836,1423,25,-1,,861,1572
5,1,33,1,24,1,149,836,92,19,96,103265,855,241
5,1,33,1,24,2,255,832,15,34,96,|,866,270
5,1,33,1,24,3,277,838,49,18,96,NOT,856,326
5,1,33,1,24,4,344,839,148,18,96,REGULATED,857,492
5,1,33,1,24,5,510,840,82,17,96,UNDER,857,592
5,1,33,1,24,6,610,840,48,18,96,TDG,858,658
5,1,33,1,24,7,978,840,95,19,94,0.9615,859,1073
5,1,33,1,24,8,1161,841,79,18,95,23001,859,1240
5,1,33,1,24,9,1310,841,80,19,95,22115,860,1390
5,1,33,1,24,10,1445,842,60,19,67,65.3,861,1505
5,1,33,1,24,11,1528,842,44,19,67,/913,861,1572
4,1,33,1,25,0,145,867,930,22,-1,,889,1075
5,1,33,1,25,1,145,867,96,19,92,MTR221,886,241
5,1,33,1,25,2,253,863,16,32,93,|,895,269
5,1,33,1,25,3,278,869,64,18,90,HVGO,887,342
5,1,33,1,25,4,958,872,49,17,92,API,889,1007
5,1,33,1,25,5,1028,871,47,18,77,54B,889,1075
4,1,33,1,26,0,667,1006,123,43,-1,,1049,790
5,1,33,1,26,1,667,1006,103,43,18,PETR,1049,770
5,1,33,1,26,2,775,1031,15,15,71,Â°,1046,790
4,1,33,1,27,0,499,1131,362,52,-1,,1183,861
5,1,33,1,27,1,499,1131,48,25,37,LY,1156,547
5,1,33,1,27,2,562,1150,19,33,57,~,1183,581
5,1,33,1,27,3,598,1136,102,41,54,"8:3,",1177,700
5,1,33,1,27,4,670,1127,40,60,49,"ay,",1187,710
5,1,33,1,27,5,725,1141,35,30,44,OF,1171,760
5,1,33,1,27,6,779,1149,82,30,37,10-34,1179,861
4,1,33,1,28,0,589,1184,138,39,-1,,1223,727
5,1,33,1,28,1,589,1184,34,30,57,8.,1214,623
5,1,33,1,28,2,629,1195,44,24,0,SS,1219,673
5,1,33,1,28,3,680,1197,47,26,0,Am,1223,727
4,1,33,1,29,0,311,1418,377,24,-1,,1442,688
5,1,33,1,29,1,311,1419,78,18,96,Total,1437,389
5,1,33,1,29,2,409,1418,97,20,96,Litres,1438,506
5,1,33,1,29,3,525,1419,33,23,96,by,1442,558
5,1,33,1,29,4,576,1419,112,19,96,Product,1438,688
4,1,33,1,30,0,279,1446,1109,31,-1,,1477,1388
5,1,33,1,30,1,279,1448,93,19,95,103265,1467,372
5,1,33,1,30,2,471,1446,70,31,92,HVGO,1477,541
5,1,33,1,30,3,1160,1452,78,18,96,48001,1470,1238
5,1,33,1,30,4,1311,1452,77,19,95,46145,1471,1388
4,1,33,1,31,0,76,1734,1495,33,-1,,1767,1571
5,1,33,1,31,1,76,1741,61,13,94,DRIVER,1754,137
5,1,33,1,31,2,142,1741,207,14,92,SIGNATURE,1755,349
5,1,33,1,31,3,242,1734,7,40,80,-,1774,249
5,1,33,1,31,4,258,1741,91,14,96,SIGNATURE,1755,349
5,1,33,1,31,5,355,1742,22,13,75,DU,1755,377
5,1,33,1,31,6,384,1742,116,14,92,CONDUCTEUR,1756,500
5,1,33,1,31,7,862,1740,61,25,48,ARRIVE,1765,923
5,1,33,1,31,8,1027,1741,73,25,88,DEBUT,1766,1100
5,1,33,1,31,9,1081,1737,18,41,74,DU,1778,1099
5,1,33,1,31,10,1102,1741,99,25,59,GHARGEMENT,1766,1201
5,1,33,1,31,11,1210,1737,18,41,67,|,1778,1228
5,1,33,1,31,12,1244,1742,149,25,19,FINTDUCHARGEMENT,1767,1393
5,1,33,1,31,13,1504,1734,67,33,22,Tea,1767,1571
4,1,33,1,32,0,860,1789,693,20,-1,,1809,1553
5,1,33,1,32,1,860,1789,78,18,95,08:24,1807,938
5,1,33,1,32,2,1060,1790,78,18,96,08:26,1808,1138
5,1,33,1,32,3,1276,1790,78,19,95,08:42,1809,1354
5,1,33,1,32,4,1476,1791,77,18,94,08:42,1809,1553
4,1,33,1,33,0,76,1821,1495,23,-1,,1844,1571
5,1,33,1,33,1,76,1821,61,13,95,DRIVER,1834,137
5,1,33,1,33,2,144,1821,45,14,92,NAME,1835,189
5,1,33,1,33,3,194,1828,5,3,92,-,1831,199
5,1,33,1,33,4,206,1822,36,13,94,NOM,1835,242
5,1,33,1,33,5,249,1822,22,13,92,DU,1835,271
5,1,33,1,33,6,276,1822,117,14,51,CONDUCTEUR,1836,393
5,1,33,1,33,7,595,1823,61,13,96,DRIVER,1836,656
5,1,33,1,33,8,662,1823,71,14,63,NUMBER,1837,733
5,1,33,1,33,9,1282,1825,54,14,95,TOTAL,1839,1336
5,1,33,1,33,10,1342,1826,83,13,93,QUANTITY,1839,1425
5,1,33,1,33,11,1430,1832,5,3,92,-,1835,1435
5,1,33,1,33,12,1440,1826,61,14,88,QUANT.,1840,1501
5,1,33,1,33,13,1507,1826,64,13,91,TOTALE,1839,1571
4,1,33,1,34,0,581,1837,908,34,-1,,1871,1489
5,1,33,1,34,1,581,1837,20,14,83,No,1851,601
5,1,33,1,34,2,607,1837,132,15,33,DUCONDUSTEUR,1852,739
5,1,33,1,34,3,761,1840,9,10,33,*,1850,770
5,1,33,1,34,4,779,1841,92,22,90,Volume,1863,871
5,1,33,1,34,5,881,1842,114,21,96,corrected,1863,995
5,1,33,1,34,6,1004,1843,22,21,95,to,1864,1026
5,1,33,1,34,7,1038,1842,27,22,95,15,1864,1065
5,1,33,1,34,8,1075,1842,102,28,93,Degrees,1870,1177
5,1,33,1,34,9,1187,1842,18,22,76,C,1864,1205
5,1,33,1,34,10,1215,1842,9,10,76,*,1852,1224
5,1,33,1,34,11,1292,1852,79,19,96,48001,1871,1371
5,1,33,1,34,12,1391,1851,98,20,95,Litres,1871,1489
4,1,33,1,35,0,144,1880,1274,22,-1,,1902,1418
5,1,33,1,35,1,144,1880,165,18,79,GURLALDEEP,1898,309
5,1,33,1,35,2,344,1881,80,18,73,SINGH,1899,424
5,1,33,1,35,3,610,1881,127,19,96,56018353,1900,737
5,1,33,1,35,4,1292,1883,79,19,33,42130,1902,1371
5,1,33,1,35,5,1392,1883,26,19,33,kg,1902,1418
2,1,34,0,0,0,54,152,23,1747,-1,,1899,77
3,1,34,1,0,0,54,152,23,1747,-1,,1899,77
4,1,34,1,1,0,54,152,23,1747,-1,,1899,77
5,1,34,1,1,1,54,152,23,1747,95, ,1899,77
2,1,35,0,0,0,56,1886,1578,269,-1,,2155,1634
3,1,35,1,0,0,56,1886,1578,269,-1,,2155,1634
4,1,35,1,1,0,56,1886,1578,269,-1,,2155,1634
5,1,35,1,1,1,56,1886,1578,269,95,     ,2155,1634
5,1,35,1,1,2,737,1886,555,23,95,  ,1909,1292
5,1,35,1,1,3,1418,1886,216,25,95,   ,1911,1634
2,1,36,0,0,0,84,1910,1523,59,-1,,1969,1607
3,1,36,1,0,0,84,1910,1523,50,-1,,1960,1607
4,1,36,1,1,0,84,1910,1523,17,-1,,1927,1607
5,1,36,1,1,1,84,1910,68,11,96,PRODUCT,1921,152
5,1,36,1,1,2,224,1910,37,12,95,TANK,1922,261
5,1,36,1,1,3,265,1911,68,11,96,CAPACITY,1922,333
5,1,36,1,1,4,376,1911,49,12,93,WATER,1923,425
5,1,36,1,1,5,430,1911,47,12,53,DIP/CM,1923,477
5,1,36,1,1,6,481,1905,6,28,66,|,1933,487
5,1,36,1,1,7,490,1912,55,11,95,BEFORE,1923,545
5,1,36,1,1,8,550,1912,31,11,93,DIPS,1923,581
5,1,36,1,1,9,591,1905,8,28,93,|,1933,599
5,1,36,1,1,10,605,1912,45,11,46,AFTER,1923,650
5,1,36,1,1,11,655,1912,31,11,46,CIPS,1923,686
5,1,36,1,1,12,696,1905,10,28,93,|,1933,706
5,1,36,1,1,13,714,1912,53,12,93,ENDING,1924,767
5,1,36,1,1,14,772,1913,49,11,95,INVENT,1924,821
5,1,36,1,1,15,866,1913,68,12,96,PRODUCT,1925,934
5,1,36,1,1,16,1004,1913,37,12,72,TANK,1925,1041
5,1,36,1,1,17,1046,1913,69,12,59,"CAPACITY,",1925,1115
5,1,36,1,1,18,1158,1914,49,11,93,WATER,1925,1207
5,1,36,1,1,19,1212,1914,47,11,59,DIP/CM|,1925,1259
5,1,36,1,1,20,1278,1914,55,12,68,BEFORE,1926,1333
5,1,36,1,1,21,1338,1915,31,11,68,DIPS),1926,1369
5,1,36,1,1,22,1388,1915,45,11,38,AFTER,1926,1433
5,1,36,1,1,23,1438,1915,31,11,38,DIPS,1926,1469
5,1,36,1,1,24,1480,1907,10,28,94,|,1935,1490
5,1,36,1,1,25,1499,1915,53,12,85,ENDING,1927,1552
5,1,36,1,1,26,1557,1915,50,12,85,INVENT,1927,1607
4,1,36,1,2,0,87,1921,1508,30,-1,,1951,1595
5,1,36,1,2,1,87,1927,61,12,88,PRODUIT,1939,148
5,1,36,1,2,2,227,1921,96,28,79,CONTENANCE,1949,323
5,1,36,1,2,3,392,1928,68,12,95,MEASURE,1940,460
5,1,36,1,2,4,502,1929,47,11,88,AVANT,1940,549
5,1,36,1,2,5,553,1929,16,12,84,LE,1941,569
5,1,36,1,2,6,613,1929,46,12,91,APRES,1941,659
5,1,36,1,2,7,664,1929,17,12,96,LE,1941,681
5,1,36,1,2,8,728,1923,81,28,72,INVENTAIRE,1951,809
5,1,36,1,2,9,869,1930,62,11,55,PRODUIT,1941,931
5,1,36,1,2,10,1008,1931,96,11,66,CONTENANCE,1942,1104
5,1,36,1,2,11,1172,1931,67,12,93,MEASURE,1943,1239
5,1,36,1,2,12,1285,1931,46,12,90,AVANT,1943,1331
5,1,36,1,2,13,1336,1931,16,12,90,LE,1943,1352
5,1,36,1,2,14,1394,1932,46,11,82,APRES,1943,1440
5,1,36,1,2,15,1445,1932,16,11,82,LE,1943,1461
5,1,36,1,2,16,1514,1932,81,11,51,INVENTAIRE,1943,1595
4,1,36,1,3,0,224,1939,1349,30,-1,,1969,1573
5,1,36,1,3,1,224,1944,19,12,87,DU,1956,243
5,1,36,1,3,2,248,1945,81,12,87,RESERVIOR,1957,329
5,1,36,1,3,3,395,1945,62,12,80,DEAUICM,1957,457
5,1,36,1,3,4,500,1945,75,12,79,JAUGEAGE,1957,575
5,1,36,1,3,5,587,1939,12,28,76,|,1967,599
5,1,36,1,3,6,610,1946,75,11,76,JAUGEAGE,1957,685
5,1,36,1,3,7,744,1939,50,28,21,APRES:,1967,794
5,1,36,1,3,8,1005,1947,18,12,87,OU,1959,1023
5,1,36,1,3,9,1029,1947,80,12,86,RESERVIOR,1959,1109
5,1,36,1,3,10,1174,1941,63,28,57,DEAVICM,1969,1237
5,1,36,1,3,11,1283,1948,74,11,80,JAUGEAGE,1959,1357
5,1,36,1,3,12,1370,1941,10,28,83,|,1969,1380
5,1,36,1,3,13,1394,1949,75,11,83,JAUGEAGE,1960,1469
5,1,36,1,3,14,1526,1949,47,11,92,APRES,1960,1573
2,1,37,0,0,0,1485,1967,3,58,-1,,2025,1488
3,1,37,1,0,0,1485,1967,3,58,-1,,2025,1488
4,1,37,1,1,0,1485,1967,3,58,-1,,2025,1488
5,1,37,1,1,1,1485,1967,3,58,91,|,2025,1488
2,1,38,0,0,0,65,1954,1560,18,-1,,1972,1625
3,1,38,1,0,0,65,1954,1560,18,-1,,1972,1625
4,1,38,1,1,0,65,1954,1560,18,-1,,1972,1625
5,1,38,1,1,1,65,1954,1560,18,95, ,1972,1625
2,1,39,0,0,0,65,2015,1560,18,-1,,2033,1625
3,1,39,1,0,0,65,2015,1560,18,-1,,2033,1625
4,1,39,1,1,0,65,2015,1560,18,-1,,2033,1625
5,1,39,1,1,1,65,2015,1560,18,95, ,2033,1625
2,1,40,0,0,0,65,2075,1560,20,-1,,2095,1625
3,1,40,1,0,0,65,2075,1560,20,-1,,2095,1625
4,1,40,1,1,0,65,2075,1560,20,-1,,2095,1625
5,1,40,1,1,1,65,2075,1560,20,95, ,2095,1625
2,1,41,0,0,0,1374,1909,5,236,-1,,2145,1379
3,1,41,1,0,0,1374,1909,5,236,-1,,2145,1379
4,1,41,1,1,0,1374,1909,5,236,-1,,2145,1379
5,1,41,1,1,1,1374,1909,5,236,95, ,2145,1379
2,1,42,0,0,0,1150,1908,6,236,-1,,2144,1156
3,1,42,1,0,0,1150,1908,6,236,-1,,2144,1156
4,1,42,1,1,0,1150,1908,6,236,-1,,2144,1156
5,1,42,1,1,1,1150,1908,6,236,95, ,2144,1156
2,1,43,0,0,0,1262,1909,5,236,-1,,2145,1267
3,1,43,1,0,0,1262,1909,5,236,-1,,2145,1267
4,1,43,1,1,0,1262,1909,5,236,-1,,2145,1267
5,1,43,1,1,1,1262,1909,5,236,95, ,2145,1267
2,1,44,0,0,0,369,1906,6,236,-1,,2142,375
3,1,44,1,0,0,369,1906,6,236,-1,,2142,375
4,1,44,1,1,0,369,1906,6,236,-1,,2142,375
5,1,44,1,1,1,369,1906,6,236,95, ,2142,375
2,1,45,0,0,0,590,1906,6,237,-1,,2143,596
3,1,45,1,0,0,590,1906,6,237,-1,,2143,596
4,1,45,1,1,0,590,1906,6,237,-1,,2143,596
5,1,45,1,1,1,590,1906,6,237,95, ,2143,596
2,1,46,0,0,0,701,1907,6,237,-1,,2144,707
3,1,46,1,0,0,701,1907,6,237,-1,,2144,707
4,1,46,1,1,0,701,1907,6,237,-1,,2144,707
5,1,46,1,1,1,701,1907,6,237,95, ,2144,707
2,1,47,0,0,0,480,1906,5,237,-1,,2143,485
3,1,47,1,0,0,480,1906,5,237,-1,,2143,485
4,1,47,1,1,0,480,1906,5,237,-1,,2143,485
5,1,47,1,1,1,480,1906,5,237,95, ,2143,485
2,1,48,0,0,0,39,2159,1624,19,-1,,2178,1663
3,1,48,1,0,0,39,2159,1624,19,-1,,2178,1663
4,1,48,1,1,0,39,2159,1624,19,-1,,2178,1663
5,1,48,1,1,1,39,2159,12,13,83,A,2172,51
5,1,48,1,1,2,55,2159,52,14,83,Suncor,2173,107
5,1,48,1,1,3,113,2159,65,14,93,business,2173,178
5,1,48,1,1,4,183,2159,5,14,93,/,2173,188
5,1,48,1,1,5,194,2159,29,14,93,Une,2173,223
5,1,48,1,1,6,229,2159,74,17,92,entreprise,2176,303
5,1,48,1,1,7,308,2159,18,14,96,de,2173,326
5,1,48,1,1,8,332,2159,53,14,95,Suncor,2173,385
5,1,48,1,1,9,1552,2161,54,13,61,41279L,2174,1606
5,1,48,1,1,10,1612,2161,51,17,94,(05/17),2178,1663
1,1,0,0,0,0,0,0,1700,2200,-1,,2200,1700
2,1,1,0,0,0,916,78,612,24,-1,,102,1528
3,1,1,1,0,0,916,78,612,24,-1,,102,1528
4,1,1,1,1,0,916,78,612,24,-1,,102,1528
5,1,1,1,1,1,916,78,117,21,95,VEHICLE,99,1033
5,1,1,1,1,2,1044,78,123,22,95,LOADING,100,1167
5,1,1,1,1,3,1178,79,114,22,93,REPORT,101,1292
5,1,1,1,1,4,1288,74,14,38,92,-,112,1302
5,1,1,1,1,5,1319,80,54,21,96,BILL,101,1373
5,1,1,1,1,6,1382,80,35,21,93,OF,101,1417
5,1,1,1,1,7,1428,81,100,21,91,LADING,102,1528
2,1,2,0,0,0,71,125,1566,10,-1,,135,1637
3,1,2,1,0,0,71,125,1566,10,-1,,135,1637
4,1,2,1,1,0,71,125,1566,10,-1,,135,1637
5,1,2,1,1,1,71,125,1566,10,95, ,135,1637
2,1,3,0,0,0,484,128,2,98,-1,,226,486
3,1,3,1,0,0,484,128,2,98,-1,,226,486
4,1,3,1,1,0,484,128,2,98,-1,,226,486
5,1,3,1,1,1,484,128,2,98,95, ,226,486
2,1,4,0,0,0,761,130,2,97,-1,,227,763
3,1,4,1,0,0,761,130,2,97,-1,,227,763
4,1,4,1,1,0,761,130,2,97,-1,,227,763
5,1,4,1,1,1,761,130,2,97,95, ,227,763
2,1,5,0,0,0,85,221,1549,11,-1,,232,1634
3,1,5,1,0,0,85,221,1549,11,-1,,232,1634
4,1,5,1,1,0,85,221,1549,11,-1,,232,1634
5,1,5,1,1,1,85,221,1549,11,95, ,232,1634
2,1,6,0,0,0,277,395,581,6,-1,,401,858
3,1,6,1,0,0,277,395,581,6,-1,,401,858
4,1,6,1,1,0,277,395,581,6,-1,,401,858
5,1,6,1,1,1,277,395,581,6,95, ,401,858
2,1,7,0,0,0,567,397,1,72,-1,,469,568
3,1,7,1,0,0,567,397,1,72,-1,,469,568
4,1,7,1,1,0,567,397,1,72,-1,,469,568
5,1,7,1,1,1,567,397,1,72,95, ,469,568
2,1,8,0,0,0,856,226,4,245,-1,,471,860
3,1,8,1,0,0,856,226,4,245,-1,,471,860
4,1,8,1,1,0,856,226,4,245,-1,,471,860
5,1,8,1,1,1,856,226,4,245,95, ,471,860
2,1,9,0,0,0,1456,229,1,62,-1,,291,1457
3,1,9,1,0,0,1456,229,1,62,-1,,291,1457
4,1,9,1,1,0,1456,229,1,62,-1,,291,1457
5,1,9,1,1,1,1456,229,1,62,95, ,291,1457
2,1,10,0,0,0,74,464,1562,10,-1,,474,1636
3,1,10,1,0,0,74,464,1562,10,-1,,474,1636
4,1,10,1,1,0,74,464,1562,10,-1,,474,1636
5,1,10,1,1,1,74,464,1562,10,95, ,474,1636
2,1,11,0,0,0,483,582,237,6,-1,,588,720
3,1,11,1,0,0,483,582,237,6,-1,,588,720
4,1,11,1,1,0,483,582,237,6,-1,,588,720
5,1,11,1,1,1,483,582,237,6,95, ,588,720
2,1,12,0,0,0,718,468,3,197,-1,,665,721
3,1,12,1,0,0,718,468,3,197,-1,,665,721
4,1,12,1,1,0,718,468,3,197,-1,,665,721
5,1,12,1,1,1,718,468,3,197,95, ,665,721
2,1,13,0,0,0,483,584,1,80,-1,,664,484
3,1,13,1,0,0,483,584,1,80,-1,,664,484
4,1,13,1,1,0,483,584,1,80,-1,,664,484
5,1,13,1,1,1,483,584,1,80,95, ,664,484
2,1,14,0,0,0,68,659,1567,10,-1,,669,1635
3,1,14,1,0,0,68,659,1567,10,-1,,669,1635
4,1,14,1,1,0,68,659,1567,10,-1,,669,1635
5,1,14,1,1,1,68,659,1567,10,95, ,669,1635
2,1,15,0,0,0,68,728,1567,10,-1,,738,1635
3,1,15,1,0,0,68,728,1567,10,-1,,738,1635
4,1,15,1,1,0,68,728,1567,10,-1,,738,1635
5,1,15,1,1,1,68,728,1567,10,95, ,738,1635
2,1,16,0,0,0,64,126,11,1551,-1,,1677,75
3,1,16,1,0,0,64,126,11,1551,-1,,1677,75
4,1,16,1,1,0,64,126,11,1551,-1,,1677,75
5,1,16,1,1,1,64,126,11,1551,95, ,1677,75
2,1,17,0,0,0,255,663,12,1071,-1,,1734,267
3,1,17,1,0,0,255,663,12,1071,-1,,1734,267
4,1,17,1,1,0,255,663,12,1071,-1,,1734,267
5,1,17,1,1,1,255,663,12,1071,95, ,1734,267
2,1,18,0,0,0,933,664,12,1073,-1,,1737,945
3,1,18,1,0,0,933,664,12,1073,-1,,1737,945
4,1,18,1,1,0,933,664,12,1073,-1,,1737,945
5,1,18,1,1,1,933,664,12,1073,95, ,1737,945
2,1,19,0,0,0,1128,665,11,1073,-1,,1738,1139
3,1,19,1,0,0,1128,665,11,1073,-1,,1738,1139
4,1,19,1,1,0,1128,665,11,1073,-1,,1738,1139
5,1,19,1,1,1,1128,665,11,1073,95, ,1738,1139
2,1,20,0,0,0,1281,666,12,1072,-1,,1738,1293
3,1,20,1,0,0,1281,666,12,1072,-1,,1738,1293
4,1,20,1,1,0,1281,666,12,1072,-1,,1738,1293
5,1,20,1,1,1,1281,666,12,1072,95, ,1738,1293
2,1,21,0,0,0,1516,670,13,1065,-1,,1735,1529
3,1,21,1,0,0,1516,670,13,1065,-1,,1735,1529
4,1,21,1,1,0,1516,670,13,1065,-1,,1735,1529
5,1,21,1,1,1,1516,670,13,1065,95, ,1735,1529
2,1,22,0,0,0,1434,666,11,1073,-1,,1739,1445
3,1,22,1,0,0,1434,666,11,1073,-1,,1739,1445
4,1,22,1,1,0,1434,666,11,1073,-1,,1739,1445
5,1,22,1,1,1,1434,666,11,1073,95, ,1739,1445
2,1,23,0,0,0,65,1729,1567,12,-1,,1741,1632
3,1,23,1,0,0,65,1729,1567,12,-1,,1741,1632
4,1,23,1,1,0,65,1729,1567,12,-1,,1741,1632
5,1,23,1,1,1,65,1729,1567,12,95, ,1741,1632
2,1,24,0,0,0,799,1735,1,84,-1,,1819,800
3,1,24,1,0,0,799,1735,1,84,-1,,1819,800
4,1,24,1,1,0,799,1735,1,84,-1,,1819,800
5,1,24,1,1,1,799,1735,1,84,95, ,1819,800
2,1,25,0,0,0,1006,1737,2,79,-1,,1816,1008
3,1,25,1,0,0,1006,1737,2,79,-1,,1816,1008
4,1,25,1,1,0,1006,1737,2,79,-1,,1816,1008
5,1,25,1,1,1,1006,1737,2,79,95, ,1816,1008
2,1,26,0,0,0,1423,1737,2,85,-1,,1822,1425
3,1,26,1,0,0,1423,1737,2,85,-1,,1822,1425
4,1,26,1,1,0,1423,1737,2,85,-1,,1822,1425
5,1,26,1,1,1,1423,1737,2,85,95, ,1822,1425
2,1,27,0,0,0,86,1812,1546,12,-1,,1824,1632
3,1,27,1,0,0,86,1812,1546,12,-1,,1824,1632
4,1,27,1,1,0,86,1812,1546,12,-1,,1824,1632
5,1,27,1,1,1,86,1812,1546,12,95, ,1824,1632
2,1,28,0,0,0,60,1814,1150,45,-1,,1859,1210
3,1,28,1,0,0,60,1814,1150,45,-1,,1859,1210
4,1,28,1,1,0,60,1814,1150,45,-1,,1859,1210
5,1,28,1,1,1,60,1814,1150,45,95, ,1859,1210
2,1,29,0,0,0,1218,1814,420,45,-1,,1859,1638
3,1,29,1,0,0,1218,1814,420,45,-1,,1859,1638
4,1,29,1,1,0,1218,1814,420,45,-1,,1859,1638
5,1,29,1,1,1,1218,1814,420,45,95, ,1859,1638
2,1,30,0,0,0,66,104,1567,1796,-1,,1900,1633
3,1,30,1,0,0,66,104,1567,1796,-1,,1900,1633
4,1,30,1,1,0,154,104,1479,26,-1,,130,1633
5,1,30,1,1,1,154,105,74,23,94,Page:,128,228
5,1,30,1,1,2,253,104,12,19,96,1,123,265
5,1,30,1,1,3,485,106,45,19,96,530,125,530
5,1,30,1,1,4,820,104,133,23,96,RAPPORT,127,953
5,1,30,1,1,5,962,105,35,22,91,DE,127,997
5,1,30,1,1,6,1008,106,214,22,91,CHARGEMENT,128,1222
5,1,30,1,1,7,1205,100,17,38,91,-,138,1222
5,1,30,1,1,8,1231,107,136,22,90,VEHICULE,129,1367
5,1,30,1,1,9,1377,120,7,3,92,-,123,1384
5,1,30,1,1,10,1394,108,239,22,91,CONNAISSEMENT,130,1633
4,1,30,1,2,0,142,132,536,25,-1,,157,678
5,1,30,1,2,1,142,134,110,16,95,DOCUMENT,150,252
5,1,30,1,2,2,259,136,82,14,66,NUMBER,150,341
5,1,30,1,2,3,369,136,61,18,66,1679,154,430
5,1,30,1,2,4,542,132,36,25,86,DATE,157,578
5,1,30,1,2,5,588,128,90,40,52,DEXBEGITION,168,678
4,1,30,1,3,0,142,153,173,16,-1,,169,315
5,1,30,1,3,1,142,153,12,15,96,No,168,154
5,1,30,1,3,2,172,154,25,14,96,DU,168,197
5,1,30,1,3,3,205,154,110,15,96,DOCUMENT,169,315
4,1,30,1,4,0,155,157,1460,39,-1,,196,1615
5,1,30,1,4,1,155,157,10,11,91,Â°,168,165
5,1,30,1,4,2,528,162,138,34,96,mm/dd/yy,196,666
5,1,30,1,4,3,805,170,29,21,95,24,191,834
5,1,30,1,4,4,844,170,80,21,95,HOUR,191,924
5,1,30,1,4,5,934,170,118,22,56,NUMBER,192,1052
5,1,30,1,4,6,1072,169,208,21,32,_(403)296-3000,190,1280
5,1,30,1,4,7,1317,173,137,21,72,-NUMERO,194,1454
5,1,30,1,4,8,1464,174,29,20,94,24,194,1493
5,1,30,1,4,9,1504,174,111,21,95,HEURES,195,1615
4,1,30,1,5,0,154,194,1224,30,-1,,224,1378
5,1,30,1,5,1,154,194,110,19,96,0114761,213,264
5,1,30,1,5,2,286,195,94,20,95,10/002,215,380
5,1,30,1,5,3,534,196,129,21,96,10/08/24,217,663
5,1,30,1,5,4,1055,202,233,22,92,COLLECT,224,1288
5,1,30,1,5,5,1185,195,18,33,92,-,228,1203
5,1,30,1,5,6,1216,202,72,22,92,FRAIS,224,1288
5,1,30,1,5,7,1297,203,81,21,92,VIRES,224,1378
4,1,30,1,6,0,83,225,1536,35,-1,,260,1619
5,1,30,1,6,1,83,226,197,14,90,CONSIGNEE/CUSTOMER,240,280
5,1,30,1,6,2,286,234,4,2,90,-,236,290
5,1,30,1,6,3,297,227,182,14,92,DESTINATAIRE/CLIENT,241,479
5,1,30,1,6,4,694,240,17,11,2,Re,251,711
5,1,30,1,6,5,749,234,12,17,0,ee,251,761
5,1,30,1,6,6,763,225,80,26,7,ea:,251,843
5,1,30,1,6,7,854,221,12,34,90,|,255,866
5,1,30,1,6,8,868,230,103,14,90,CONSIGNOR,244,971
5,1,30,1,6,9,976,238,5,2,90,-,240,981
5,1,30,1,6,10,986,231,106,14,92,EXPEDITEUR,245,1092
5,1,30,1,6,11,1471,225,110,35,12,ee,260,1581
5,1,30,1,6,12,1589,225,30,35,14,er,260,1619
4,1,30,1,7,0,151,254,1426,29,-1,,283,1577
5,1,30,1,7,1,151,254,181,24,96,Mississauga,278,332
5,1,30,1,7,2,350,256,80,19,96,Lubes,275,430
5,1,30,1,7,3,450,258,97,18,96,Center,276,547
5,1,30,1,7,4,684,258,161,20,95,0000081523,278,845
5,1,30,1,7,5,864,258,184,25,91,Mississauga,283,1048
5,1,30,1,7,6,1066,260,80,19,96,Lubes,279,1146
5,1,30,1,7,7,1167,262,98,18,96,Center,280,1265
5,1,30,1,7,8,1467,262,110,19,95,0081523,281,1577
4,1,30,1,8,0,70,280,1095,29,-1,,309,1165
5,1,30,1,8,1,70,280,2,11,93,|,291,72
5,1,30,1,8,2,153,286,45,18,96,385,304,198
5,1,30,1,8,3,219,286,147,19,96,Southdown,305,366
5,1,30,1,8,4,383,287,65,18,96,Road,305,448
5,1,30,1,8,5,684,289,162,19,0,0000000104,308,846
5,1,30,1,8,6,867,290,45,18,0,|385,308,912
5,1,30,1,8,7,934,290,147,19,96,Southdown,309,1081
5,1,30,1,8,8,1099,291,66,18,96,Road,309,1165
4,1,30,1,9,0,151,314,1061,29,-1,,343,1212
5,1,30,1,9,1,151,314,175,25,90,"Missisauga,",339,326
5,1,30,1,9,2,351,318,31,18,92,ON,336,382
5,1,30,1,9,3,400,318,95,18,14,L5d2Y2,336,495
5,1,30,1,9,4,864,318,177,25,90,"Missisauga,",343,1041
5,1,30,1,9,5,1066,322,32,18,93,ON,340,1098
5,1,30,1,9,6,1116,322,96,18,75,L5J2Â¥2,340,1212
4,1,30,1,10,0,284,400,567,15,-1,,415,851
5,1,30,1,10,1,284,400,62,11,93,RELEASE,411,346
5,1,30,1,10,2,352,400,48,15,48,(C-of-A},415,400
5,1,30,1,10,3,404,400,59,12,96,NUMBER,412,463
5,1,30,1,10,4,574,401,79,12,95,CUSTOMER,413,653
5,1,30,1,10,5,657,402,76,12,96,PURCHASE,414,733
5,1,30,1,10,6,738,402,49,12,71,ORDER,414,787
5,1,30,1,10,7,792,402,59,12,96,NUMBER,414,851
4,1,30,1,11,0,624,416,190,12,-1,,428,814
5,1,30,1,11,1,624,416,17,11,94,No,427,641
5,1,30,1,11,2,646,416,17,11,96,DE,427,663
5,1,30,1,11,3,668,416,69,12,96,DEMANDE,428,737
5,1,30,1,11,4,742,416,19,11,96,DU,427,761
5,1,30,1,11,5,766,417,48,11,95,CLIENT,428,814
4,1,30,1,12,0,70,463,1350,30,-1,,493,1420
5,1,30,1,12,1,70,463,2,8,91,|,471,72
5,1,30,1,12,2,83,474,73,14,81,CARRIER,488,156
5,1,30,1,12,3,161,482,5,2,81,-,484,166
5,1,30,1,12,4,171,475,137,15,80,TRANSPORTEUR,490,308
5,1,30,1,12,5,740,476,147,14,90,VEHICLENUMBER,490,887
5,1,30,1,12,6,929,477,70,14,38,LICENSE,491,999
5,1,30,1,12,7,1006,477,70,14,95,NUMBER,491,1076
5,1,30,1,12,8,1137,478,80,14,94,ADDRESS,492,1217
5,1,30,1,12,9,1223,478,22,14,96,OF,492,1245
5,1,30,1,12,10,1251,478,58,14,96,METER,492,1309
5,1,30,1,12,11,1313,479,35,13,95,AND,492,1348
5,1,30,1,12,12,1353,479,67,14,95,TRADER,493,1420
4,1,30,1,13,0,153,499,1332,23,-1,,522,1485
5,1,30,1,13,1,153,500,129,18,96,SEABOARD,518,282
5,1,30,1,13,2,300,501,98,21,95,LIQUID,522,398
5,1,30,1,13,3,416,501,130,19,94,CARRIERS,520,546
5,1,30,1,13,4,584,502,111,18,94,0101317,520,695
5,1,30,1,13,5,709,488,17,38,93,|,526,726
5,1,30,1,13,6,744,499,135,13,39,NoOUVEHICULE,512,879
5,1,30,1,13,7,905,488,11,38,41,=,526,916
5,1,30,1,13,8,930,500,167,14,26,NOMBREOEPERMIS,514,1097
5,1,30,1,13,9,1105,488,10,38,93,|,526,1115
5,1,30,1,13,10,1124,501,91,13,39,L'ADRESSE,514,1215
5,1,30,1,13,11,1222,501,21,13,94,DE,514,1243
5,1,30,1,13,12,1249,502,57,13,95,METRE,515,1306
5,1,30,1,13,13,1313,502,20,13,96,ET,515,1333
5,1,30,1,13,14,1342,502,18,13,91,DE,515,1360
5,1,30,1,13,15,1365,502,120,14,91,COMMERCANT,516,1485
4,1,30,1,14,0,153,530,1325,29,-1,,559,1478
5,1,30,1,14,1,153,530,27,18,96,55,548,180
5,1,30,1,14,2,200,531,82,18,96,ARROW,549,282
5,1,30,1,14,3,300,532,31,17,96,RD,549,331
5,1,30,1,14,4,731,533,80,19,46,H1346,552,811
5,1,30,1,14,5,1116,536,98,18,96,Suncor,554,1214
5,1,30,1,14,6,1233,537,99,22,96,Energy,559,1332
5,1,30,1,14,7,1350,536,128,20,96,Products,556,1478
4,1,30,1,15,0,150,560,1278,26,-1,,586,1428
5,1,30,1,15,1,150,560,82,20,96,North,580,232
5,1,30,1,15,2,250,561,66,19,96,York,580,316
5,1,30,1,15,3,733,564,78,19,96,91328,583,811
5,1,30,1,15,4,1116,566,62,19,96,3275,585,1178
5,1,30,1,15,5,1199,566,115,20,96,Rebecca,586,1314
5,1,30,1,15,6,1333,568,95,18,96,Street,586,1428
4,1,30,1,16,0,150,591,526,27,-1,,618,676
5,1,30,1,16,1,150,591,50,19,86,MOM,610,200
5,1,30,1,16,2,218,591,45,19,76,2L4,610,263
5,1,30,1,16,3,493,592,62,25,31,EE,617,555
5,1,30,1,16,4,573,592,103,26,43,EOS,618,676
4,1,30,1,17,0,157,621,205,21,-1,,642,362
5,1,30,1,17,1,157,621,68,21,77,(416),642,225
5,1,30,1,17,2,235,622,127,19,77,642-0515,641,362
4,1,30,1,18,0,992,675,617,14,-1,,689,1609
5,1,30,1,18,1,992,675,67,13,96,FACTOR,688,1059
5,1,30,1,18,2,1168,676,93,12,96,MEASURED,688,1261
5,1,30,1,18,3,1313,676,31,12,94,NET,688,1344
5,1,30,1,18,4,1351,676,55,13,94,LITRES,689,1406
5,1,30,1,18,5,1539,677,70,12,94,DENSITY,689,1609
4,1,30,1,19,0,82,676,1527,35,-1,,711,1609
5,1,30,1,19,1,82,676,142,35,42,PRODUCTIMETER,711,224
5,1,30,1,19,2,578,703,4,2,3,.,705,582
5,1,30,1,19,3,992,693,77,13,91,FACTEUR,706,1069
5,1,30,1,19,4,1181,693,58,14,95,LITRES,707,1239
5,1,30,1,19,5,1312,694,103,13,0,correcteo,707,1415
5,1,30,1,19,6,1444,688,62,12,81,|TEMPC,700,1506
5,1,30,1,19,7,1514,683,13,34,92,|,717,1527
5,1,30,1,19,8,1538,695,71,14,62,pensite,709,1609
4,1,30,1,20,0,82,695,1513,43,-1,,738,1595
5,1,30,1,20,1,82,707,136,14,91,PRODUIT/METER,721,218
5,1,30,1,20,2,374,695,80,14,40,BES,709,454
5,1,30,1,20,3,450,691,53,42,16,HORSE,733,503
5,1,30,1,20,4,513,696,57,13,39,ETON,709,570
5,1,30,1,20,5,589,696,220,15,0,DeseniETONEUEROPUIT,711,809
5,1,30,1,20,6,991,712,26,13,52,API,725,1017
5,1,30,1,20,7,1022,712,53,13,52,TABLE,725,1075
5,1,30,1,20,8,1168,713,92,14,92,MESUREES,727,1260
5,1,30,1,20,9,1337,714,61,13,26,TO15C,727,1398
5,1,30,1,20,10,1444,713,86,25,0,[CELSIUS,738,1530
5,1,30,1,20,11,1538,714,57,17,37,kg/cu.m,731,1595
4,1,30,1,21,0,152,742,1424,25,-1,,767,1576
5,1,30,1,21,1,152,742,94,19,95,103265,761,246
5,1,30,1,21,2,260,738,15,33,95,|,771,275
5,1,30,1,21,3,282,744,48,17,95,NOT,761,330
5,1,30,1,21,4,349,744,147,18,95,REGULATED,762,496
5,1,30,1,21,5,514,745,82,18,96,UNDER,763,596
5,1,30,1,21,6,614,746,49,17,96,TDG,763,663
5,1,30,1,21,7,982,746,95,19,95,0.9615,765,1077
5,1,30,1,21,8,1165,747,80,19,96,25000,766,1245
5,1,30,1,21,9,1316,748,78,19,96,24038,767,1394
5,1,30,1,21,10,1449,748,60,19,89,65.2,767,1509
5,1,30,1,21,11,1532,749,44,18,73,|913,767,1576
4,1,30,1,22,0,149,773,930,23,-1,,796,1079
5,1,30,1,22,1,149,773,96,18,92,MTR222,791,245
5,1,30,1,22,2,259,769,14,32,92,|,801,273
5,1,30,1,22,3,282,775,65,18,90,HVGO,793,347
5,1,30,1,22,4,962,779,49,16,93,API,795,1011
5,1,30,1,22,5,1032,777,47,19,88,54B,796,1079
4,1,30,1,23,0,1287,824,1,12,-1,,836,1288
5,1,30,1,23,1,1287,824,1,12,88,|,836,1288
4,1,30,1,24,0,152,834,1423,26,-1,,860,1575
5,1,30,1,24,1,152,834,94,19,96,103265,853,246
5,1,30,1,24,2,260,830,15,33,95,|,863,275
5,1,30,1,24,3,281,836,49,18,95,NOT,854,330
5,1,30,1,24,4,348,836,148,19,95,REGULATED,855,496
5,1,30,1,24,5,514,838,82,17,96,UNDER,855,596
5,1,30,1,24,6,614,838,49,18,96,TDG,856,663
5,1,30,1,24,7,982,839,95,18,95,0.9619,857,1077
5,1,30,1,24,8,1165,839,80,20,91,25000,859,1245
5,1,30,1,24,9,1287,845,1,11,90,|,856,1288
5,1,30,1,24,10,1315,840,79,19,96,24048,859,1394
5,1,30,1,24,11,1448,841,127,19,45,64.8|913,860,1575
4,1,30,1,25,0,149,865,930,23,-1,,888,1079
5,1,30,1,25,1,149,865,97,19,92,MTR221,884,246
5,1,30,1,25,2,257,861,14,32,92,|,893,271
5,1,30,1,25,3,282,867,64,18,89,HVGO,885,346
5,1,30,1,25,4,962,871,49,17,90,API,888,1011
5,1,30,1,25,5,1032,870,47,18,87,54B,888,1079
4,1,30,1,26,0,67,1122,2,12,-1,,1134,69
5,1,30,1,26,1,67,1122,2,12,73,|,1134,69
4,1,30,1,27,0,313,1417,379,23,-1,,1440,692
5,1,30,1,27,1,313,1418,80,18,96,Total,1436,393
5,1,30,1,27,2,413,1417,97,19,96,Litres,1436,510
5,1,30,1,27,3,529,1418,32,22,96,by,1440,561
5,1,30,1,27,4,580,1419,112,19,96,Product,1438,692
4,1,30,1,28,0,282,1444,1111,34,-1,,1478,1393
5,1,30,1,28,1,282,1447,94,20,96,103265,1467,376
5,1,30,1,28,2,475,1444,69,34,91,HVGO,1478,544
5,1,30,1,28,3,1164,1452,79,18,95,50000,1470,1243
5,1,30,1,28,4,1314,1452,79,19,96,48086,1471,1393
4,1,30,1,29,0,80,1739,1493,27,-1,,1766,1573
5,1,30,1,29,1,80,1740,61,13,86,ORIVER,1753,141
5,1,30,1,29,2,147,1740,95,13,92,SIGNATURE,1753,242
5,1,30,1,29,3,247,1748,5,2,84,-,1750,252
5,1,30,1,29,4,258,1740,94,14,96,SIGNATURE,1754,352
5,1,30,1,29,5,358,1740,22,14,93,DU,1754,380
5,1,30,1,29,6,386,1741,117,13,92,CONDUCTEUR,1754,503
5,1,30,1,29,7,866,1739,61,25,12,ARRIVES,1764,927
5,1,30,1,29,8,1030,1740,174,25,39,DEBUTDUGHARGEMENT,1765,1204
5,1,30,1,29,9,1213,1736,12,41,81,|,1777,1225
5,1,30,1,29,10,1249,1740,20,25,49,FIN,1765,1269
5,1,30,1,29,11,1275,1740,18,26,59,DU,1766,1293
5,1,30,1,29,12,1295,1740,102,26,61,GHARGENENT,1766,1397
5,1,30,1,29,13,1508,1742,65,24,46,DEPART,1766,1573
4,1,30,1,30,0,863,1788,694,21,-1,,1809,1557
5,1,30,1,30,1,863,1788,78,19,96,09:00,1807,941
5,1,30,1,30,2,1063,1789,78,18,96,09:02,1807,1141
5,1,30,1,30,3,1281,1790,77,18,95,09:19,1808,1358
5,1,30,1,30,4,1480,1790,77,19,96,09:19,1809,1557
4,1,30,1,31,0,66,1819,1508,19,-1,,1838,1574
5,1,30,1,31,1,66,1821,1,3,88,|,1824,67
5,1,30,1,31,2,80,1820,61,13,88,DRIVER,1833,141
5,1,30,1,31,3,147,1819,46,14,91,NAME,1833,193
5,1,30,1,31,4,199,1827,4,2,91,-,1829,203
5,1,30,1,31,5,209,1820,37,14,96,NOM,1834,246
5,1,30,1,31,6,253,1820,20,14,92,DU,1834,273
5,1,30,1,31,7,280,1820,116,14,60,GONDUCTEUR,1834,396
5,1,30,1,31,8,1286,1824,53,13,95,TOTAL,1837,1339
5,1,30,1,31,9,1345,1824,93,14,92,QUANTITY,1838,1438
5,1,30,1,31,10,1432,1814,9,34,91,-,1848,1441
5,1,30,1,31,11,1444,1824,60,14,80,"QUANT,",1838,1504
5,1,30,1,31,12,1510,1825,64,13,92,TOTALE,1838,1574
4,1,30,1,32,0,764,1839,727,31,-1,,1870,1491
5,1,30,1,32,1,764,1839,9,9,0,*,1848,773
5,1,30,1,32,2,782,1840,93,22,0,Volume,1862,875
5,1,30,1,32,3,884,1840,113,22,96,corrected,1862,997
5,1,30,1,32,4,1008,1842,21,20,95,to,1862,1029
5,1,30,1,32,5,1041,1840,28,22,96,15,1862,1069
5,1,30,1,32,6,1078,1840,103,28,93,Degrees,1868,1181
5,1,30,1,32,7,1190,1840,19,22,90,C,1862,1209
5,1,30,1,32,8,1218,1841,9,9,90,*,1850,1227
5,1,30,1,32,9,1297,1850,78,20,96,50000,1870,1375
5,1,30,1,32,10,1395,1850,96,20,95,Litres,1870,1491
4,1,30,1,33,0,1297,1881,124,19,-1,,1900,1421
5,1,30,1,33,1,1297,1881,77,19,54,43903,1900,1374
5,1,30,1,33,2,1395,1881,26,19,54,kg,1900,1421
2,1,31,0,0,0,88,1908,67,29,-1,,1937,155
3,1,31,1,0,0,88,1908,67,29,-1,,1937,155
4,1,31,1,1,0,88,1908,67,11,-1,,1919,155
5,1,31,1,1,1,88,1908,67,11,96,PRODUCT,1919,155
4,1,31,1,2,0,91,1925,60,12,-1,,1937,151
5,1,31,1,2,1,91,1925,60,12,96,PRODUIT,1937,151
2,1,32,0,0,0,227,1909,109,46,-1,,1955,336
3,1,32,1,0,0,227,1909,109,46,-1,,1955,336
4,1,32,1,1,0,227,1909,109,12,-1,,1921,336
5,1,32,1,1,1,227,1909,37,11,76,TANK,1920,264
5,1,32,1,1,2,268,1909,68,12,95,CAPACITY,1921,336
4,1,32,1,2,0,231,1926,94,11,-1,,1937,325
5,1,32,1,2,1,231,1926,94,11,87,CONTENANCE,1937,325
4,1,32,1,3,0,229,1943,102,12,-1,,1955,331
5,1,32,1,3,1,229,1943,18,11,88,BU,1954,247
5,1,32,1,3,2,253,1943,78,12,59,RESERVIOR,1955,331
2,1,33,0,0,0,608,1910,81,46,-1,,1956,689
3,1,33,1,0,0,608,1910,81,46,-1,,1956,689
4,1,33,1,1,0,608,1910,81,12,-1,,1922,689
5,1,33,1,1,1,608,1910,45,12,94,AFTER,1922,653
5,1,33,1,1,2,658,1911,31,11,67,DIPS.,1922,689
4,1,33,1,2,0,616,1927,68,12,-1,,1939,684
5,1,33,1,2,1,616,1927,46,12,93,APRES,1939,662
5,1,33,1,2,2,668,1927,16,12,93,LE,1939,684
4,1,33,1,3,0,614,1945,74,11,-1,,1956,688
5,1,33,1,3,1,614,1945,74,11,88,JAUGEAGE,1956,688
2,1,34,0,0,0,717,1911,107,46,-1,,1957,824
3,1,34,1,0,0,717,1911,107,46,-1,,1957,824
4,1,34,1,1,0,717,1911,107,12,-1,,1923,824
5,1,34,1,1,1,717,1911,53,12,96,ENDING,1923,770
5,1,34,1,1,2,775,1911,49,12,96,INVENT,1923,824
4,1,34,1,2,0,731,1928,81,11,-1,,1939,812
5,1,34,1,2,1,731,1928,81,11,76,INVENTAIRE,1939,812
4,1,34,1,3,0,747,1945,46,12,-1,,1957,793
5,1,34,1,3,1,747,1945,46,12,36,APRES:,1957,793
2,1,35,0,0,0,1008,1912,110,46,-1,,1958,1118
3,1,35,1,0,0,1008,1912,110,46,-1,,1958,1118
4,1,35,1,1,0,1008,1912,110,11,-1,,1923,1118
5,1,35,1,1,1,1008,1912,37,11,95,TANK,1923,1045
5,1,35,1,1,2,1049,1912,69,11,96,CAPACITY,1923,1118
4,1,35,1,2,0,1011,1929,96,12,-1,,1941,1107
5,1,35,1,2,1,1011,1929,96,12,77,CONTENANCE,1941,1107
4,1,35,1,3,0,1008,1946,105,12,-1,,1958,1113
5,1,35,1,3,1,1008,1946,19,11,86,DU,1957,1027
5,1,35,1,3,2,1032,1946,81,12,86,RESERVIOR,1958,1113
2,1,36,0,0,0,1161,1912,102,47,-1,,1959,1263
3,1,36,1,0,0,1161,1912,102,47,-1,,1959,1263
4,1,36,1,1,0,1161,1912,102,12,-1,,1924,1263
5,1,36,1,1,1,1161,1912,50,12,89,WATER,1924,1211
5,1,36,1,1,2,1216,1912,47,12,89,DIP/CM,1924,1263
4,1,36,1,2,0,1176,1929,67,12,-1,,1941,1243
5,1,36,1,2,1,1176,1929,67,12,73,MEASURE,1941,1243
4,1,36,1,3,0,1178,1947,64,12,-1,,1959,1242
5,1,36,1,3,1,1178,1947,64,12,41,DEAUICM,1959,1242
2,1,37,0,0,0,870,1911,67,29,-1,,1940,937
3,1,37,1,0,0,870,1911,67,29,-1,,1940,937
4,1,37,1,1,0,870,1911,67,12,-1,,1923,937
5,1,37,1,1,1,870,1911,67,12,96,PRODUCT,1923,937
4,1,37,1,2,0,872,1929,62,11,-1,,1940,934
5,1,37,1,2,1,872,1929,62,11,95,PRODUIT,1940,934
2,1,38,0,0,0,1281,1913,92,46,-1,,1959,1373
3,1,38,1,0,0,1281,1913,92,46,-1,,1959,1373
4,1,38,1,1,0,1281,1913,92,12,-1,,1925,1373
5,1,38,1,1,1,1281,1913,56,12,96,BEFORE,1925,1337
5,1,38,1,1,2,1343,1913,30,12,83,DIPS,1925,1373
4,1,38,1,2,0,1289,1930,67,11,-1,,1941,1356
5,1,38,1,2,1,1289,1930,46,11,85,AVANT,1941,1335
5,1,38,1,2,2,1340,1930,16,11,85,LE,1941,1356
4,1,38,1,3,0,1287,1947,74,12,-1,,1959,1361
5,1,38,1,3,1,1287,1947,74,12,74,JAUGEAGE,1959,1361
2,1,39,0,0,0,1391,1913,81,46,-1,,1959,1472
3,1,39,1,0,0,1391,1913,81,46,-1,,1959,1472
4,1,39,1,1,0,1391,1913,81,12,-1,,1925,1472
5,1,39,1,1,1,1391,1913,45,12,94,AFTER,1925,1436
5,1,39,1,1,2,1441,1913,31,12,93,DIPS,1925,1472
4,1,39,1,2,0,1397,1930,66,12,-1,,1942,1463
5,1,39,1,2,1,1397,1930,46,12,90,APRES,1942,1443
5,1,39,1,2,2,1448,1931,15,11,96,LE,1942,1463
4,1,39,1,3,0,1397,1947,75,12,-1,,1959,1472
5,1,39,1,3,1,1397,1947,75,12,91,JAUGEAGE,1959,1472
2,1,40,0,0,0,1628,134,12,1769,-1,,1903,1640
3,1,40,1,0,0,1628,134,12,1769,-1,,1903,1640
4,1,40,1,1,0,1628,134,12,1769,-1,,1903,1640
5,1,40,1,1,1,1628,134,12,1769,95, ,1903,1640
2,1,41,0,0,0,1502,1913,107,46,-1,,1959,1609
3,1,41,1,0,0,1502,1913,107,46,-1,,1959,1609
4,1,41,1,1,0,1502,1913,107,12,-1,,1925,1609
5,1,41,1,1,1,1502,1913,53,12,96,ENDING,1925,1555
5,1,41,1,1,2,1560,1913,49,12,96,INVENT,1925,1609
4,1,41,1,2,0,1516,1931,82,12,-1,,1943,1598
5,1,41,1,2,1,1516,1931,82,12,92,INVENTAIRE,1943,1598
4,1,41,1,3,0,1530,1948,46,11,-1,,1959,1576
5,1,41,1,3,1,1530,1948,46,11,12,APRES.,1959,1576
2,1,42,0,0,0,69,1956,1560,12,-1,,1968,1629
3,1,42,1,0,0,69,1956,1560,12,-1,,1968,1629
4,1,42,1,1,0,69,1956,1560,12,-1,,1968,1629
5,1,42,1,1,1,69,1956,1560,12,95, ,1968,1629
2,1,43,0,0,0,68,2018,1560,11,-1,,2029,1628
3,1,43,1,0,0,68,2018,1560,11,-1,,2029,1628
4,1,43,1,1,0,68,2018,1560,11,-1,,2029,1628
5,1,43,1,1,1,68,2018,1560,11,95, ,2029,1628
2,1,44,0,0,0,70,2078,1558,13,-1,,2091,1628
3,1,44,1,0,0,70,2078,1558,13,-1,,2091,1628
4,1,44,1,1,0,70,2078,1558,13,-1,,2091,1628
5,1,44,1,1,1,70,2078,1558,13,95, ,2091,1628
2,1,45,0,0,0,706,1905,3,238,-1,,2143,709
3,1,45,1,0,0,706,1905,3,238,-1,,2143,709
4,1,45,1,1,0,706,1905,3,238,-1,,2143,709
5,1,45,1,1,1,706,1905,3,238,95, ,2143,709
2,1,46,0,0,0,374,1904,3,238,-1,,2142,377
3,1,46,1,0,0,374,1904,3,238,-1,,2142,377
4,1,46,1,1,0,374,1904,3,238,-1,,2142,377
5,1,46,1,1,1,374,1904,3,238,95, ,2142,377
2,1,47,0,0,0,44,2160,344,17,-1,,2177,388
3,1,47,1,0,0,44,2160,344,17,-1,,2177,388
4,1,47,1,1,0,44,2160,344,17,-1,,2177,388
5,1,47,1,1,1,44,2160,11,14,96,A,2174,55
5,1,47,1,1,2,60,2160,53,14,96,Suncor,2174,113
5,1,47,1,1,3,118,2161,65,13,91,business,2174,183
5,1,47,1,1,4,188,2160,5,14,91,/,2174,193
5,1,47,1,1,5,199,2161,28,13,93,Une,2174,227
5,1,47,1,1,6,233,2161,73,16,92,entreprise,2177,306
5,1,47,1,1,7,312,2161,18,13,96,de,2174,330
5,1,47,1,1,8,336,2161,52,13,96,Suncor,2174,388
2,1,48,0,0,0,954,1906,4,237,-1,,2143,958
3,1,48,1,0,0,954,1906,4,237,-1,,2143,958
4,1,48,1,1,0,954,1906,4,237,-1,,2143,958
5,1,48,1,1,1,954,1906,4,237,95, ,2143,958
2,1,49,0,0,0,1266,1907,4,238,-1,,2145,1270
3,1,49,1,0,0,1266,1907,4,238,-1,,2145,1270
4,1,49,1,1,0,1266,1907,4,238,-1,,2145,1270
5,1,49,1,1,1,1266,1907,4,238,95, ,2145,1270
2,1,50,0,0,0,1377,1907,4,216,-1,,2123,1381
3,1,50,1,0,0,1377,1907,4,216,-1,,2123,1381
4,1,50,1,1,0,1377,1907,4,216,-1,,2123,1381
5,1,50,1,1,1,1377,1907,4,216,95, ,2123,1381
2,1,51,0,0,0,60,1859,1578,296,-1,,2155,1638
3,1,51,1,0,0,60,1859,1578,296,-1,,2155,1638
4,1,51,1,1,0,60,1859,1578,296,-1,,2155,1638
5,1,51,1,1,1,60,1859,1578,296,95, ,2155,1638
2,1,52,0,0,0,1488,1908,4,237,-1,,2145,1492
3,1,52,1,0,0,1488,1908,4,237,-1,,2145,1492
4,1,52,1,1,0,1488,1908,4,237,-1,,2145,1492
5,1,52,1,1,1,1488,1908,4,237,95, ,2145,1492
2,1,53,0,0,0,1558,2162,109,17,-1,,2179,1667
3,1,53,1,0,0,1558,2162,109,17,-1,,2179,1667
4,1,53,1,1,0,1558,2162,109,17,-1,,2179,1667
5,1,53,1,1,1,1558,2162,52,13,89,142791.,2175,1610
5,1,53,1,1,2,1616,2162,51,17,93,(05/17),2179,1667
1,1,0,0,0,0,0,0,1700,2200,-1,,2200,1700
2,1,1,0,0,0,705,44,825,56,-1,,100,1530
3,1,1,1,0,0,705,44,825,56,-1,,100,1530
4,1,1,1,1,0,705,44,825,56,-1,,100,1530
5,1,1,1,1,1,705,44,37,46,94,2,90,742
5,1,1,1,1,2,752,49,25,41,9,Y,90,777
5,1,1,1,1,3,786,58,19,25,85,6,83,805
5,1,1,1,1,4,815,53,39,39,90,76,92,854
5,1,1,1,1,5,866,49,12,33,46,7,82,878
5,1,1,1,1,6,889,46,15,29,89,8,75,904
5,1,1,1,1,7,919,75,116,22,95,VEHICLE,97,1035
5,1,1,1,1,8,1047,76,121,22,95,LOADING,98,1168
5,1,1,1,1,9,1179,77,113,22,92,REPORT,99,1292
5,1,1,1,1,10,1301,90,8,3,92,-,93,1309
5,1,1,1,1,11,1319,78,54,21,95,BILL,99,1373
5,1,1,1,1,12,1383,78,36,22,93,OF,100,1419
5,1,1,1,1,13,1430,79,100,21,91,LADING,100,1530
2,1,2,0,0,0,73,121,1566,14,-1,,135,1639
3,1,2,1,0,0,73,121,1566,14,-1,,135,1639
4,1,2,1,1,0,73,121,1566,14,-1,,135,1639
5,1,2,1,1,1,73,121,1566,14,95, ,135,1639
2,1,3,0,0,0,486,125,3,98,-1,,223,489
3,1,3,1,0,0,486,125,3,98,-1,,223,489
4,1,3,1,1,0,486,125,3,98,-1,,223,489
5,1,3,1,1,1,486,125,3,98,95, ,223,489
2,1,4,0,0,0,72,217,623,7,-1,,224,695
3,1,4,1,0,0,72,217,623,7,-1,,224,695
4,1,4,1,1,0,72,217,623,7,-1,,224,695
5,1,4,1,1,1,72,217,623,7,95, ,224,695
2,1,5,0,0,0,828,224,643,6,-1,,230,1471
3,1,5,1,0,0,828,224,643,6,-1,,230,1471
4,1,5,1,1,0,828,224,643,6,-1,,230,1471
5,1,5,1,1,1,828,224,643,6,95, ,230,1471
2,1,6,0,0,0,680,223,2,63,-1,,286,682
3,1,6,1,0,0,680,223,2,63,-1,,286,682
4,1,6,1,1,0,680,223,2,63,-1,,286,682
5,1,6,1,1,1,680,223,2,63,95, ,286,682
2,1,7,0,0,0,1457,228,2,63,-1,,291,1459
3,1,7,1,0,0,1457,228,2,63,-1,,291,1459
4,1,7,1,1,0,1457,228,2,63,-1,,291,1459
5,1,7,1,1,1,1457,228,2,63,95, ,291,1459
2,1,8,0,0,0,1457,289,182,3,-1,,292,1639
3,1,8,1,0,0,1457,289,182,3,-1,,292,1639
4,1,8,1,1,0,1457,289,182,3,-1,,292,1639
5,1,8,1,1,1,1457,289,182,3,95, ,292,1639
2,1,9,0,0,0,278,394,582,5,-1,,399,860
3,1,9,1,0,0,278,394,582,5,-1,,399,860
4,1,9,1,1,0,278,394,582,5,-1,,399,860
5,1,9,1,1,1,278,394,582,5,95, ,399,860
2,1,10,0,0,0,858,224,3,246,-1,,470,861
3,1,10,1,0,0,858,224,3,246,-1,,470,861
4,1,10,1,1,0,858,224,3,246,-1,,470,861
5,1,10,1,1,1,858,224,3,246,95, ,470,861
2,1,11,0,0,0,568,397,1,71,-1,,468,569
3,1,11,1,0,0,568,397,1,71,-1,,468,569
4,1,11,1,1,0,568,397,1,71,-1,,468,569
5,1,11,1,1,1,568,397,1,71,95, ,468,569
2,1,12,0,0,0,107,461,1530,13,-1,,474,1637
3,1,12,1,0,0,107,461,1530,13,-1,,474,1637
4,1,12,1,1,0,107,461,1530,13,-1,,474,1637
5,1,12,1,1,1,107,461,1530,13,95, ,474,1637
2,1,13,0,0,0,1108,469,2,197,-1,,666,1110
3,1,13,1,0,0,1108,469,2,197,-1,,666,1110
4,1,13,1,1,0,1108,469,2,197,-1,,666,1110
5,1,13,1,1,1,1108,469,2,197,95, ,666,1110
2,1,14,0,0,0,484,582,2,80,-1,,662,486
3,1,14,1,0,0,484,582,2,80,-1,,662,486
4,1,14,1,1,0,484,582,2,80,-1,,662,486
5,1,14,1,1,1,484,582,2,80,95, ,662,486
2,1,15,0,0,0,70,656,1564,12,-1,,668,1634
3,1,15,1,0,0,70,656,1564,12,-1,,668,1634
4,1,15,1,1,0,70,656,1564,12,-1,,668,1634
5,1,15,1,1,1,70,656,1564,12,95, ,668,1634
2,1,16,0,0,0,73,725,1561,12,-1,,737,1634
3,1,16,1,0,0,73,725,1561,12,-1,,737,1634
4,1,16,1,1,0,73,725,1561,12,-1,,737,1634
5,1,16,1,1,1,73,725,1561,12,95, ,737,1634
2,1,17,0,0,0,68,100,1571,788,-1,,888,1639
3,1,17,1,0,0,69,100,1568,788,-1,,888,1637
4,1,17,1,1,0,156,100,1479,30,-1,,130,1635
5,1,17,1,1,1,156,101,75,23,95,Page:,124,231
5,1,17,1,1,2,256,100,11,19,96,1,119,267
5,1,17,1,1,3,488,102,45,20,96,530,122,533
5,1,17,1,1,4,822,102,133,23,96,RAPPORT,125,955
5,1,17,1,1,5,965,103,35,22,93,DE,125,1000
5,1,17,1,1,6,1010,104,213,23,91,CHARGEMENT,127,1223
5,1,17,1,1,7,1208,98,13,39,92,-,137,1221
5,1,17,1,1,8,1232,105,136,23,89,VEHICULE,128,1368
5,1,17,1,1,9,1378,118,8,4,89,-,122,1386
5,1,17,1,1,10,1395,106,240,24,91,CONNAISSEMENT,130,1635
4,1,17,1,2,0,144,130,536,26,-1,,156,680
5,1,17,1,2,1,144,130,111,16,91,DOCUMENT,146,255
5,1,17,1,2,2,261,132,82,15,91,NUMBER,147,343
5,1,17,1,2,3,366,134,66,18,70,1683,152,432
5,1,17,1,2,4,544,130,36,24,82,DATE,154,580
5,1,17,1,2,5,586,126,94,40,0,DEXBEDITION,166,680
4,1,17,1,3,0,144,150,173,16,-1,,166,317
5,1,17,1,3,1,144,150,12,14,95,No,164,156
5,1,17,1,3,2,174,150,25,15,96,DU,165,199
5,1,17,1,3,3,208,150,109,16,96,DOCUMENT,166,317
4,1,17,1,4,0,72,153,1545,42,-1,,195,1617
5,1,17,1,4,1,72,153,2,13,91,|,166,74
5,1,17,1,4,2,158,154,9,10,89,Â°,164,167
5,1,17,1,4,3,530,160,138,34,96,mm/dd/yy,194,668
5,1,17,1,4,4,807,168,30,21,94,24,189,837
5,1,17,1,4,5,847,168,79,22,93,HOUR,190,926
5,1,17,1,4,6,937,169,206,22,89,NUMBER_(403),191,1143
5,1,17,1,4,7,1155,169,126,19,77,296-3000,188,1281
5,1,17,1,4,8,1318,172,138,22,77,-NUMERO,194,1456
5,1,17,1,4,9,1466,173,29,21,95,24,194,1495
5,1,17,1,4,10,1506,173,111,22,95,HEURES,195,1617
4,1,17,1,5,0,156,191,1224,33,-1,,224,1380
5,1,17,1,5,1,156,191,110,19,95,0114763,210,266
5,1,17,1,5,2,288,192,94,20,96,10/002,212,382
5,1,17,1,5,3,536,194,129,21,96,10/08/24,215,665
5,1,17,1,5,4,1057,200,232,23,93,COLLECT,223,1289
5,1,17,1,5,5,1187,193,15,35,92,-,228,1202
5,1,17,1,5,6,1216,200,71,23,89,FRAIS,223,1287
5,1,17,1,5,7,1298,202,82,22,89,VIRES,224,1380
4,1,17,1,6,0,86,218,1553,42,-1,,260,1639
5,1,17,1,6,1,86,218,197,20,92,CONSIGNEE/CUSTOMER,238,283
5,1,17,1,6,2,288,232,5,2,85,-,234,293
5,1,17,1,6,3,299,225,182,14,85,DESTINATAIRE/CLIENT,239,481
5,1,17,1,6,4,696,238,17,12,8,NeD,250,713
5,1,17,1,6,5,733,227,12,23,27,et,250,745
5,1,17,1,6,6,749,238,23,12,26,ASL,250,772
5,1,17,1,6,7,774,227,71,23,0,Sectiewr,250,845
5,1,17,1,6,8,857,221,9,33,93,|,254,866
5,1,17,1,6,9,871,229,101,14,91,CONSIGNOR,243,972
5,1,17,1,6,10,978,237,5,2,92,-,239,983
5,1,17,1,6,11,989,230,105,14,92,EXPEDITEUR,244,1094
5,1,17,1,6,12,1460,224,125,36,5,Bsiickke,260,1585
5,1,17,1,6,13,1597,224,42,36,33,sal,260,1639
4,1,17,1,7,0,153,252,1426,30,-1,,282,1579
5,1,17,1,7,1,153,252,182,24,96,Mississauga,276,335
5,1,17,1,7,2,352,254,80,19,96,Lubes,273,432
5,1,17,1,7,3,452,256,97,18,96,Center,274,549
5,1,17,1,7,4,686,257,161,19,93,0000081523,276,847
5,1,17,1,7,5,867,257,183,25,90,|Mississauga,282,1050
5,1,17,1,7,6,1067,260,81,19,96,Lubes,279,1148
5,1,17,1,7,7,1168,261,97,18,96,Center,279,1265
5,1,17,1,7,8,1469,262,110,19,91,0081523,281,1579
4,1,17,1,8,0,155,283,1012,26,-1,,309,1167
5,1,17,1,8,1,155,283,45,19,95,385,302,200
5,1,17,1,8,2,221,284,146,20,96,Southdown,304,367
5,1,17,1,8,3,385,286,66,18,96,Road,304,451
5,1,17,1,8,4,686,288,228,20,68,0000000104/385,308,914
5,1,17,1,8,5,935,290,147,19,96,Southdown,309,1082
5,1,17,1,8,6,1101,291,66,18,96,Road,309,1167
4,1,17,1,9,0,152,313,1061,30,-1,,343,1213
5,1,17,1,9,1,152,313,175,25,91,"Missisauga,",338,327
5,1,17,1,9,2,352,317,33,18,93,ON,335,385
5,1,17,1,9,3,402,316,95,19,60,L5J2Y2,335,497
5,1,17,1,9,4,866,319,177,24,91,"Missisauga,",343,1043
5,1,17,1,9,5,1067,322,32,18,93,ON,340,1099
5,1,17,1,9,6,1117,322,96,18,0,L502Y2,340,1213
4,1,17,1,10,0,278,399,575,20,-1,,419,853
5,1,17,1,10,1,278,399,2,20,87,|,419,280
5,1,17,1,10,2,286,399,62,11,93,RELEASE,410,348
5,1,17,1,10,3,353,400,48,14,91,(C-of-A),414,401
5,1,17,1,10,4,406,400,59,11,96,NUMBER,411,465
5,1,17,1,10,5,576,401,78,12,96,CUSTOMER,413,654
5,1,17,1,10,6,658,402,77,11,81,PURCHASE,413,735
5,1,17,1,10,7,740,402,49,12,96,ORDER,414,789
5,1,17,1,10,8,794,402,59,12,68,NUMBER,414,853
4,1,17,1,11,0,278,416,538,20,-1,,436,816
5,1,17,1,11,1,278,423,2,13,89,|,436,280
5,1,17,1,11,2,626,416,16,10,96,No,426,642
5,1,17,1,11,3,647,416,18,11,96,DE,427,665
5,1,17,1,11,4,670,416,69,11,95,DEMANDE,427,739
5,1,17,1,11,5,743,416,18,11,90,OU,427,761
5,1,17,1,11,6,767,416,49,11,86,CLIENT,427,816
4,1,17,1,12,0,68,437,211,38,-1,,475,279
5,1,17,1,12,1,68,437,34,38,62,|_,475,102
5,1,17,1,12,2,278,440,1,23,80,|,463,279
4,1,17,1,13,0,84,472,1337,20,-1,,492,1421
5,1,17,1,13,1,84,472,73,14,92,CARRIER,486,157
5,1,17,1,13,2,162,480,5,2,92,-,482,167
5,1,17,1,13,3,172,473,137,15,92,TRANSPORTEUR,488,309
5,1,17,1,13,4,740,475,71,13,96,VEHICLE,488,811
5,1,17,1,13,5,818,476,71,13,91,NUMBER,489,889
5,1,17,1,13,6,931,476,70,14,29,LICENSE,490,1001
5,1,17,1,13,7,1007,476,70,14,96,NUMBER,490,1077
5,1,17,1,13,8,1139,478,79,14,96,ADDRESS,492,1218
5,1,17,1,13,9,1225,478,21,14,96,OF,492,1246
5,1,17,1,13,10,1252,478,57,14,96,METER,492,1309
5,1,17,1,13,11,1314,478,34,14,96,AND,492,1348
5,1,17,1,13,12,1354,479,67,13,96,TRADER,492,1421
4,1,17,1,14,0,154,498,1332,21,-1,,519,1486
5,1,17,1,14,1,154,498,113,18,96,PREMIER,516,267
5,1,17,1,14,2,286,499,64,17,96,BULK,516,350
5,1,17,1,14,3,369,500,112,18,96,SYSTEMS,518,481
5,1,17,1,14,4,585,500,112,19,96,5000234,519,697
5,1,17,1,14,5,714,489,15,34,93,|,523,729
5,1,17,1,14,6,745,498,136,14,21,NoDUVEHICULE,512,881
5,1,17,1,14,7,909,489,12,34,48,=,523,921
5,1,17,1,14,8,931,499,71,13,84,NOMBRE,512,1002
5,1,17,1,14,9,1009,499,21,13,88,DE,512,1030
5,1,17,1,14,10,1037,500,62,13,92,PERMIS,513,1099
5,1,17,1,14,11,1105,489,9,34,91,|,523,1114
5,1,17,1,14,12,1125,500,91,14,85,L'AORESSE,514,1216
5,1,17,1,14,13,1223,501,21,13,96,DE,514,1244
5,1,17,1,14,14,1250,501,57,13,96,METRE,514,1307
5,1,17,1,14,15,1313,501,20,13,96,ET,514,1333
5,1,17,1,14,16,1339,501,21,13,93,DE,514,1360
5,1,17,1,14,17,1366,502,120,13,89,COMMERCANT,515,1486
4,1,17,1,15,0,154,527,1325,31,-1,,558,1479
5,1,17,1,15,1,154,527,28,18,95,25,545,182
5,1,17,1,15,2,202,528,115,22,95,Gormley,550,317
5,1,17,1,15,3,336,528,161,20,96,Industrial,548,497
5,1,17,1,15,4,516,531,33,17,96,Dr,548,549
5,1,17,1,15,5,734,532,95,18,95,919322,550,829
5,1,17,1,15,6,1118,535,97,18,96,Suncor,553,1215
5,1,17,1,15,7,1234,536,98,22,95,Energy,558,1332
5,1,17,1,15,8,1350,536,129,19,96,Products,555,1479
4,1,17,1,16,0,152,558,1278,27,-1,,585,1430
5,1,17,1,16,1,152,558,115,18,94,GORMLEY,576,267
5,1,17,1,16,2,734,562,78,19,50,$1202,581,812
5,1,17,1,16,3,1118,565,62,19,95,3275,584,1180
5,1,17,1,16,4,1200,565,115,19,95,Rebecca,584,1315
5,1,17,1,16,5,1334,567,96,18,96,Street,585,1430
4,1,17,1,17,0,152,588,525,27,-1,,615,677
5,1,17,1,17,1,152,588,97,20,70,LOH1GO,608,249
5,1,17,1,17,2,494,589,53,25,26,BE,614,547
5,1,17,1,17,3,575,590,102,25,34,ESE,615,677
4,1,17,1,18,0,159,618,204,22,-1,,640,363
5,1,17,1,18,1,159,618,68,22,0,(226),640,227
5,1,17,1,18,2,237,619,126,19,0,338-5962,638,363
4,1,17,1,19,0,70,664,1541,34,-1,,698,1611
5,1,17,1,19,1,70,672,2,3,94,|,675,72
5,1,17,1,19,2,995,673,66,13,96,FACTOR,686,1061
5,1,17,1,19,3,1169,664,92,34,96,MEASURED,698,1261
5,1,17,1,19,4,1314,675,31,13,96,NET,688,1345
5,1,17,1,19,5,1351,675,57,13,85,LITRES,688,1408
5,1,17,1,19,6,1523,667,5,19,57,|,686,1528
5,1,17,1,19,7,1540,676,71,13,73,bensity,689,1611
4,1,17,1,20,0,84,678,1527,38,-1,,716,1611
5,1,17,1,20,1,84,678,143,13,0,PROQUCTETER,691,227
5,1,17,1,20,2,580,701,5,3,42,.,704,585
5,1,17,1,20,3,995,692,76,13,91,FACTEUR,705,1071
5,1,17,1,20,4,1183,681,57,35,96,LITRES,716,1240
5,1,17,1,20,5,1312,693,105,14,55,correctep,707,1417
5,1,17,1,20,6,1445,687,62,12,81,|TEMPC,699,1507
5,1,17,1,20,7,1517,682,10,35,65,|,717,1527
5,1,17,1,20,8,1540,695,71,13,29,pensite,708,1611
4,1,17,1,21,0,69,693,1527,38,-1,,731,1596
5,1,17,1,21,1,69,724,3,5,85,|,729,72
5,1,17,1,21,2,84,704,135,15,66,PRODUITMETER,719,219
5,1,17,1,21,3,376,693,81,14,92,PRODUCT,707,457
5,1,17,1,21,4,462,693,111,14,93,DESCRIPTION,707,573
5,1,17,1,21,5,578,689,8,42,69,-,731,586
5,1,17,1,21,6,590,695,112,14,96,DESCRIPTION,709,702
5,1,17,1,21,7,708,695,23,14,95,DU,709,731
5,1,17,1,21,8,738,696,73,13,95,PRODUIT,709,811
5,1,17,1,21,9,993,711,26,13,78,API,724,1019
5,1,17,1,21,10,1024,711,52,14,78,TABLE,725,1076
5,1,17,1,21,11,1169,712,91,13,89,MESUREES,725,1260
5,1,17,1,21,12,1324,694,36,33,46,TD,727,1360
5,1,17,1,21,13,1366,713,33,14,68,15C,727,1399
5,1,17,1,21,14,1446,713,70,14,17,â_|CELSIUS,727,1516
5,1,17,1,21,15,1522,709,10,20,63,â¬,729,1532
5,1,17,1,21,16,1540,714,56,17,25,kg/eu.m,731,1596
4,1,17,1,22,0,153,740,1424,27,-1,,767,1577
5,1,17,1,22,1,153,740,94,19,96,103265,759,247
5,1,17,1,22,2,262,736,15,34,94,|,770,277
5,1,17,1,22,3,283,742,50,18,96,NOT,760,333
5,1,17,1,22,4,350,742,148,19,96,REGULATED,761,498
5,1,17,1,22,5,516,744,81,17,96,UNDER,761,597
5,1,17,1,22,6,616,744,49,19,96,TDG,763,665
5,1,17,1,22,7,984,745,94,19,95,0.9612,764,1078
5,1,17,1,22,8,1167,746,79,19,95,25001,765,1246
5,1,17,1,22,9,1316,747,79,19,95,24031,766,1395
5,1,17,1,22,10,1450,748,61,19,13,65.7,767,1511
5,1,17,1,22,11,1533,748,44,19,13,|913,767,1577
4,1,17,1,23,0,150,771,930,24,-1,,795,1080
5,1,17,1,23,1,150,771,97,18,92,MTR222,789,247
5,1,17,1,23,2,260,767,14,32,93,|,799,274
5,1,17,1,23,3,284,773,65,18,93,HVGO,791,349
5,1,17,1,23,4,965,777,47,18,91,API,795,1012
5,1,17,1,23,5,1034,776,46,19,86,54B,795,1080
4,1,17,1,24,0,153,832,1423,28,-1,,860,1576
5,1,17,1,24,1,153,832,94,20,93,103265,852,247
5,1,17,1,24,2,259,828,16,35,93,|,863,275
5,1,17,1,24,3,283,835,49,18,96,NOT,853,332
5,1,17,1,24,4,350,835,147,18,95,REGULATED,853,497
5,1,17,1,24,5,515,836,82,19,96,UNDER,855,597
5,1,17,1,24,6,615,837,50,18,96,TDG,855,665
5,1,17,1,24,7,984,838,94,19,96,0.9615,857,1078
5,1,17,1,24,8,1167,839,79,19,96,23000,858,1246
5,1,17,1,24,9,1316,840,78,19,95,22115,859,1394
5,1,17,1,24,10,1450,840,60,19,86,65.3,859,1510
5,1,17,1,24,11,1532,841,44,19,80,|913,860,1576
4,1,17,1,25,0,150,864,930,24,-1,,888,1080
5,1,17,1,25,1,150,864,97,19,89,MTR221,883,247
5,1,17,1,25,2,258,860,15,33,89,|,893,273
5,1,17,1,25,3,284,866,65,18,92,HVGO,884,349
5,1,17,1,25,4,964,871,48,17,92,API,888,1012
5,1,17,1,25,5,1033,869,47,19,88,54B,888,1080
2,1,18,0,0,0,727,1036,122,62,-1,,1098,849
3,1,18,1,0,0,727,1036,122,62,-1,,1098,849
4,1,18,1,1,0,727,1036,122,62,-1,,1098,849
5,1,18,1,1,1,727,1036,122,62,84,PETRe,1098,849
2,1,19,0,0,0,504,1148,394,84,-1,,1232,898
3,1,19,1,0,0,504,1148,394,84,-1,,1232,898
4,1,19,1,1,0,504,1148,394,44,-1,,1192,898
5,1,19,1,1,1,504,1152,76,34,0,Sh,1186,580
5,1,19,1,1,2,610,1148,288,44,9,JocornO8-'0-94,1192,898
4,1,19,1,2,0,512,1192,240,40,-1,,1232,752
5,1,19,1,2,1,508,1188,77,51,0,Our,1239,585
5,1,19,1,2,2,597,1192,123,39,0,l8:957,1231,720
2,1,20,0,0,0,314,1417,379,23,-1,,1440,693
3,1,20,1,0,0,314,1417,379,23,-1,,1440,693
4,1,20,1,1,0,314,1417,379,23,-1,,1440,693
5,1,20,1,1,1,314,1417,81,19,95,Total,1436,395
5,1,20,1,1,2,414,1417,96,19,95,Litres,1436,510
5,1,20,1,1,3,529,1418,33,22,96,by,1440,562
5,1,20,1,1,4,581,1418,112,19,96,Product,1437,693
2,1,21,0,0,0,260,658,6,1074,-1,,1732,266
3,1,21,1,0,0,260,658,6,1074,-1,,1732,266
4,1,21,1,1,0,260,658,6,1074,-1,,1732,266
5,1,21,1,1,1,260,658,6,1074,95, ,1732,266
2,1,22,0,0,0,938,663,5,1068,-1,,1731,943
3,1,22,1,0,0,938,663,5,1068,-1,,1731,943
4,1,22,1,1,0,938,663,5,1068,-1,,1731,943
5,1,22,1,1,1,938,663,5,1068,95, ,1731,943
2,1,23,0,0,0,1132,664,6,1072,-1,,1736,1138
3,1,23,1,0,0,1132,664,6,1072,-1,,1736,1138
4,1,23,1,1,0,1132,664,6,1072,-1,,1736,1138
5,1,23,1,1,1,1132,664,6,1072,95, ,1736,1138
2,1,24,0,0,0,1438,666,5,1071,-1,,1737,1443
3,1,24,1,0,0,1438,666,5,1071,-1,,1737,1443
4,1,24,1,1,0,1438,666,5,1071,-1,,1737,1443
5,1,24,1,1,1,1438,666,5,1071,95, ,1737,1443
2,1,25,0,0,0,1521,728,5,1010,-1,,1738,1526
3,1,25,1,0,0,1521,728,5,1010,-1,,1738,1526
4,1,25,1,1,0,1521,728,5,1010,-1,,1738,1526
5,1,25,1,1,1,1521,728,5,1010,95, ,1738,1526
2,1,26,0,0,0,114,1730,1519,8,-1,,1738,1633
3,1,26,1,0,0,114,1730,1519,8,-1,,1738,1633
4,1,26,1,1,0,114,1730,1519,8,-1,,1738,1633
5,1,26,1,1,1,114,1730,1519,8,95, ,1738,1633
2,1,27,0,0,0,1286,665,5,1142,-1,,1807,1291
3,1,27,1,0,0,1286,665,5,1142,-1,,1807,1291
4,1,27,1,1,0,1286,665,5,1142,-1,,1807,1291
5,1,27,1,1,1,1286,665,5,1142,95, ,1807,1291
2,1,28,0,0,0,799,1733,2,86,-1,,1819,801
3,1,28,1,0,0,799,1733,2,86,-1,,1819,801
4,1,28,1,1,0,799,1733,2,86,-1,,1819,801
5,1,28,1,1,1,799,1733,2,86,95, ,1819,801
2,1,29,0,0,0,1215,1735,2,86,-1,,1821,1217
3,1,29,1,0,0,1215,1735,2,86,-1,,1821,1217
4,1,29,1,1,0,1215,1735,2,86,-1,,1821,1217
5,1,29,1,1,1,1215,1735,2,86,95, ,1821,1217
2,1,30,0,0,0,86,1814,1547,8,-1,,1822,1633
3,1,30,1,0,0,86,1814,1547,8,-1,,1822,1633
4,1,30,1,1,0,86,1814,1547,8,-1,,1822,1633
5,1,30,1,1,1,86,1814,1547,8,95, ,1822,1633
2,1,31,0,0,0,66,127,9,1770,-1,,1897,75
3,1,31,1,0,0,66,127,9,1770,-1,,1897,75
4,1,31,1,1,0,66,127,9,1770,-1,,1897,75
5,1,31,1,1,1,66,127,9,1770,95, ,1897,75
2,1,32,0,0,0,1631,133,9,1769,-1,,1902,1640
3,1,32,1,0,0,1631,133,9,1769,-1,,1902,1640
4,1,32,1,1,0,1631,133,9,1769,-1,,1902,1640
5,1,32,1,1,1,1631,133,9,1769,95, ,1902,1640
2,1,33,0,0,0,80,1447,1495,454,-1,,1901,1575
3,1,33,1,0,0,80,1447,1495,454,-1,,1901,1575
4,1,33,1,1,0,283,1447,1110,24,-1,,1471,1393
5,1,33,1,1,1,283,1447,94,19,96,103265,1466,377
5,1,33,1,1,2,481,1449,63,18,92,HVGO,1467,544
5,1,33,1,1,3,1164,1452,79,18,92,48001,1470,1243
5,1,33,1,1,4,1314,1452,79,19,95,46146,1471,1393
4,1,33,1,2,0,80,1730,1494,35,-1,,1765,1574
5,1,33,1,2,1,80,1730,62,22,93,DRIVER,1752,142
5,1,33,1,2,2,147,1738,95,14,85,SIGNATURE,1752,242
5,1,33,1,2,3,247,1746,5,2,85,-,1748,252
5,1,33,1,2,4,258,1739,95,14,95,SIGNATURE,1753,353
5,1,33,1,2,5,359,1740,23,13,93,DU,1753,382
5,1,33,1,2,6,388,1740,116,14,78,CONDUCTEUR,1754,504
5,1,33,1,2,7,867,1738,60,25,0,Awa,1763,927
5,1,33,1,2,8,1032,1739,73,24,45,DEBUT,1763,1105
5,1,33,1,2,9,1083,1734,20,39,47,EU,1773,1103
5,1,33,1,2,10,1107,1739,98,24,0,coaneeuenr,1763,1205
5,1,33,1,2,11,1213,1734,10,39,84,|,1773,1223
5,1,33,1,2,12,1249,1740,22,24,46,in,1764,1271
5,1,33,1,2,13,1281,1740,56,24,0,BOHRA,1764,1337
5,1,33,1,2,14,1343,1740,53,25,0,een,1765,1396
5,1,33,1,2,15,1508,1741,66,24,32,aT,1765,1574
4,1,33,1,3,0,864,1787,694,21,-1,,1808,1558
5,1,33,1,3,1,864,1787,79,19,92,10:04,1806,943
5,1,33,1,3,2,1064,1787,79,20,95,10:04,1807,1143
5,1,33,1,3,3,1298,1789,60,19,89,0:19,1808,1358
5,1,33,1,3,4,1480,1789,78,19,96,10:19,1808,1558
4,1,33,1,4,0,80,1819,1495,31,-1,,1850,1575
5,1,33,1,4,1,80,1819,60,13,96,DRIVER,1832,140
5,1,33,1,4,2,147,1819,46,14,93,NAME,1833,193
5,1,33,1,4,3,199,1827,5,3,90,-,1830,204
5,1,33,1,4,4,210,1819,36,15,96,NOM,1834,246
5,1,33,1,4,5,253,1819,21,15,93,DU,1834,274
5,1,33,1,4,6,281,1820,117,14,91,CONDUCTEUR,1834,398
5,1,33,1,4,7,599,1821,62,14,89,ORIVER,1835,661
5,1,33,1,4,8,666,1821,11,14,87,NI,1835,677
5,1,33,1,4,9,690,1822,47,28,88,MBER,1850,737
5,1,33,1,4,10,748,1839,6,3,46,x,1842,754
5,1,33,1,4,11,1287,1824,53,14,96,TOTAL,1838,1340
5,1,33,1,4,12,1346,1824,82,14,93,QUANTITY,1838,1428
5,1,33,1,4,13,1434,1831,4,3,91,-,1834,1438
5,1,33,1,4,14,1444,1824,61,14,89,QUANT.,1838,1505
5,1,33,1,4,15,1511,1825,64,13,50,TOTALE,1838,1575
4,1,33,1,5,0,585,1835,907,35,-1,,1870,1492
5,1,33,1,5,1,585,1835,20,14,86,No,1849,605
5,1,33,1,5,2,611,1836,133,14,64,DUCONDUCTELR,1850,744
5,1,33,1,5,3,765,1839,9,10,64,*,1849,774
5,1,33,1,5,4,783,1839,93,23,95,Volume,1862,876
5,1,33,1,5,5,885,1840,114,22,95,corrected,1862,999
5,1,33,1,5,6,1008,1841,23,21,96,to,1862,1031
5,1,33,1,5,7,1042,1841,27,21,96,15,1862,1069
5,1,33,1,5,8,1080,1841,102,27,93,Degrees,1868,1182
5,1,33,1,5,9,1192,1841,18,22,68,C,1863,1210
5,1,33,1,5,10,1220,1841,9,9,68,*,1850,1229
5,1,33,1,5,11,1297,1850,78,19,95,48001,1869,1375
5,1,33,1,5,12,1395,1850,97,20,95,Litres,1870,1492
4,1,33,1,6,0,149,1878,1273,23,-1,,1901,1422
5,1,33,1,6,1,149,1878,163,19,91,GURLALDEEP,1897,312
5,1,33,1,6,2,348,1880,80,18,61,SINGH,1898,428
5,1,33,1,6,3,614,1880,127,19,95,56018353,1899,741
5,1,33,1,6,4,1297,1882,78,19,80,42131,1901,1375
5,1,33,1,6,5,1395,1882,27,19,80,kg,1901,1422
2,1,34,0,0,0,61,1884,1578,270,-1,,2154,1639
3,1,34,1,0,0,61,1884,1578,270,-1,,2154,1639
4,1,34,1,1,0,61,1884,1578,270,-1,,2154,1639
5,1,34,1,1,1,61,1884,1578,270,95,   ,2154,1639
5,1,34,1,1,2,428,1884,186,24,95, ,1908,614
5,1,34,1,1,3,741,1884,556,24,95, ,1908,1297
5,1,34,1,1,4,1422,1884,217,26,95,  ,1910,1639
2,1,35,0,0,0,88,1909,1523,50,-1,,1959,1611
3,1,35,1,0,0,88,1909,1523,50,-1,,1959,1611
4,1,35,1,1,0,88,1909,1523,17,-1,,1926,1611
5,1,35,1,1,1,88,1909,68,12,94,PRODUCT,1921,156
5,1,35,1,1,2,228,1910,36,12,88,TANK,1922,264
5,1,35,1,1,3,269,1910,68,12,95,CAPACITY,1922,337
5,1,35,1,1,4,380,1911,48,11,91,WATER,1922,428
5,1,35,1,1,5,434,1911,46,11,91,DIP/CM,1922,480
5,1,35,1,1,6,485,1904,6,28,94,|,1932,491
5,1,35,1,1,7,493,1911,56,11,82,BEFORE,1922,549
5,1,35,1,1,8,554,1911,31,12,82,DIPS,1923,585
5,1,35,1,1,9,595,1904,8,28,94,|,1932,603
5,1,35,1,1,10,609,1912,46,11,39,AFTER,1923,655
5,1,35,1,1,11,659,1912,31,11,39,DIPS,1923,690
5,1,35,1,1,12,702,1904,10,28,91,|,1932,712
5,1,35,1,1,13,718,1912,53,12,96,ENDING,1924,771
5,1,35,1,1,14,776,1912,50,12,96,INVENT,1924,826
5,1,35,1,1,15,870,1912,69,12,95,PRODUCT,1924,939
5,1,35,1,1,16,1008,1913,37,11,81,TANK,1924,1045
5,1,35,1,1,17,1050,1913,70,11,93,CAPACITY,1924,1120
5,1,35,1,1,18,1163,1914,48,11,93,WATER,1925,1211
5,1,35,1,1,19,1217,1910,53,15,15,DIP/CM),1925,1270
5,1,35,1,1,20,1283,1914,55,12,92,BEFORE,1926,1338
5,1,35,1,1,21,1343,1914,30,12,12,DIPS,1926,1373
5,1,35,1,1,22,1376,1906,8,29,12,|,1935,1384
5,1,35,1,1,23,1392,1914,45,12,73,AFTER,1926,1437
5,1,35,1,1,24,1442,1914,31,12,73,DIPS,1926,1473
5,1,35,1,1,25,1485,1906,10,29,88,|,1935,1495
5,1,35,1,1,26,1503,1914,53,12,62,ENDING,1926,1556
5,1,35,1,1,27,1561,1915,50,11,62,INVENT,1926,1611
4,1,35,1,2,0,91,1919,1508,31,-1,,1950,1599
5,1,35,1,2,1,91,1926,61,11,53,PRODUIT,1937,152
5,1,35,1,2,2,231,1927,95,11,84,CONTENANCE,1938,326
5,1,35,1,2,3,397,1919,67,28,86,MEASURE,1947,464
5,1,35,1,2,4,506,1928,46,11,92,AVANT,1939,552
5,1,35,1,2,5,557,1928,15,11,92,LE,1939,572
5,1,35,1,2,6,618,1929,46,10,72,APRES,1939,664
5,1,35,1,2,7,668,1929,17,10,72,LE,1939,685
5,1,35,1,2,8,732,1929,82,10,92,INVENTAIRE,1939,814
5,1,35,1,2,9,874,1930,61,10,96,PRODUIT,1940,935
5,1,35,1,2,10,1012,1922,97,28,66,CONTENANCE,1950,1109
5,1,35,1,2,11,1177,1922,67,28,66,"MEASURE,",1950,1244
5,1,35,1,2,12,1290,1931,46,10,94,AVANT,1941,1336
5,1,35,1,2,13,1341,1931,16,10,77,LE,1941,1357
5,1,35,1,2,14,1398,1931,66,10,90,APRESLE,1941,1464
5,1,35,1,2,15,1518,1932,81,10,0,"INVENTAIRE,",1942,1599
4,1,35,1,3,0,229,1943,1348,16,-1,,1959,1577
5,1,35,1,3,1,229,1943,17,11,91,DU,1954,246
5,1,35,1,3,2,252,1943,80,11,91,RESERVIOR,1954,332
5,1,35,1,3,3,399,1944,63,11,52,DEAU/CM,1955,462
5,1,35,1,3,4,504,1944,74,11,66,JAUGEAGE,1955,578
5,1,35,1,3,5,591,1937,10,28,84,|,1965,601
5,1,35,1,3,6,614,1944,76,12,84,JAUGEAGE,1956,690
5,1,35,1,3,7,748,1945,47,11,90,APRES,1956,795
5,1,35,1,3,8,1010,1946,18,11,92,DU,1957,1028
5,1,35,1,3,9,1034,1946,81,11,92,RESERVIOR,1957,1115
5,1,35,1,3,10,1179,1946,63,11,78,DEAUICM,1957,1242
5,1,35,1,3,11,1287,1946,74,12,92,JAUGEAGE,1958,1361
5,1,35,1,3,12,1374,1939,12,28,77,|,1967,1386
5,1,35,1,3,13,1398,1947,74,12,77,JAUGEAGE,1959,1472
5,1,35,1,3,14,1530,1947,47,12,92,APRES,1959,1577
2,1,36,0,0,0,73,1957,1556,8,-1,,1965,1629
3,1,36,1,0,0,73,1957,1556,8,-1,,1965,1629
4,1,36,1,1,0,73,1957,1556,8,-1,,1965,1629
5,1,36,1,1,1,73,1957,1556,8,95, ,1965,1629
2,1,37,0,0,0,75,2019,1554,8,-1,,2027,1629
3,1,37,1,0,0,75,2019,1554,8,-1,,2027,1629
4,1,37,1,1,0,75,2019,1554,8,-1,,2027,1629
5,1,37,1,1,1,75,2019,1554,8,95, ,2027,1629
2,1,38,0,0,0,71,2081,1558,7,-1,,2088,1629
3,1,38,1,0,0,71,2081,1558,7,-1,,2088,1629
4,1,38,1,1,0,71,2081,1558,7,-1,,2088,1629
5,1,38,1,1,1,71,2081,1558,7,95, ,2088,1629
2,1,39,0,0,0,177,1903,2,228,-1,,2131,179
3,1,39,1,0,0,177,1903,2,228,-1,,2131,179
4,1,39,1,1,0,177,1903,2,228,-1,,2131,179
5,1,39,1,1,1,177,1903,2,228,95, ,2131,179
2,1,40,0,0,0,486,1904,2,238,-1,,2142,488
3,1,40,1,0,0,486,1904,2,238,-1,,2142,488
4,1,40,1,1,0,486,1904,2,238,-1,,2142,488
5,1,40,1,1,1,486,1904,2,238,95, ,2142,488
2,1,41,0,0,0,956,1906,3,237,-1,,2143,959
3,1,41,1,0,0,956,1906,3,237,-1,,2143,959
4,1,41,1,1,0,956,1906,3,237,-1,,2143,959
5,1,41,1,1,1,956,1906,3,237,95, ,2143,959
2,1,42,0,0,0,1156,1907,4,237,-1,,2144,1160
3,1,42,1,0,0,1156,1907,4,237,-1,,2144,1160
4,1,42,1,1,0,1156,1907,4,237,-1,,2144,1160
5,1,42,1,1,1,1156,1907,4,237,95, ,2144,1160
2,1,43,0,0,0,1378,1908,5,237,-1,,2145,1383
3,1,43,1,0,0,1378,1908,5,237,-1,,2145,1383
4,1,43,1,1,0,1378,1908,5,237,-1,,2145,1383
5,1,43,1,1,1,1378,1908,5,237,95, ,2145,1383
2,1,44,0,0,0,1268,1933,2,211,-1,,2144,1270
3,1,44,1,0,0,1268,1933,2,211,-1,,2144,1270
4,1,44,1,1,0,1268,1933,2,211,-1,,2144,1270
5,1,44,1,1,1,1268,1933,2,211,95, ,2144,1270
2,1,45,0,0,0,42,2159,1623,19,-1,,2178,1665
3,1,45,1,0,0,42,2159,1623,19,-1,,2178,1665
4,1,45,1,1,0,42,2159,1623,19,-1,,2178,1665
5,1,45,1,1,1,42,2159,12,14,66,A,2173,54
5,1,45,1,1,2,58,2159,53,15,66,Suncor,2174,111
5,1,45,1,1,3,116,2160,65,14,90,business,2174,181
5,1,45,1,1,4,186,2160,5,14,90,/,2174,191
5,1,45,1,1,5,197,2160,30,14,93,Une,2174,227
5,1,45,1,1,6,233,2160,73,16,91,entreprise,2176,306
5,1,45,1,1,7,311,2161,18,13,96,de,2174,329
5,1,45,1,1,8,335,2160,53,14,96,Suncor,2174,388
5,1,45,1,1,9,1556,2161,53,13,33,112791,2174,1609
5,1,45,1,1,10,1615,2161,50,17,52,(05!17),2178,1665
1,1,0,0,0,0,0,0,1700,2200,-1,,2200,1700
2,1,1,0,0,0,903,93,610,22,-1,,115,1513
3,1,1,1,0,0,903,93,610,22,-1,,115,1513
4,1,1,1,1,0,903,93,610,22,-1,,115,1513
5,1,1,1,1,1,903,93,116,21,96,VEHICLE,114,1019
5,1,1,1,1,2,1031,94,121,21,96,LOADING,115,1152
5,1,1,1,1,3,1164,94,112,20,93,REPORT,114,1276
5,1,1,1,1,4,1274,89,12,36,91,-,125,1286
5,1,1,1,1,5,1304,94,53,20,94,BILL,114,1357
5,1,1,1,1,6,1367,94,36,20,93,OF,114,1403
5,1,1,1,1,7,1414,93,99,21,90,LADING,114,1513
2,1,2,0,0,0,854,142,767,5,-1,,147,1621
3,1,2,1,0,0,854,142,767,5,-1,,147,1621
4,1,2,1,1,0,854,142,767,5,-1,,147,1621
5,1,2,1,1,1,854,142,767,5,95, ,147,1621
2,1,3,0,0,0,812,242,672,1,-1,,243,1484
3,1,3,1,0,0,812,242,672,1,-1,,243,1484
4,1,3,1,1,0,812,242,672,1,-1,,243,1484
5,1,3,1,1,1,812,242,672,1,95, ,243,1484
2,1,4,0,0,0,55,119,1563,207,-1,,326,1618
3,1,4,1,0,0,55,119,1563,207,-1,,326,1618
4,1,4,1,1,0,139,119,1479,28,-1,,147,1618
5,1,4,1,1,1,139,122,74,22,95,Page:,144,213
5,1,4,1,1,2,239,122,12,18,89,1,140,251
5,1,4,1,1,3,420,144,7,1,0,_,145,427
5,1,4,1,1,4,471,122,44,19,0,530,141,515
5,1,4,1,1,5,683,144,22,1,22,_,145,705
5,1,4,1,1,6,807,120,131,27,96,RAPPORT,147,938
5,1,4,1,1,7,949,120,35,21,92,DE,141,984
5,1,4,1,1,8,995,120,195,22,91,CHARGEMENT,142,1190
5,1,4,1,1,9,1199,132,7,3,92,-,135,1206
5,1,4,1,1,10,1217,120,134,21,91,VEHICULE,141,1351
5,1,4,1,1,11,1362,132,7,2,91,-,134,1369
5,1,4,1,1,12,1379,119,239,22,91,CONNAISSEMENT,141,1618
4,1,4,1,2,0,128,148,535,25,-1,,173,663
5,1,4,1,2,1,128,150,110,16,0,DOCUMENT,166,238
5,1,4,1,2,2,244,151,82,15,0,NUMBER,166,326
5,1,4,1,2,3,355,152,61,18,88,6891,170,416
5,1,4,1,2,4,470,149,1,3,87,|,152,471
5,1,4,1,2,5,528,148,37,24,35,pate,172,565
5,1,4,1,2,6,571,143,92,37,0,bexeeoition,180,663
4,1,4,1,3,0,128,167,1473,42,-1,,209,1601
5,1,4,1,3,1,128,170,23,15,96,No,185,151
5,1,4,1,3,2,158,170,25,15,92,DU,185,183
5,1,4,1,3,3,190,170,111,15,90,DOGUMENT,185,301
5,1,4,1,3,4,514,167,137,42,0,mm/dd/yy,209,651
5,1,4,1,3,5,791,186,29,20,94,24,206,820
5,1,4,1,3,6,831,185,78,22,94,HOUR,207,909
5,1,4,1,3,7,921,185,116,22,0,NUMBER,207,1037
5,1,4,1,3,8,1059,183,206,21,0,_(613)996-6666,204,1265
5,1,4,1,3,9,1302,197,7,3,83,-,200,1309
5,1,4,1,3,10,1320,184,120,23,95,NUMERO,207,1440
5,1,4,1,3,11,1450,186,29,20,94,24,206,1479
5,1,4,1,3,12,1490,184,111,22,95,HEURES,206,1601
4,1,4,1,4,0,140,212,1223,26,-1,,238,1363
5,1,4,1,4,1,140,212,109,19,95,0362663,231,249
5,1,4,1,4,2,272,212,93,20,96,10/007,232,365
5,1,4,1,4,3,520,213,129,20,95,10/08/24,233,649
5,1,4,1,4,4,1041,216,232,22,92,COLLECT,238,1273
5,1,4,1,4,5,1173,212,15,34,89,-,246,1188
5,1,4,1,4,6,1198,216,75,22,91,FRAIS,238,1273
5,1,4,1,4,7,1283,216,80,22,91,VIRES,238,1363
4,1,4,1,5,0,55,222,1510,51,-1,,273,1565
5,1,4,1,5,1,55,238,3,4,50,|,242,58
5,1,4,1,5,2,73,222,203,45,50,CONSIGNESICUSTOMER-,267,276
5,1,4,1,5,3,287,222,177,45,20,DESTINATAIRECLENT,267,464
5,1,4,1,5,4,664,245,2,28,88,|,273,666
5,1,4,1,5,5,680,242,148,25,0,NeGetaelsseuewr,267,828
5,1,4,1,5,6,844,243,2,26,93,|,269,846
5,1,4,1,5,7,855,246,222,13,88,CONSIGNOR,259,1077
5,1,4,1,5,8,960,236,8,41,89,-,277,968
5,1,4,1,5,9,977,243,100,26,87,EXPEDITEUR,269,1077
5,1,4,1,5,10,1457,241,50,26,7,eal,267,1507
5,1,4,1,5,11,1518,241,47,26,16,eter,267,1565
4,1,4,1,6,0,55,274,1557,30,-1,,304,1612
5,1,4,1,6,1,55,276,1,5,93,|,281,56
5,1,4,1,6,2,138,274,81,19,92,PETRO,293,219
5,1,4,1,6,3,236,274,99,19,96,CANADA,293,335
5,1,4,1,6,4,352,275,164,18,95,LUBRICANTS,293,516
5,1,4,1,6,5,536,275,47,18,96,INC,293,583
5,1,4,1,6,6,663,274,168,22,53,(0005064508,296,831
5,1,4,1,6,7,853,276,97,17,91,SUNCOR,293,950
5,1,4,1,6,8,969,276,98,17,96,ENERGY,293,1067
5,1,4,1,6,9,1085,276,132,17,96,MONTREAL,293,1217
5,1,4,1,6,10,1441,280,1,11,84,|,291,1442
5,1,4,1,6,11,1471,274,110,30,91,0082041,304,1581
5,1,4,1,6,12,1589,302,23,1,89,_|,303,1612
4,1,4,1,7,0,138,301,1111,25,-1,,326,1249
5,1,4,1,7,1,138,306,63,16,91,PCLI,322,201
5,1,4,1,7,2,222,313,11,3,85,~,316,233
5,1,4,1,7,3,254,306,96,20,95,QUEBEC,326,350
5,1,4,1,7,4,370,305,45,18,96,302,323,415
5,1,4,1,7,5,664,302,166,21,48,0009406423,323,830
5,1,4,1,7,6,840,301,91,23,89,|11675,324,931
5,1,4,1,7,7,953,310,47,14,95,rue,324,1000
5,1,4,1,7,8,1020,306,164,18,96,Sherbrooke,324,1184
5,1,4,1,7,9,1203,308,46,16,96,est,324,1249
2,1,5,0,0,0,136,334,378,50,-1,,384,514
3,1,5,1,0,0,136,334,378,50,-1,,384,514
4,1,5,1,1,0,138,334,295,18,-1,,352,433
5,1,5,1,1,1,138,334,45,17,96,385,351,183
5,1,5,1,1,2,205,335,146,17,95,SOUTHDOWN,352,351
5,1,5,1,1,3,369,336,64,16,96,ROAD,352,433
4,1,5,1,2,0,136,364,378,20,-1,,384,514
5,1,5,1,2,1,136,364,192,20,96,"MISSISSAUGA,",384,328
5,1,5,1,2,2,352,364,33,17,92,ON,381,385
5,1,5,1,2,3,402,364,49,18,73,L5J,382,451
5,1,5,1,2,4,470,364,44,18,46,2YÂ¥3,382,514
2,1,6,0,0,0,844,317,2,49,-1,,366,846
3,1,6,1,0,0,844,317,2,49,-1,,366,846
4,1,6,1,1,0,844,317,2,49,-1,,366,846
5,1,6,1,1,1,844,317,2,49,95, ,366,846
2,1,7,0,0,0,851,336,631,21,-1,,357,1482
3,1,7,1,0,0,851,336,631,21,-1,,357,1482
4,1,7,1,1,0,851,336,631,21,-1,,357,1482
5,1,7,1,1,1,851,336,143,20,96,"Montreal,",356,994
5,1,7,1,1,2,1019,337,31,20,92,QC,357,1050
5,1,7,1,1,3,1069,336,48,18,84,H1B,354,1117
5,1,7,1,1,4,1137,336,44,18,17,iCc3,354,1181
5,1,7,1,1,5,1275,336,68,21,55,(613),357,1343
5,1,7,1,1,6,1356,336,126,18,55,996-6666,354,1482
2,1,8,0,0,0,266,376,834,85,-1,,461,1100
3,1,8,1,0,0,266,376,834,85,-1,,461,1100
4,1,8,1,1,0,844,376,256,39,-1,,415,1100
5,1,8,1,1,1,844,376,123,39,81,lvannick,415,967
5,1,8,1,1,2,984,394,116,19,95,Mercier,413,1100
4,1,8,1,2,0,266,412,571,17,-1,,429,837
5,1,8,1,2,1,266,412,66,15,52,âRELEASE,427,332
5,1,8,1,2,2,338,416,47,13,84,(C-ol-A),429,385
5,1,8,1,2,3,390,416,59,11,59,NUMBER,427,449
5,1,8,1,2,4,552,412,4,7,74,|,419,556
5,1,8,1,2,5,560,416,78,12,79,CUSTOMER,428,638
5,1,8,1,2,6,644,414,75,14,96,PURCHASE,428,719
5,1,8,1,2,7,724,417,49,11,96,ORDER,428,773
5,1,8,1,2,8,778,417,59,11,96,NUMBER,428,837
4,1,8,1,3,0,552,419,294,42,-1,,461,846
5,1,8,1,3,1,552,430,1,29,90,|,459,553
5,1,8,1,3,2,610,430,17,11,95,No,441,627
5,1,8,1,3,3,632,430,17,11,96,DE,441,649
5,1,8,1,3,4,655,431,68,11,92,DEMANDE,442,723
5,1,8,1,3,5,728,431,19,11,91,DU,442,747
5,1,8,1,3,6,752,431,49,11,91,CLIENT,442,801
5,1,8,1,3,7,844,419,2,42,88,|,461,846
2,1,9,0,0,0,309,412,534,3,-1,,415,843
3,1,9,1,0,0,309,412,534,3,-1,,415,843
4,1,9,1,1,0,309,412,534,3,-1,,415,843
5,1,9,1,1,1,309,412,534,3,95, ,415,843
2,1,10,0,0,0,552,473,2,9,-1,,482,554
3,1,10,1,0,0,552,473,2,9,-1,,482,554
4,1,10,1,1,0,552,473,2,9,-1,,482,554
5,1,10,1,1,1,552,473,2,9,62,i,482,554
2,1,11,0,0,0,117,480,705,3,-1,,483,822
3,1,11,1,0,0,117,480,705,3,-1,,483,822
4,1,11,1,1,0,117,480,705,3,-1,,483,822
5,1,11,1,1,1,117,480,705,3,95, ,483,822
2,1,12,0,0,0,705,524,918,3,-1,,527,1623
3,1,12,1,0,0,705,524,918,3,-1,,527,1623
4,1,12,1,1,0,705,524,918,3,-1,,527,1623
5,1,12,1,1,1,705,524,918,3,95, ,527,1623
2,1,13,0,0,0,705,482,2,188,-1,,670,707
3,1,13,1,0,0,705,482,2,188,-1,,670,707
4,1,13,1,1,0,705,482,2,188,-1,,670,707
5,1,13,1,1,1,705,482,2,188,95, ,670,707
2,1,14,0,0,0,289,676,309,3,-1,,679,598
3,1,14,1,0,0,289,676,309,3,-1,,679,598
4,1,14,1,1,0,289,676,309,3,-1,,679,598
5,1,14,1,1,1,289,676,309,3,95, ,679,598
2,1,15,0,0,0,757,678,640,1,-1,,679,1397
3,1,15,1,0,0,757,678,640,1,-1,,679,1397
4,1,15,1,1,0,757,678,640,1,-1,,679,1397
5,1,15,1,1,1,757,678,640,1,95, ,679,1397
2,1,16,0,0,0,55,142,2,562,-1,,704,57
3,1,16,1,0,0,55,142,2,562,-1,,704,57
4,1,16,1,1,0,55,142,2,562,-1,,704,57
5,1,16,1,1,1,55,142,2,562,95, ,704,57
2,1,17,0,0,0,58,744,1531,4,-1,,748,1589
3,1,17,1,0,0,58,744,1531,4,-1,,748,1589
4,1,17,1,1,0,58,744,1531,4,-1,,748,1589
5,1,17,1,1,1,58,744,1531,4,95, ,748,1589
2,1,18,0,0,0,992,746,597,3,-1,,749,1589
3,1,18,1,0,0,992,746,597,3,-1,,749,1589
4,1,18,1,1,0,992,746,597,3,-1,,749,1589
5,1,18,1,1,1,992,746,597,3,95, ,749,1589
2,1,19,0,0,0,53,475,1559,334,-1,,809,1612
3,1,19,1,0,0,57,475,1441,157,-1,,632,1498
4,1,19,1,1,0,57,475,788,40,-1,,515,845
5,1,19,1,1,1,57,475,241,29,12,âQARRIER-TRANSPORTEUR,504,298
5,1,19,1,1,2,844,512,1,3,57,|,515,845
4,1,19,1,2,0,137,516,1269,30,-1,,546,1406
5,1,19,1,2,1,137,516,48,18,95,GEO,534,185
5,1,19,1,2,2,202,517,17,17,94,A,534,219
5,1,19,1,2,3,236,517,65,17,94,HALL,534,301
5,1,19,1,2,4,570,516,111,19,84,0101535,535,681
5,1,19,1,2,5,698,512,15,44,29,|,556,713
5,1,19,1,2,6,726,521,147,25,0,VenicleNUMBER,546,873
5,1,19,1,2,7,916,532,70,14,25,LICENSE,546,986
5,1,19,1,2,8,992,533,70,13,25,NUMBER,546,1062
5,1,19,1,2,9,1081,526,6,1,77,|,527,1087
5,1,19,1,2,10,1125,533,78,13,0,ADDRESS,546,1203
5,1,19,1,2,11,1210,533,21,13,95,OF,546,1231
5,1,19,1,2,12,1237,533,56,13,95,METER,546,1293
5,1,19,1,2,13,1300,533,33,13,93,AND,546,1333
5,1,19,1,2,14,1339,533,67,13,96,TRADER,546,1406
4,1,19,1,3,0,139,546,1332,24,-1,,570,1471
5,1,19,1,3,1,139,546,61,18,93,8800,564,200
5,1,19,1,3,2,222,555,11,3,89,-,558,233
5,1,19,1,3,3,255,546,29,18,90,6E,564,284
5,1,19,1,3,4,302,547,148,19,89,CROISSANT,566,450
5,1,19,1,3,5,730,555,19,13,96,No,568,749
5,1,19,1,3,6,756,555,21,13,89,DU,568,777
5,1,19,1,3,7,784,555,82,13,89,VEHICULE,568,866
5,1,19,1,3,8,916,555,71,13,95,NOMBRE,568,987
5,1,19,1,3,9,994,555,21,14,92,DE,569,1015
5,1,19,1,3,10,1022,555,62,14,90,PEAMIS,569,1084
5,1,19,1,3,11,1090,548,9,31,89,|,579,1099
5,1,19,1,3,12,1111,555,90,14,74,L'ADRESSE,569,1201
5,1,19,1,3,13,1207,556,22,13,90,DE,569,1229
5,1,19,1,3,14,1234,556,57,14,90,METRE,570,1291
5,1,19,1,3,15,1298,556,19,14,96,ET,570,1317
5,1,19,1,3,16,1324,556,21,14,92,DE,570,1345
5,1,19,1,3,17,1351,556,120,14,42,COMMERCANT,570,1471
4,1,19,1,4,0,136,572,1362,36,-1,,608,1498
5,1,19,1,4,1,136,572,83,33,95,ANJOU,605,219
5,1,19,1,4,2,469,599,22,3,94,=,602,491
5,1,19,1,4,3,704,597,3,11,51,|,608,707
5,1,19,1,4,4,720,578,61,18,51,1137,596,781
5,1,19,1,4,5,1103,579,78,19,95,11675,598,1181
5,1,19,1,4,6,1203,585,46,13,95,rue,598,1249
5,1,19,1,4,7,1269,579,163,19,96,Sherbrooke,598,1432
5,1,19,1,4,8,1452,582,46,16,96,est,598,1498
4,1,19,1,5,0,136,602,1294,34,-1,,636,1430
5,1,19,1,5,1,136,608,49,18,80,Hid,626,185
5,1,19,1,5,2,204,608,45,18,63,1A1,626,249
5,1,19,1,5,3,480,606,43,25,27,RST,631,523
5,1,19,1,5,4,538,607,8,24,10,a,631,546
5,1,19,1,5,5,580,602,82,34,5,laren,636,662
5,1,19,1,5,6,720,609,61,18,95,1099,627,781
5,1,19,1,5,7,1101,609,142,21,96,"Montreal,",630,1243
5,1,19,1,5,8,1268,611,30,21,92,QC,632,1298
5,1,19,1,5,9,1318,610,48,18,86,H1B,628,1366
5,1,19,1,5,10,1386,610,44,18,25,1Â¢3,628,1430
3,1,19,2,0,0,55,635,1259,24,-1,,659,1314
4,1,19,2,1,0,55,635,1259,24,-1,,659,1314
5,1,19,2,1,1,55,635,1,5,92,|,640,56
5,1,19,2,1,2,144,636,67,21,70,(514),657,211
5,1,19,2,1,3,225,637,124,18,70,352-5550,655,349
5,1,19,2,1,4,1108,639,68,20,76,(613),659,1176
5,1,19,2,1,5,1189,639,125,18,79,996-6666,657,1314
3,1,19,3,0,0,55,664,1557,22,-1,,686,1612
4,1,19,3,1,0,55,664,1557,22,-1,,686,1612
5,1,19,3,1,1,55,664,51,13,63,â,677,106
5,1,19,3,1,2,245,676,32,2,5,â_,678,277
5,1,19,3,1,3,335,677,3,1,0,.,678,338
5,1,19,3,1,4,704,675,32,4,66,|,679,736
5,1,19,3,1,5,1273,678,18,8,27,â,686,1291
5,1,19,3,1,6,1354,678,75,3,19,ââ,681,1429
5,1,19,3,1,7,1546,679,66,1,21,_â___!,680,1612
3,1,19,4,0,0,68,687,1520,32,-1,,719,1588
4,1,19,4,1,0,1155,687,91,13,-1,,700,1246
5,1,19,4,1,1,1155,687,91,13,95,MEASURED,700,1246
4,1,19,4,2,0,68,685,1520,34,-1,,719,1588
5,1,19,4,2,1,68,685,143,34,92,PRODUCT/METER,719,211
5,1,19,4,2,2,565,718,4,1,30,7,719,569
5,1,19,4,2,3,1169,706,56,13,46,ay,719,1225
5,1,19,4,2,4,1298,698,104,13,92,CORRECTED,711,1402
5,1,19,4,2,5,1413,687,9,34,80,|,721,1422
5,1,19,4,2,6,1430,698,46,13,96,TEMP,711,1476
5,1,19,4,2,7,1489,687,12,34,96,|,721,1501
5,1,19,4,2,8,1518,698,70,13,96,DENSITY,711,1588
3,1,19,5,0,0,53,707,1535,102,-1,,809,1588
4,1,19,5,1,0,53,707,1535,41,-1,,748,1588
5,1,19,5,1,1,53,740,3,6,87,|,746,56
5,1,19,5,1,2,68,723,135,13,0,proourtavereR,736,203
5,1,19,5,1,3,360,710,81,13,96,PRODUCT,723,441
5,1,19,5,1,4,447,710,112,13,91,DESCRIPTION,723,559
5,1,19,5,1,5,562,700,9,33,93,-,733,571
5,1,19,5,1,6,576,710,111,13,94,DESCRIPTION,723,687
5,1,19,5,1,7,694,711,21,13,96,DU,724,715
5,1,19,5,1,8,722,711,75,13,96,PRODUIT,724,797
5,1,19,5,1,9,940,707,1,22,95,|,729,941
5,1,19,5,1,10,959,747,12,1,49,7,748,971
5,1,19,5,1,11,1155,725,46,14,0,Meat,739,1201
5,1,19,5,1,12,1217,725,29,14,0,ces,739,1246
5,1,19,5,1,13,1323,726,61,13,49,70150.,739,1384
5,1,19,5,1,14,1420,726,72,22,49,|cetsius|,748,1492
5,1,19,5,1,15,1518,726,70,13,25,ensite,739,1588
4,1,19,5,2,0,138,758,1442,21,-1,,779,1580
5,1,19,5,2,1,138,758,94,18,94,103265,776,232
5,1,19,5,2,2,246,753,15,33,94,|,786,261
5,1,19,5,2,3,268,759,49,18,95,NOT,777,317
5,1,19,5,2,4,335,759,148,18,96,REGULATED,777,483
5,1,19,5,2,5,500,760,83,17,96,UNDER,777,583
5,1,19,5,2,6,600,760,49,17,96,TDG,777,649
5,1,19,5,2,7,969,760,95,17,95,0.9651,777,1064
5,1,19,5,2,8,1169,760,78,18,95,44001,778,1247
5,1,19,5,2,9,1318,760,79,18,92,42465,778,1397
5,1,19,5,2,10,1419,760,61,18,81,|60.6,778,1480
5,1,19,5,2,11,1502,760,78,19,83,|910.6,779,1580
4,1,19,5,3,0,135,788,947,21,-1,,809,1082
5,1,19,5,3,1,135,788,97,17,91,MTR271,805,232
5,1,19,5,3,2,244,784,14,31,92,|,815,258
5,1,19,5,3,3,268,789,82,16,95,HEAVY,805,350
5,1,19,5,3,4,367,789,100,18,93,VACUUM,807,467
5,1,19,5,3,5,484,789,98,18,77,GASOIL,807,582
5,1,19,5,3,6,590,789,85,20,77,(HVGO),809,675
5,1,19,5,3,7,967,791,47,16,93,API,807,1014
5,1,19,5,3,8,1036,789,46,18,75,54B,807,1082
2,1,20,0,0,0,467,871,291,69,-1,,940,758
3,1,20,1,0,0,467,871,291,69,-1,,940,758
4,1,20,1,1,0,467,871,291,69,-1,,940,758
5,1,20,1,1,1,467,875,91,65,78,(42,940,558
5,1,20,1,1,2,618,871,140,57,81,(0.%,928,758
2,1,21,0,0,0,446,969,360,84,-1,,1053,806
3,1,21,1,0,0,446,969,360,84,-1,,1053,806
4,1,21,1,1,0,696,969,110,32,-1,,1001,806
5,1,21,1,1,1,696,969,110,32,43,a,1001,806
4,1,21,1,2,0,446,994,321,59,-1,,1053,767
5,1,21,1,2,1,446,994,108,59,70,oot,1053,554
5,1,21,1,2,2,592,1002,175,47,66,10.52,1049,767
2,1,22,0,0,0,413,1068,1083,178,-1,,1246,1496
3,1,22,1,0,0,413,1068,1083,178,-1,,1246,1496
4,1,22,1,1,0,413,1068,496,86,-1,,1154,909
5,1,22,1,1,1,413,1085,157,69,75,Back,1154,570
5,1,22,1,1,2,637,1092,17,54,79,f,1146,654
5,1,22,1,1,3,722,1083,47,49,17,tr,1132,769
5,1,22,1,1,4,794,1068,115,78,17,pol,1146,909
4,1,22,1,2,0,445,1189,1051,57,-1,,1246,1496
5,1,22,1,2,1,445,1204,42,42,43,g,1246,487
5,1,22,1,2,2,549,1189,96,57,53,och,1246,645
5,1,22,1,2,3,697,1198,153,44,25,BORK,1242,850
5,1,22,1,2,4,1495,1210,1,6,71,|,1216,1496
2,1,23,0,0,0,54,921,2,363,-1,,1284,56
3,1,23,1,0,0,54,921,2,363,-1,,1284,56
4,1,23,1,1,0,54,921,2,363,-1,,1284,56
5,1,23,1,1,1,54,921,2,363,95, ,1284,56
2,1,24,0,0,0,52,1489,1345,53,-1,,1542,1397
3,1,24,1,0,0,52,1489,1345,53,-1,,1542,1397
4,1,24,1,1,0,52,1489,628,24,-1,,1513,680
5,1,24,1,1,1,52,1503,1,10,90,|,1513,53
5,1,24,1,1,2,300,1489,80,19,96,Total,1508,380
5,1,24,1,1,3,400,1489,96,19,96,Litres,1508,496
5,1,24,1,1,4,516,1489,32,23,96,by,1512,548
5,1,24,1,1,5,567,1489,113,19,96,Product,1508,680
4,1,24,1,2,0,52,1517,1345,25,-1,,1542,1397
5,1,24,1,2,1,52,1517,1,11,94,|,1528,53
5,1,24,1,2,2,269,1519,93,19,96,103265,1538,362
5,1,24,1,2,3,466,1521,82,17,96,HEAVY,1538,548
5,1,24,1,2,4,565,1521,101,18,93,VACUUM,1539,666
5,1,24,1,2,5,683,1521,192,21,48,GASOIL(HVGO),1542,875
5,1,24,1,2,6,1168,1522,79,18,96,44001,1540,1247
5,1,24,1,2,7,1318,1522,79,18,95,42465,1540,1397
2,1,25,0,0,0,247,676,4,1012,-1,,1688,251
3,1,25,1,0,0,247,676,4,1012,-1,,1688,251
4,1,25,1,1,0,247,676,4,1012,-1,,1688,251
5,1,25,1,1,1,247,676,4,1012,95, ,1688,251
2,1,26,0,0,0,1119,678,4,1013,-1,,1691,1123
3,1,26,1,0,0,1119,678,4,1013,-1,,1691,1123
4,1,26,1,1,0,1119,678,4,1013,-1,,1691,1123
5,1,26,1,1,1,1119,678,4,1013,95, ,1691,1123
2,1,27,0,0,0,1412,706,2,985,-1,,1691,1414
3,1,27,1,0,0,1412,706,2,985,-1,,1691,1414
4,1,27,1,1,0,1412,706,2,985,-1,,1691,1414
5,1,27,1,1,1,1412,706,2,985,95, ,1691,1414
2,1,28,0,0,0,1273,717,2,974,-1,,1691,1275
3,1,28,1,0,0,1273,717,2,974,-1,,1691,1275
4,1,28,1,1,0,1273,717,2,974,-1,,1691,1275
5,1,28,1,1,1,1273,717,2,974,95, ,1691,1275
2,1,29,0,0,0,53,1698,982,61,-1,,1759,1035
3,1,29,1,0,0,53,1698,982,61,-1,,1759,1035
4,1,29,1,1,0,53,1698,876,20,-1,,1718,929
5,1,29,1,1,1,53,1698,1,18,95,|,1716,54
5,1,29,1,1,2,66,1699,58,16,47,(hereby,1715,124
5,1,29,1,1,3,130,1699,54,13,95,declare,1712,184
5,1,29,1,1,4,189,1699,27,13,91,that,1712,216
5,1,29,1,1,5,222,1699,22,13,96,the,1712,244
5,1,29,1,1,6,249,1701,61,11,96,contents,1712,310
5,1,29,1,1,7,316,1700,13,12,96,of,1712,329
5,1,29,1,1,8,334,1700,24,13,96,this,1713,358
5,1,29,1,1,9,365,1700,93,16,96,consignment,1716,458
5,1,29,1,1,10,464,1703,22,10,96,are,1713,486
5,1,29,1,1,11,492,1701,28,15,96,fully,1716,520
5,1,29,1,1,12,527,1701,25,13,96,and,1714,552
5,1,29,1,1,13,559,1701,75,16,92,accurately,1717,634
5,1,29,1,1,14,639,1701,71,13,96,described,1714,710
5,1,29,1,1,15,716,1701,44,13,94,above,1714,760
5,1,29,1,1,16,766,1701,16,17,94,by,1718,782
5,1,29,1,1,17,788,1701,22,13,96,the,1714,810
5,1,29,1,1,18,816,1705,47,13,95,proper,1718,863
5,1,29,1,1,19,869,1702,60,16,96,shipping,1718,929
4,1,29,1,2,0,66,1718,878,19,-1,,1737,944
5,1,29,1,2,1,66,1721,44,13,83,"name,",1734,110
5,1,29,1,2,2,116,1721,22,11,96,are,1732,138
5,1,29,1,2,3,145,1718,59,17,96,properly,1735,204
5,1,29,1,2,4,209,1718,67,14,82,classified,1732,276
5,1,29,1,2,5,282,1719,26,13,96,and,1732,308
5,1,29,1,2,6,314,1719,74,17,94,"packaged,",1736,388
5,1,29,1,2,7,396,1719,34,14,96,have,1733,430
5,1,29,1,2,8,436,1719,76,17,95,dangerous,1736,512
5,1,29,1,2,9,519,1719,43,17,96,goods,1736,562
5,1,29,1,2,10,569,1720,43,16,95,safety,1736,612
5,1,29,1,2,11,618,1720,44,13,96,marks,1733,662
5,1,29,1,2,12,668,1720,58,17,96,properly,1737,726
5,1,29,1,2,13,733,1720,47,14,91,affixed,1734,780
5,1,29,1,2,14,786,1723,14,11,96,or,1734,800
5,1,29,1,2,15,806,1721,69,16,95,displayed,1737,875
5,1,29,1,2,16,881,1724,17,10,96,on,1734,898
5,1,29,1,2,17,904,1721,40,15,96,"them,",1736,944
4,1,29,1,3,0,66,1738,969,21,-1,,1759,1035
5,1,29,1,3,1,66,1738,26,12,93,and,1750,92
5,1,29,1,3,2,98,1741,22,10,93,are,1751,120
5,1,29,1,3,3,126,1741,11,9,96,in,1750,137
5,1,29,1,3,4,144,1738,15,13,94,ali,1751,159
5,1,29,1,3,5,165,1740,61,14,94,respects,1754,226
5,1,29,1,3,6,232,1738,12,13,96,in,1751,244
5,1,29,1,3,7,250,1742,46,12,96,proper,1754,296
5,1,29,1,3,8,302,1739,65,13,38,condition,1752,367
5,1,29,1,3,9,373,1739,19,13,96,for,1752,392
5,1,29,1,3,10,397,1740,65,15,86,transport,1755,462
5,1,29,1,3,11,467,1740,71,15,93,according,1755,538
5,1,29,1,3,12,544,1741,12,11,96,to,1752,556
5,1,29,1,3,13,562,1740,22,12,96,the,1752,584
5,1,29,1,3,14,590,1740,106,16,95,Transportation,1756,696
5,1,29,1,3,15,702,1740,13,13,96,of,1753,715
5,1,29,1,3,16,722,1740,78,16,96,Dangerous,1756,800
5,1,29,1,3,17,807,1740,48,13,93,Goods,1753,855
5,1,29,1,3,18,862,1740,85,17,28,Regulations,1757,947
5,1,29,1,3,19,955,1730,7,33,28,|,1763,962
5,1,29,1,3,20,985,1748,50,11,8,Fagen,1759,1035
2,1,30,0,0,0,128,1687,636,2,-1,,1689,764
3,1,30,1,0,0,128,1687,636,2,-1,,1689,764
4,1,30,1,1,0,128,1687,636,2,-1,,1689,764
5,1,30,1,1,1,128,1687,636,2,95, ,1689,764
2,1,31,0,0,0,458,1687,306,3,-1,,1690,764
3,1,31,1,0,0,458,1687,306,3,-1,,1690,764
4,1,31,1,1,0,458,1687,306,3,-1,,1690,764
5,1,31,1,1,1,458,1687,306,3,95, ,1690,764
2,1,32,0,0,0,1495,678,4,1149,-1,,1827,1499
3,1,32,1,0,0,1495,678,4,1149,-1,,1827,1499
4,1,32,1,1,0,1495,678,4,1149,-1,,1827,1499
5,1,32,1,1,1,1495,678,4,1149,95, ,1827,1499
2,1,33,0,0,0,952,1689,4,139,-1,,1828,956
3,1,33,1,0,0,952,1689,4,139,-1,,1828,956
4,1,33,1,1,0,952,1689,4,139,-1,,1828,956
5,1,33,1,1,1,952,1689,4,139,95, ,1828,956
2,1,34,0,0,0,53,1822,413,5,-1,,1827,466
3,1,34,1,0,0,53,1822,413,5,-1,,1827,466
4,1,34,1,1,0,53,1822,413,5,-1,,1827,466
5,1,34,1,1,1,53,1822,413,5,95, ,1827,466
2,1,35,0,0,0,683,1827,917,2,-1,,1829,1600
3,1,35,1,0,0,683,1827,917,2,-1,,1829,1600
4,1,35,1,1,0,683,1827,917,2,-1,,1829,1600
5,1,35,1,1,1,683,1827,917,2,95, ,1829,1600
2,1,36,0,0,0,66,1744,1545,114,-1,,1858,1611
3,1,36,1,0,0,66,1744,1545,114,-1,,1858,1611
4,1,36,1,1,0,986,1744,625,29,-1,,1773,1611
5,1,36,1,1,1,986,1762,7,10,15,TIME,1772,993
5,1,36,1,1,2,1077,1752,2,11,86,T,1763,1079
5,1,36,1,1,3,1126,1748,46,25,89,START,1773,1172
5,1,36,1,1,4,1180,1744,58,29,66,LOADING,1773,1238
5,1,36,1,1,5,1320,1749,43,11,95,FINISH,1760,1363
5,1,36,1,1,6,1369,1749,60,11,74,LOADING,1760,1429
5,1,36,1,1,7,1501,1745,78,15,41,âTIMEOUT,1760,1579
4,1,36,1,2,0,134,1758,1440,35,-1,,1793,1574
5,1,36,1,2,1,134,1764,116,18,96,Yannick,1782,250
5,1,36,1,2,2,266,1766,64,17,96,Merc,1783,330
5,1,36,1,2,3,335,1764,11,19,82,i,1783,346
5,1,36,1,2,4,351,1770,30,13,96,er,1783,381
5,1,36,1,2,5,995,1762,50,11,70,RAIVEE,1773,1045
5,1,36,1,2,6,1077,1764,2,29,87,|,1793,1079
5,1,36,1,2,7,1097,1758,27,23,89,DEBI,1781,1124
5,1,36,1,2,8,1218,1758,52,23,0,iEMENT,1781,1270
5,1,36,1,2,9,1309,1763,20,11,96,FIN,1774,1329
5,1,36,1,2,10,1335,1763,18,11,91,DU,1774,1353
5,1,36,1,2,11,1358,1763,99,11,85,CHARGEMENT,1774,1457
5,1,36,1,2,12,1520,1764,54,10,81,DEPART,1774,1574
4,1,36,1,3,0,149,1794,1430,33,-1,,1827,1579
5,1,36,1,3,1,149,1804,55,16,96,Shipper,1820,204
5,1,36,1,3,2,210,1808,40,9,92,name,1817,250
5,1,36,1,3,3,256,1804,54,17,92,(please,1821,310
5,1,36,1,3,4,315,1805,36,16,96,print),1821,351
5,1,36,1,3,5,416,1800,11,1,46,~,1801,427
5,1,36,1,3,6,968,1797,77,18,96,02:13,1815,1045
5,1,36,1,3,7,1077,1794,2,33,90,|,1827,1079
5,1,36,1,3,8,1135,1798,78,18,95,02:18,1816,1213
5,1,36,1,3,9,1335,1798,77,18,95,02:42,1816,1412
5,1,36,1,3,10,1502,1798,77,18,95,02:42,1816,1579
4,1,36,1,4,0,66,1825,1497,21,-1,,1846,1563
5,1,36,1,4,1,66,1828,60,14,96,DRIVER,1842,126
5,1,36,1,4,2,133,1829,46,13,92,NAME,1842,179
5,1,36,1,4,3,185,1836,4,2,92,-,1838,189
5,1,36,1,4,4,196,1829,36,13,96,NOM,1842,232
5,1,36,1,4,5,239,1830,21,12,92,DU,1842,260
5,1,36,1,4,6,266,1825,118,18,3,CONOUCTEUR,1843,384
5,1,36,1,4,7,586,1830,60,14,96,DRIVER,1844,646
5,1,36,1,4,8,653,1831,70,13,96,NUMBER,1844,723
5,1,36,1,4,9,930,1839,3,2,7,:,1841,933
5,1,36,1,4,10,994,1827,15,1,49,Wy,1828,1009
5,1,36,1,4,11,1083,1827,99,16,22,ONDUGFEA,1843,1182
5,1,36,1,4,12,1274,1832,53,14,96,TOTAL,1846,1327
5,1,36,1,4,13,1333,1832,83,14,92,QUANTITY,1846,1416
5,1,36,1,4,14,1422,1840,4,2,92,-,1842,1426
5,1,36,1,4,15,1432,1833,61,13,92,QUANT.,1846,1493
5,1,36,1,4,16,1499,1833,64,13,92,TOTALE,1846,1563
4,1,36,1,5,0,572,1831,171,27,-1,,1858,743
5,1,36,1,5,1,572,1831,48,27,53,NOBU,1858,620
5,1,36,1,5,2,626,1831,117,27,0,CONDUGEUA,1858,743
2,1,37,0,0,0,47,1826,1579,336,-1,,2162,1626
3,1,37,1,0,0,47,1826,1579,336,-1,,2162,1626
4,1,37,1,1,0,47,1826,1579,336,-1,,2162,1626
5,1,37,1,1,1,47,1826,1579,336,95,   ,2162,1626
2,1,38,0,0,0,134,1858,1396,48,-1,,1906,1530
3,1,38,1,0,0,134,1858,1396,48,-1,,1906,1530
4,1,38,1,1,0,1318,1858,212,19,-1,,1877,1530
5,1,38,1,1,1,1318,1859,79,18,83,44001,1877,1397
5,1,38,1,1,2,1433,1858,97,19,92,Litres,1877,1530
4,1,38,1,2,0,134,1888,601,18,-1,,1906,735
5,1,38,1,2,1,134,1888,82,16,47,ANDRE,1904,216
5,1,38,1,2,2,226,1881,40,34,25,____,1915,266
5,1,38,1,2,3,267,1888,164,17,25,DRAINVILLE,1905,431
5,1,38,1,2,4,601,1888,134,18,86,00004028,1906,735
2,1,39,0,0,0,75,1913,1524,60,-1,,1973,1599
3,1,39,1,0,0,75,1913,1524,58,-1,,1971,1599
4,1,39,1,1,0,75,1913,1524,19,-1,,1932,1599
5,1,39,1,1,1,75,1917,67,12,89,PRODUCT,1929,142
5,1,39,1,1,2,155,1911,12,28,68,|,1939,167
5,1,39,1,1,3,168,1918,36,11,68,TANK,1929,204
5,1,39,1,1,4,209,1918,67,11,47,CAPACITY|,1929,276
5,1,39,1,1,5,284,1918,48,11,47,WATER,1929,332
5,1,39,1,1,6,338,1918,21,11,53,DIP,1929,359
5,1,39,1,1,7,367,1918,55,12,53,BEFORE,1930,422
5,1,39,1,1,8,428,1918,30,12,10,DIPS],1930,458
5,1,39,1,1,9,478,1918,110,12,0,BEFORE{NVENT,1930,588
5,1,39,1,1,10,598,1911,10,28,89,|,1939,608
5,1,39,1,1,11,613,1920,45,10,93,AFTER,1930,658
5,1,39,1,1,12,663,1919,31,11,22,ODIPS|,1930,694
5,1,39,1,1,13,705,1919,52,11,96,ENDING,1930,757
5,1,39,1,1,14,763,1920,49,11,96,INVENT,1931,812
5,1,39,1,1,15,858,1920,68,11,72,PRODUCT,1931,926
5,1,39,1,1,16,947,1913,2,2,36,|â,1915,949
5,1,39,1,1,17,1270,1920,55,12,60,BEFORE,1932,1325
5,1,39,1,1,18,1330,1921,51,11,60,INVENT,1932,1381
5,1,39,1,1,19,1397,1921,44,11,79,AFTER,1932,1441
5,1,39,1,1,20,1447,1921,30,11,72,CIPS),1932,1477
5,1,39,1,1,21,1492,1921,52,11,84,ENDING,1932,1544
5,1,39,1,1,22,1549,1921,50,11,4,âNVENT,1932,1599
4,1,39,1,2,0,77,1928,1510,29,-1,,1957,1587
5,1,39,1,2,1,77,1934,61,11,36,PRODUIT,1945,138
5,1,39,1,2,2,154,1927,13,28,9,âÂ§,1955,167
5,1,39,1,2,3,171,1934,95,12,76,CONTENANCE,1946,266
5,1,39,1,2,4,276,1927,10,28,94,|,1955,286
5,1,39,1,2,5,287,1935,67,11,94,MEASURE,1946,354
5,1,39,1,2,6,360,1927,10,28,96,|,1955,370
5,1,39,1,2,7,378,1936,45,10,43,AVANT,1946,423
5,1,39,1,2,8,428,1936,15,11,43,LE,1947,443
5,1,39,1,2,9,492,1928,85,28,5,INVENTAIRE.,1956,577
5,1,39,1,2,10,719,1929,81,28,87,INVENTAIRE,1957,800
5,1,39,1,2,11,861,1929,61,28,66,PRODUIT,1957,922
5,1,39,1,2,12,1163,1938,46,11,95,AVANT,1949,1209
5,1,39,1,2,13,1214,1938,15,11,95,LE,1949,1229
5,1,39,1,2,14,1284,1938,81,11,91,INVENTAIRE,1949,1365
5,1,39,1,2,15,1382,1930,13,28,90,|,1958,1395
5,1,39,1,2,16,1402,1938,67,11,50,APRESLE,1949,1469
5,1,39,1,2,17,1476,1930,7,28,38,|,1958,1483
5,1,39,1,2,18,1506,1938,81,11,0, INVENTAIRE,1949,1587
4,1,39,1,3,0,168,1945,1397,28,-1,,1973,1565
5,1,39,1,3,1,168,1952,18,10,90,OU,1962,186
5,1,39,1,3,2,192,1952,80,11,89,RESERVIOR,1963,272
5,1,39,1,3,3,375,1952,74,11,78,JAUGEAGE,1963,449
5,1,39,1,3,4,496,1945,75,28,92,JAUGEAGE,1973,571
5,1,39,1,3,5,612,1952,75,12,76,JAUGEAGE,1964,687
5,1,39,1,3,6,712,1968,3,2,49,|,1970,715
5,1,39,1,3,7,735,1953,54,17,0,APRES,1970,789
5,1,39,1,3,8,841,1969,14,2,11,L_,1971,855
5,1,39,1,3,9,1160,1954,75,12,91,JAUGEAGE,1966,1235
5,1,39,1,3,10,1288,1954,75,12,89,JAUGEAGE,1966,1363
5,1,39,1,3,11,1379,1947,15,28,41,|,1975,1394
5,1,39,1,3,12,1396,1954,75,12,88,JAUGEAGE,1966,1471
5,1,39,1,3,13,1518,1955,47,11,91,APRES,1966,1565
2,1,40,0,0,0,1619,145,5,1764,-1,,1909,1624
3,1,40,1,0,0,1619,145,5,1764,-1,,1909,1624
4,1,40,1,1,0,1619,145,5,1764,-1,,1909,1624
5,1,40,1,1,1,1619,145,5,1764,95, ,1909,1624
2,1,41,0,0,0,117,1967,555,2,-1,,1969,672
3,1,41,1,0,0,117,1967,555,2,-1,,1969,672
4,1,41,1,1,0,117,1967,555,2,-1,,1969,672
5,1,41,1,1,1,117,1967,555,2,95, ,1969,672
2,1,42,0,0,0,906,1969,320,2,-1,,1971,1226
3,1,42,1,0,0,906,1969,320,2,-1,,1971,1226
4,1,42,1,1,0,906,1969,320,2,-1,,1971,1226
5,1,42,1,1,1,906,1969,320,2,95, ,1971,1226
2,1,43,0,0,0,1364,1970,253,3,-1,,1973,1617
3,1,43,1,0,0,1364,1970,253,3,-1,,1973,1617
4,1,43,1,1,0,1364,1970,253,3,-1,,1973,1617
5,1,43,1,1,1,1364,1970,253,3,95, ,1973,1617
2,1,44,0,0,0,353,2030,149,1,-1,,2031,502
3,1,44,1,0,0,353,2030,149,1,-1,,2031,502
4,1,44,1,1,0,353,2030,149,1,-1,,2031,502
5,1,44,1,1,1,353,2030,149,1,95, ,2031,502
2,1,45,0,0,0,672,2031,942,2,-1,,2033,1614
3,1,45,1,0,0,672,2031,942,2,-1,,2033,1614
4,1,45,1,1,0,672,2031,942,2,-1,,2033,1614
5,1,45,1,1,1,672,2031,942,2,95, ,2033,1614
2,1,46,0,0,0,1162,2031,452,3,-1,,2034,1614
3,1,46,1,0,0,1162,2031,452,3,-1,,2034,1614
4,1,46,1,1,0,1162,2031,452,3,-1,,2034,1614
5,1,46,1,1,1,1162,2031,452,3,95, ,2034,1614
2,1,47,0,0,0,107,2089,905,5,-1,,2094,1012
3,1,47,1,0,0,107,2089,905,5,-1,,2094,1012
4,1,47,1,1,0,107,2089,905,5,-1,,2094,1012
5,1,47,1,1,1,107,2089,905,5,95, ,2094,1012
2,1,48,0,0,0,1255,2093,320,3,-1,,2096,1575
3,1,48,1,0,0,1255,2093,320,3,-1,,2096,1575
4,1,48,1,1,0,1255,2093,320,3,-1,,2096,1575
5,1,48,1,1,1,1255,2093,320,3,95, ,2096,1575
2,1,49,0,0,0,1478,1914,2,219,-1,,2133,1480
3,1,49,1,0,0,1478,1914,2,219,-1,,2133,1480
4,1,49,1,1,0,1478,1914,2,219,-1,,2133,1480
5,1,49,1,1,1,1478,1914,2,219,95, ,2133,1480
2,1,50,0,0,0,164,1912,2,237,-1,,2149,166
3,1,50,1,0,0,164,1912,2,237,-1,,2149,166
4,1,50,1,1,0,164,1912,2,237,-1,,2149,166
5,1,50,1,1,1,164,1912,2,237,95, ,2149,166
2,1,51,0,0,0,362,1911,3,239,-1,,2150,365
3,1,51,1,0,0,362,1911,3,239,-1,,2150,365
4,1,51,1,1,0,362,1911,3,239,-1,,2150,365
5,1,51,1,1,1,362,1911,3,239,95, ,2150,365
2,1,52,0,0,0,461,1912,4,238,-1,,2150,465
3,1,52,1,0,0,461,1912,4,238,-1,,2150,465
4,1,52,1,1,0,461,1912,4,238,-1,,2150,465
5,1,52,1,1,1,461,1912,4,238,95, ,2150,465
2,1,53,0,0,0,606,1912,1,239,-1,,2151,607
3,1,53,1,0,0,606,1912,1,239,-1,,2151,607
4,1,53,1,1,0,606,1912,1,239,-1,,2151,607
5,1,53,1,1,1,606,1912,1,239,95, ,2151,607
2,1,54,0,0,0,1256,1920,1,232,-1,,2152,1257
3,1,54,1,0,0,1256,1920,1,232,-1,,2152,1257
4,1,54,1,1,0,1256,1920,1,232,-1,,2152,1257
5,1,54,1,1,1,1256,1920,1,232,95, ,2152,1257
2,1,55,0,0,0,1389,1933,1,220,-1,,2153,1390
3,1,55,1,0,0,1389,1933,1,220,-1,,2153,1390
4,1,55,1,1,0,1389,1933,1,220,-1,,2153,1390
5,1,55,1,1,1,1389,1933,1,220,95,,2153,1390
1,1,0,0,0,0,0,0,1700,2200,-1,,2200,1700
2,1,1,0,0,0,908,92,611,23,-1,,115,1519
3,1,1,1,0,0,908,92,611,23,-1,,115,1519
4,1,1,1,1,0,908,92,611,23,-1,,115,1519
5,1,1,1,1,1,908,92,115,21,96,VEHICLE,113,1023
5,1,1,1,1,2,1035,92,121,22,95,LOADING,114,1156
5,1,1,1,1,3,1168,93,113,21,93,REPORT,114,1281
5,1,1,1,1,4,1280,88,13,37,92,-,125,1293
5,1,1,1,1,5,1308,93,55,21,96,BILL,114,1363
5,1,1,1,1,6,1372,93,37,21,93,OF,114,1409
5,1,1,1,1,7,1419,94,100,21,92,LADING,115,1519
2,1,2,0,0,0,187,139,1061,10,-1,,149,1248
3,1,2,1,0,0,187,139,1061,10,-1,,149,1248
4,1,2,1,1,0,187,139,1061,10,-1,,149,1248
5,1,2,1,1,1,187,139,1061,10,95, ,149,1248
2,1,3,0,0,0,475,143,1,98,-1,,241,476
3,1,3,1,0,0,475,143,1,98,-1,,241,476
4,1,3,1,1,0,475,143,1,98,-1,,241,476
5,1,3,1,1,1,475,143,1,98,95, ,241,476
2,1,4,0,0,0,63,235,630,7,-1,,242,693
3,1,4,1,0,0,63,235,630,7,-1,,242,693
4,1,4,1,1,0,63,235,630,7,-1,,242,693
5,1,4,1,1,1,63,235,630,7,95, ,242,693
2,1,5,0,0,0,331,411,416,5,-1,,416,747
3,1,5,1,0,0,331,411,416,5,-1,,416,747
4,1,5,1,1,0,331,411,416,5,-1,,416,747
5,1,5,1,1,1,331,411,416,5,95, ,416,747
2,1,6,0,0,0,847,281,5,170,-1,,451,852
3,1,6,1,0,0,847,281,5,170,-1,,451,852
4,1,6,1,1,0,847,281,5,170,-1,,451,852
5,1,6,1,1,1,847,281,5,170,95, ,451,852
2,1,7,0,0,0,74,477,776,8,-1,,485,850
3,1,7,1,0,0,74,477,776,8,-1,,485,850
4,1,7,1,1,0,74,477,776,8,-1,,485,850
5,1,7,1,1,1,74,477,776,8,95, ,485,850
2,1,8,0,0,0,716,522,799,9,-1,,531,1515
3,1,8,1,0,0,716,522,799,9,-1,,531,1515
4,1,8,1,1,0,716,522,799,9,-1,,531,1515
5,1,8,1,1,1,716,522,799,9,95, ,531,1515
2,1,9,0,0,0,58,142,5,450,-1,,592,63
3,1,9,1,0,0,58,142,5,450,-1,,592,63
4,1,9,1,1,0,58,142,5,450,-1,,592,63
5,1,9,1,1,1,58,142,5,450,95, ,592,63
2,1,10,0,0,0,1096,526,3,152,-1,,678,1099
3,1,10,1,0,0,1096,526,3,152,-1,,678,1099
4,1,10,1,1,0,1096,526,3,152,-1,,678,1099
5,1,10,1,1,1,1096,526,3,152,95, ,678,1099
2,1,11,0,0,0,64,667,1557,15,-1,,682,1621
3,1,11,1,0,0,64,667,1557,15,-1,,682,1621
4,1,11,1,1,0,64,667,1557,15,-1,,682,1621
5,1,11,1,1,1,64,667,1557,15,95, ,682,1621
2,1,12,0,0,0,68,737,1468,13,-1,,750,1536
3,1,12,1,0,0,68,737,1468,13,-1,,750,1536
4,1,12,1,1,0,68,737,1468,13,-1,,750,1536
5,1,12,1,1,1,68,737,1468,13,95, ,750,1536
2,1,13,0,0,0,715,741,821,10,-1,,751,1536
3,1,13,1,0,0,715,741,821,10,-1,,751,1536
4,1,13,1,1,0,715,741,821,10,-1,,751,1536
5,1,13,1,1,1,715,741,821,10,95, ,751,1536
2,1,14,0,0,0,1272,718,10,906,-1,,1624,1282
3,1,14,1,0,0,1272,718,10,906,-1,,1624,1282
4,1,14,1,1,0,1272,718,10,906,-1,,1624,1282
5,1,14,1,1,1,1272,718,10,906,95, ,1624,1282
2,1,15,0,0,0,1410,678,11,1010,-1,,1688,1421
3,1,15,1,0,0,1410,678,11,1010,-1,,1688,1421
4,1,15,1,1,0,1410,678,11,1010,-1,,1688,1421
5,1,15,1,1,1,1410,678,11,1010,95, ,1688,1421
2,1,16,0,0,0,937,676,11,1013,-1,,1689,948
3,1,16,1,0,0,937,676,11,1013,-1,,1689,948
4,1,16,1,1,0,937,676,11,1013,-1,,1689,948
5,1,16,1,1,1,937,676,11,1013,95, ,1689,948
2,1,17,0,0,0,246,672,10,1015,-1,,1687,256
3,1,17,1,0,0,246,672,10,1015,-1,,1687,256
4,1,17,1,1,0,246,672,10,1015,-1,,1687,256
5,1,17,1,1,1,246,672,10,1015,95, ,1687,256
2,1,18,0,0,0,1118,683,11,1008,-1,,1691,1129
3,1,18,1,0,0,1118,683,11,1008,-1,,1691,1129
4,1,18,1,1,0,1118,683,11,1008,-1,,1691,1129
5,1,18,1,1,1,1118,683,11,1008,95, ,1691,1129
2,1,19,0,0,0,1386,1689,236,5,-1,,1694,1622
3,1,19,1,0,0,1386,1689,236,5,-1,,1694,1622
4,1,19,1,1,0,1386,1689,236,5,-1,,1694,1622
5,1,19,1,1,1,1386,1689,236,5,95, ,1694,1622
2,1,20,0,0,0,53,1682,1161,10,-1,,1692,1214
3,1,20,1,0,0,53,1682,1161,10,-1,,1692,1214
4,1,20,1,1,0,53,1682,1161,10,-1,,1692,1214
5,1,20,1,1,1,53,1682,1161,10,95, ,1692,1214
2,1,21,0,0,0,953,1742,669,7,-1,,1749,1622
3,1,21,1,0,0,953,1742,669,7,-1,,1749,1622
4,1,21,1,1,0,953,1742,669,7,-1,,1749,1622
5,1,21,1,1,1,953,1742,669,7,95, ,1749,1622
2,1,22,0,0,0,1493,678,12,1149,-1,,1827,1505
3,1,22,1,0,0,1493,678,12,1149,-1,,1827,1505
4,1,22,1,1,0,1493,678,12,1149,-1,,1827,1505
5,1,22,1,1,1,1493,678,12,1149,95, ,1827,1505
2,1,23,0,0,0,952,1698,3,130,-1,,1828,955
3,1,23,1,0,0,952,1698,3,130,-1,,1828,955
4,1,23,1,1,0,952,1698,3,130,-1,,1828,955
5,1,23,1,1,1,952,1698,3,130,95, ,1828,955
2,1,24,0,0,0,1286,1745,4,85,-1,,1830,1290
3,1,24,1,0,0,1286,1745,4,85,-1,,1830,1290
4,1,24,1,1,0,1286,1745,4,85,-1,,1830,1290
5,1,24,1,1,1,1286,1745,4,85,95, ,1830,1290
2,1,25,0,0,0,884,1824,684,8,-1,,1832,1568
3,1,25,1,0,0,884,1824,684,8,-1,,1832,1568
4,1,25,1,1,0,884,1824,684,8,-1,,1832,1568
5,1,25,1,1,1,884,1824,684,8,95, ,1832,1568
2,1,26,0,0,0,78,1821,637,7,-1,,1828,715
3,1,26,1,0,0,78,1821,637,7,-1,,1828,715
4,1,26,1,1,0,78,1821,637,7,-1,,1828,715
5,1,26,1,1,1,78,1821,637,7,95, ,1828,715
2,1,27,0,0,0,47,1826,1580,336,-1,,2162,1627
3,1,27,1,0,0,47,1826,1580,336,-1,,2162,1627
4,1,27,1,1,0,47,1826,1580,336,-1,,2162,1627
5,1,27,1,1,1,47,1826,1580,336,95,   ,2162,1627
2,1,28,0,0,0,53,120,1572,1790,-1,,1910,1625
3,1,28,1,0,0,53,120,1572,1790,-1,,1910,1625
4,1,28,1,1,0,144,120,1480,28,-1,,148,1624
5,1,28,1,1,1,144,122,75,21,95,Page:,143,219
5,1,28,1,1,2,244,120,11,18,95,1,138,255
5,1,28,1,1,3,476,122,45,18,96,530,140,521
5,1,28,1,1,4,812,120,131,21,96,RAPPORT,141,943
5,1,28,1,1,5,954,120,34,21,93,DE,141,988
5,1,28,1,1,6,998,120,197,22,90,CHARGEMENT,142,1195
5,1,28,1,1,7,1204,132,7,3,91,-,135,1211
5,1,28,1,1,8,1221,120,136,28,88,VEHICULE,148,1357
5,1,28,1,1,9,1369,132,15,16,88,-,148,1384
5,1,28,1,1,10,1384,121,240,27,65,CONNAISSEMENT,148,1624
4,1,28,1,2,0,132,147,537,25,-1,,172,669
5,1,28,1,2,1,132,148,111,16,93,DOCUMENT,164,243
5,1,28,1,2,2,250,150,81,14,92,NUMBER,164,331
5,1,28,1,2,3,360,150,61,18,92,6980,168,421
5,1,28,1,2,4,532,147,35,24,93,DATE,171,567
5,1,28,1,2,5,576,143,93,39,81,DEXPEDITION,182,669
4,1,28,1,3,0,132,167,174,16,-1,,183,306
5,1,28,1,3,1,132,167,23,16,95,No,183,155
5,1,28,1,3,2,162,168,25,15,95,DU,183,187
5,1,28,1,3,3,196,168,110,15,95,DOCUMENT,183,306
4,1,28,1,4,0,519,177,1088,37,-1,,214,1607
5,1,28,1,4,1,519,177,138,37,81,mm/dd/yy,214,657
5,1,28,1,4,2,796,184,29,21,96,24,205,825
5,1,28,1,4,3,836,184,78,22,95,HOUR,206,914
5,1,28,1,4,4,924,184,118,22,90,NUMBER,206,1042
5,1,28,1,4,5,1064,184,206,21,88,(613)996-6666,205,1270
5,1,28,1,4,6,1308,186,137,22,89,-NUMERO,208,1445
5,1,28,1,4,7,1455,187,29,20,89,24,207,1484
5,1,28,1,4,8,1495,186,112,22,93,HEURES,208,1607
4,1,28,1,5,0,144,209,1225,29,-1,,238,1369
5,1,28,1,5,1,144,209,111,19,96,0362704,228,255
5,1,28,1,5,2,276,210,94,20,96,10/007,230,370
5,1,28,1,5,3,525,212,128,20,95,10/08/24,232,653
5,1,28,1,5,4,1046,216,143,27,93,COLLECT,243,1189
5,1,28,1,5,5,1175,206,14,42,93,-,248,1189
5,1,28,1,5,6,1194,210,109,34,90,FRAIS,244,1303
5,1,28,1,5,7,1290,217,79,21,92,VIRES,238,1369
4,1,28,1,6,0,73,238,1548,31,-1,,269,1621
5,1,28,1,6,1,73,241,198,14,72,CONSIGNEE/CUSTOMER,255,271
5,1,28,1,6,2,276,250,5,2,86,-,252,281
5,1,28,1,6,3,287,238,183,18,86,DESTINATAIRE/CLIENT,256,470
5,1,28,1,6,4,598,240,9,1,34,7,241,607
5,1,28,1,6,5,684,240,31,26,13,oD,266,715
5,1,28,1,6,6,717,240,134,27,0,etAsSeenienT,267,851
5,1,28,1,6,7,846,236,9,35,87,|,271,855
5,1,28,1,6,8,853,242,118,17,91,CONSIGNOR,259,971
5,1,28,1,6,9,962,236,10,35,91,-,271,972
5,1,28,1,6,10,977,246,105,13,92,EXPEDITEUR,259,1082
5,1,28,1,6,11,1446,243,175,26,36,eae,269,1621
4,1,28,1,7,0,143,272,1468,33,-1,,305,1611
5,1,28,1,7,1,143,272,80,18,93,PETRO,290,223
5,1,28,1,7,2,241,272,100,18,96,CANADA,290,341
5,1,28,1,7,3,357,274,164,17,96,LUBRICANTS,291,521
5,1,28,1,7,4,542,274,45,18,96,INC,292,587
5,1,28,1,7,5,675,274,162,18,93,0005064508,292,837
5,1,28,1,7,6,858,276,97,17,91,SUNCOR,293,955
5,1,28,1,7,7,974,276,97,18,96,ENERGY,294,1071
5,1,28,1,7,8,1088,276,133,18,96,MONTREAL,294,1221
5,1,28,1,7,9,1445,281,3,24,69,|,305,1448
5,1,28,1,7,10,1474,276,115,29,63,0082041,305,1589
5,1,28,1,7,11,1600,304,11,1,0,_,305,1611
4,1,28,1,8,0,143,301,1110,23,-1,,324,1253
5,1,28,1,8,1,143,302,62,17,88,PCLI,319,205
5,1,28,1,8,2,226,310,12,3,88,-,313,238
5,1,28,1,8,3,258,302,97,21,95,QUEBEC,323,355
5,1,28,1,8,4,375,302,44,18,96,302,320,419
5,1,28,1,8,5,672,301,163,22,88,0009406423,323,835
5,1,28,1,8,6,858,304,77,19,88,11675,323,935
5,1,28,1,8,7,956,310,48,13,96,rue,323,1004
5,1,28,1,8,8,1024,305,164,19,96,Sherbrooke,324,1188
5,1,28,1,8,9,1208,308,45,16,96,est,324,1253
4,1,28,1,9,0,143,332,1343,26,-1,,358,1486
5,1,28,1,9,1,143,332,44,18,96,385,350,187
5,1,28,1,9,2,210,333,146,18,96,SOUTHDOWN,351,356
5,1,28,1,9,3,374,334,64,17,95,ROAD,351,438
5,1,28,1,9,4,855,336,143,20,95,"Montreal,",356,998
5,1,28,1,9,5,1023,337,30,21,91,QC,358,1053
5,1,28,1,9,6,1072,336,49,18,82,H1B,354,1121
5,1,28,1,9,7,1141,336,44,19,24,1C3,355,1185
5,1,28,1,9,8,1280,337,68,21,67,(613),358,1348
5,1,28,1,9,9,1361,337,125,18,67,996-6666,355,1486
4,1,28,1,10,0,140,363,710,20,-1,,383,850
5,1,28,1,10,1,140,363,193,20,95,"MISSISSAUGA,",383,333
5,1,28,1,10,2,357,364,32,17,92,ON,381,389
5,1,28,1,10,3,406,364,49,17,85,L5J,381,455
5,1,28,1,10,4,474,364,45,17,43,2Â¥3,381,519
5,1,28,1,10,5,848,377,2,3,93,|,380,850
4,1,28,1,11,0,769,394,335,22,-1,,416,1104
5,1,28,1,11,1,769,394,202,22,41,__|Yannick,416,971
5,1,28,1,11,2,988,395,116,20,96,Mercier,415,1104
4,1,28,1,12,0,267,411,574,34,-1,,445,841
5,1,28,1,12,1,267,411,2,34,81,[,445,269
5,1,28,1,12,2,274,416,62,11,92,RELEASE,427,336
5,1,28,1,12,3,342,416,47,13,58,(C-ol-A),429,389
5,1,28,1,12,4,394,416,59,11,48,NUMBER,427,453
5,1,28,1,12,5,564,417,79,11,57,CUSTOMER,428,643
5,1,28,1,12,6,648,418,75,11,43,PURCHASE,429,723
5,1,28,1,12,7,728,418,49,11,96,ORDER,429,777
5,1,28,1,12,8,782,418,59,11,95,NUMBER,429,841
4,1,28,1,13,0,614,432,191,11,-1,,443,805
5,1,28,1,13,1,614,432,17,10,77,No,442,631
5,1,28,1,13,2,636,432,17,10,95,DE,442,653
5,1,28,1,13,3,659,432,68,11,0,DEMANDE,443,727
5,1,28,1,13,4,732,432,19,11,92,DU,443,751
5,1,28,1,13,5,756,432,49,11,92,CLIENT,443,805
4,1,28,1,14,0,59,479,791,25,-1,,504,850
5,1,28,1,14,1,59,479,2,2,92,|,481,61
5,1,28,1,14,2,72,480,225,24,55,CARRIER-TRANSPORTEUR,504,297
5,1,28,1,14,3,402,481,28,2,0,_,483,430
5,1,28,1,14,4,629,482,11,1,0,-,483,640
5,1,28,1,14,5,708,483,4,11,80,],494,712
5,1,28,1,14,6,848,490,2,14,72,|,504,850
4,1,28,1,15,0,141,514,1395,34,-1,,548,1536
5,1,28,1,15,1,141,514,48,18,94,GEO,532,189
5,1,28,1,15,2,206,515,17,17,95,A,532,223
5,1,28,1,15,3,240,515,65,17,96,HALL,532,305
5,1,28,1,15,4,574,516,111,18,93,0101535,534,685
5,1,28,1,15,5,709,523,4,14,32,|,537,713
5,1,28,1,15,6,730,525,70,20,0,Venicte,545,800
5,1,28,1,15,7,813,525,64,21,92,NUMBER,546,877
5,1,28,1,15,8,919,526,70,20,48,LICENSE,546,989
5,1,28,1,15,9,995,533,70,13,95,NUMBER,546,1065
5,1,28,1,15,10,1128,526,79,21,95,ADDRESS,547,1207
5,1,28,1,15,11,1213,527,22,20,96,OF,547,1235
5,1,28,1,15,12,1241,534,56,13,93,METER,547,1297
5,1,28,1,15,13,1304,534,33,13,88,ANO,547,1337
5,1,28,1,15,14,1343,534,68,14,93,TRADER,548,1411
5,1,28,1,15,15,1525,527,11,1,0,-,528,1536
4,1,28,1,16,0,142,544,1333,26,-1,,570,1475
5,1,28,1,16,1,142,544,61,18,92,8800,562,203
5,1,28,1,16,2,226,553,11,2,92,-,555,237
5,1,28,1,16,3,258,544,29,18,91,6E,562,287
5,1,28,1,16,4,306,546,148,18,89,CROISSANT,564,454
5,1,28,1,16,5,733,554,20,12,96,No,566,753
5,1,28,1,16,6,759,554,22,13,70,DU,567,781
5,1,28,1,16,7,788,554,81,14,92,VEHICULE,568,869
5,1,28,1,16,8,919,555,72,13,88,NOMBRE,568,991
5,1,28,1,16,9,998,555,21,13,93,DE,568,1019
5,1,28,1,16,10,1025,555,62,13,43,PERMIS,568,1087
5,1,28,1,16,11,1093,547,12,32,89,|,579,1105
5,1,28,1,16,12,1114,556,91,13,37,L'âADRESSE,569,1205
5,1,28,1,16,13,1211,556,22,13,96,DE,569,1233
5,1,28,1,16,14,1238,556,57,13,96,METRE,569,1295
5,1,28,1,16,15,1302,556,20,13,96,ET,569,1322
5,1,28,1,16,16,1328,557,21,12,92,DE,569,1349
5,1,28,1,16,17,1355,556,120,14,92,COMMERCANT,570,1475
4,1,28,1,17,0,136,570,1366,31,-1,,601,1502
5,1,28,1,17,1,136,570,87,31,96,ANJOU,601,223
5,1,28,1,17,2,622,598,85,2,2,|},600,707
5,1,28,1,17,3,723,577,46,19,77,118,596,769
5,1,28,1,17,4,1106,579,79,18,96,11675,597,1185
5,1,28,1,17,5,1206,584,47,13,95,rue,597,1253
5,1,28,1,17,6,1274,579,163,19,96,Sherbrooke,598,1437
5,1,28,1,17,7,1456,582,46,16,96,est,598,1502
4,1,28,1,18,0,140,604,1294,27,-1,,631,1434
5,1,28,1,18,1,140,605,49,18,68,H1g,623,189
5,1,28,1,18,2,208,605,45,17,85,1A1,622,253
5,1,28,1,18,3,483,604,63,25,27,CASE,629,546
5,1,28,1,18,4,555,604,110,26,0,faeeontele,630,665
5,1,28,1,18,5,679,600,14,40,34,=,640,693
5,1,28,1,18,6,705,600,15,40,53,|,640,720
5,1,28,1,18,7,740,607,45,19,93,1068,626,785
5,1,28,1,18,8,1104,609,143,21,95,"Montreal,",630,1247
5,1,28,1,18,9,1272,611,31,20,90,QC,631,1303
5,1,28,1,18,10,1322,610,48,18,89,H1B,628,1370
5,1,28,1,18,11,1390,610,44,18,1,13,628,1434
4,1,28,1,19,0,146,622,1172,52,-1,,674,1318
5,1,28,1,19,1,146,634,69,20,0,(544),654,215
5,1,28,1,19,2,226,634,127,18,0,352-5550,652,353
5,1,28,1,19,3,472,622,1,52,93,|,674,473
5,1,28,1,19,4,1111,638,68,21,91,(613),659,1179
5,1,28,1,19,5,1197,638,121,19,94,996-6666,657,1318
4,1,28,1,20,0,58,670,1453,29,-1,,699,1511
5,1,28,1,20,1,58,670,2,5,94,|,675,60
5,1,28,1,20,2,330,673,11,1,0,-,674,341
5,1,28,1,20,3,576,674,15,1,0,-,675,591
5,1,28,1,20,4,651,675,8,1,0,-,676,659
5,1,28,1,20,5,906,676,26,1,0,i,677,932
5,1,28,1,20,6,1158,686,93,13,91,MEASURED,699,1251
5,1,28,1,20,7,1277,686,1,11,55,|,697,1278
5,1,28,1,20,8,1501,678,10,2,0,T,680,1511
4,1,28,1,21,0,72,692,1521,20,-1,,712,1593
5,1,28,1,21,1,72,692,142,13,76,PROOUCT/METER,705,214
5,1,28,1,21,2,1302,697,105,14,88,CORRECTED,711,1407
5,1,28,1,21,3,1416,688,9,33,88,|,721,1425
5,1,28,1,21,4,1434,698,47,13,95,TEMP,711,1481
5,1,28,1,21,5,1493,688,12,33,96,|,721,1505
5,1,28,1,21,6,1522,698,71,14,96,DENSITY,712,1593
4,1,28,1,22,0,568,705,661,14,-1,,719,1229
5,1,28,1,22,1,568,715,5,2,15,7,717,573
5,1,28,1,22,2,1172,705,57,14,95,LITRES,719,1229
4,1,28,1,23,0,57,707,1565,42,-1,,749,1622
5,1,28,1,23,1,57,740,10,2,55,|,742,67
5,1,28,1,23,2,72,719,135,14,21,PRODUITIMETER,733,207
5,1,28,1,23,3,364,707,198,14,0,siatehidaianniiatibiel,721,562
5,1,28,1,23,4,579,708,112,37,90,DESCRIPTION,745,691
5,1,28,1,23,5,698,709,102,13,0,abinebell,722,800
5,1,28,1,23,6,943,740,2,2,96,|,742,945
5,1,28,1,23,7,1158,725,100,23,90,MESUREES,748,1258
5,1,28,1,23,8,1285,747,3,1,71,|,748,1288
5,1,28,1,23,9,1327,725,62,14,11,TO1SC,739,1389
5,1,28,1,23,10,1424,726,70,13,3,|CELSIUS|,739,1494
5,1,28,1,23,11,1522,726,78,23,86,DENSITE,749,1600
5,1,28,1,23,12,1610,748,12,1,86,|,749,1622
4,1,28,1,24,0,57,747,1527,32,-1,,779,1584
5,1,28,1,24,1,57,747,2,32,88,|,779,59
5,1,28,1,24,2,142,754,93,19,94,103265,773,235
5,1,28,1,24,3,248,750,18,34,94,|,784,266
5,1,28,1,24,4,272,756,48,18,96,NOT,774,320
5,1,28,1,24,5,338,757,148,18,96,REGULATED,775,486
5,1,28,1,24,6,504,758,82,17,96,UNDER,775,586
5,1,28,1,24,7,604,758,49,17,96,TDG,775,653
5,1,28,1,24,8,943,750,1,10,63,|,760,944
5,1,28,1,24,9,972,759,95,19,87,0.9644,778,1067
5,1,28,1,24,10,1172,759,79,19,96,44001,778,1251
5,1,28,1,24,11,1322,760,79,19,92,42435,779,1401
5,1,28,1,24,12,1423,760,62,19,85,|61.4,779,1485
5,1,28,1,24,13,1506,761,78,18,70,910.6,779,1584
4,1,28,1,25,0,57,784,1444,27,-1,,811,1501
5,1,28,1,25,1,57,784,2,19,96,|,803,59
5,1,28,1,25,2,138,785,98,19,91,MTR271,804,236
5,1,28,1,25,3,246,781,15,33,91,|,814,261
5,1,28,1,25,4,272,788,81,17,95,HEAVY,805,353
5,1,28,1,25,5,370,788,101,17,93,VACUUM,805,471
5,1,28,1,25,6,488,788,111,21,80,GASOIL,809,599
5,1,28,1,25,7,594,788,85,21,53,(HVGO),809,679
5,1,28,1,25,8,943,792,1,14,93,|,806,944
5,1,28,1,25,9,970,791,47,17,92,API,808,1017
5,1,28,1,25,10,1039,790,46,18,90,54B,808,1085
5,1,28,1,25,11,1499,803,2,8,80,|,811,1501
4,1,28,1,26,0,415,829,1210,154,-1,,983,1625
5,1,28,1,26,1,415,859,40,124,38,.,983,455
5,1,28,1,26,2,462,829,80,106,11,act,935,542
5,1,28,1,26,3,568,833,43,87,11,=z,920,611
5,1,28,1,26,4,1623,877,2,12,96,|,889,1625
4,1,28,1,27,0,57,865,598,76,-1,,941,655
5,1,28,1,27,1,57,916,2,12,53,1,928,59
5,1,28,1,27,2,250,912,2,7,91,|,919,252
5,1,28,1,27,3,611,865,44,76,55,J,941,655
4,1,28,1,28,0,302,1487,379,25,-1,,1512,681
5,1,28,1,28,1,302,1487,79,19,95,Total,1506,381
5,1,28,1,28,2,402,1487,96,21,96,Litres,1508,498
5,1,28,1,28,3,518,1489,32,23,96,by,1512,550
5,1,28,1,28,4,569,1489,112,19,96,Product,1508,681
4,1,28,1,29,0,270,1519,1127,24,-1,,1543,1397
5,1,28,1,29,1,270,1519,94,19,96,103265,1538,364
5,1,28,1,29,2,468,1521,82,17,96,HEAVY,1538,550
5,1,28,1,29,3,567,1521,100,19,93,VACUUM,1540,667
5,1,28,1,29,4,684,1522,94,18,51,GASOIL,1540,778
5,1,28,1,29,5,791,1517,85,33,51,(HVGO),1550,876
5,1,28,1,29,6,1170,1523,79,19,95,44001,1542,1249
5,1,28,1,29,7,1320,1523,77,19,96,42435,1542,1397
4,1,28,1,30,0,67,1681,1210,39,-1,,1720,1277
5,1,28,1,30,1,67,1697,2,13,62,|,1710,69
5,1,28,1,30,2,76,1697,49,17,79,hereby,1714,125
5,1,28,1,30,3,131,1697,53,13,88,declare,1710,184
5,1,28,1,30,4,190,1681,26,37,96,that,1718,216
5,1,28,1,30,5,222,1697,22,14,96,the,1711,244
5,1,28,1,30,6,246,1681,65,38,94,contents,1719,311
5,1,28,1,30,7,317,1699,12,13,84,of,1712,329
5,1,28,1,30,8,335,1685,25,27,84,this,1712,360
5,1,28,1,30,9,362,1682,96,38,67,consignment,1720,458
5,1,28,1,30,10,465,1703,22,9,96,are,1712,487
5,1,28,1,30,11,493,1699,29,17,83,fully,1716,522
5,1,28,1,30,12,527,1699,26,13,96,and,1712,553
5,1,28,1,30,13,560,1699,74,17,33,accurately,1716,634
5,1,28,1,30,14,640,1700,70,14,65,described,1714,710
5,1,28,1,30,15,717,1701,44,13,96,above,1714,761
5,1,28,1,30,16,767,1701,17,16,96,by,1717,784
5,1,28,1,30,17,789,1701,22,13,96,the,1714,811
5,1,28,1,30,18,817,1704,48,13,96,proper,1717,865
5,1,28,1,30,19,870,1701,61,17,96,shipping,1718,931
5,1,28,1,30,20,952,1688,48,5,0,T,1693,1000
5,1,28,1,30,21,1086,1689,21,2,0,-,1691,1107
5,1,28,1,30,22,1159,1689,4,2,0,;,1691,1163
5,1,28,1,30,23,1237,1687,40,4,19,_,1691,1277
4,1,28,1,31,0,67,1717,878,20,-1,,1737,945
5,1,28,1,31,1,67,1719,43,11,94,"name,",1730,110
5,1,28,1,31,2,117,1720,23,10,96,are,1730,140
5,1,28,1,31,3,146,1717,58,17,96,properly,1734,204
5,1,28,1,31,4,210,1717,67,14,88,classified,1731,277
5,1,28,1,31,5,283,1718,26,13,96,and,1731,309
5,1,28,1,31,6,315,1718,75,17,86,"packaged,",1735,390
5,1,28,1,31,7,397,1718,34,14,93,have,1732,431
5,1,28,1,31,8,437,1719,77,17,89,dangeraus,1736,514
5,1,28,1,31,9,520,1719,44,17,66,goods,1736,564
5,1,28,1,31,10,570,1719,43,17,93,safely,1736,613
5,1,28,1,31,11,619,1719,43,14,93,marks,1733,662
5,1,28,1,31,12,669,1720,59,17,93,properly,1737,728
5,1,28,1,31,13,734,1719,47,15,94,affixed,1734,781
5,1,28,1,31,14,787,1723,14,11,93,or,1734,801
5,1,28,1,31,15,807,1720,69,17,81,disptayed,1737,876
5,1,28,1,31,16,882,1723,17,11,96,on,1734,899
5,1,28,1,31,17,905,1721,40,13,78,"them,",1734,945
4,1,28,1,32,0,66,1737,1514,24,-1,,1761,1580
5,1,28,1,32,1,66,1737,26,12,95,and,1749,92
5,1,28,1,32,2,99,1740,23,10,94,are,1750,122
5,1,28,1,32,3,127,1736,11,13,92,in,1749,138
5,1,28,1,32,4,145,1737,15,13,88,all,1750,160
5,1,28,1,32,5,166,1738,70,15,84,respects,1753,236
5,1,28,1,32,6,233,1741,11,9,87,in,1750,244
5,1,28,1,32,7,251,1740,47,14,96,proper,1754,298
5,1,28,1,32,8,303,1738,65,13,96,condition,1751,368
5,1,28,1,32,9,374,1738,18,13,93,for,1751,392
5,1,28,1,32,10,398,1739,64,15,65,trarsport,1754,462
5,1,28,1,32,11,468,1739,70,16,94,according,1755,538
5,1,28,1,32,12,545,1740,12,12,96,to,1752,557
5,1,28,1,32,13,563,1739,22,13,92,the,1752,585
5,1,28,1,32,14,590,1739,106,17,91,Transportalion,1756,696
5,1,28,1,32,15,703,1740,13,12,96,af,1752,716
5,1,28,1,32,16,722,1740,80,16,72,Dangerous,1756,802
5,1,28,1,32,17,808,1740,48,13,57,Goods,1753,856
5,1,28,1,32,18,862,1740,86,17,56,Regulations,1757,948
5,1,28,1,32,19,957,1729,6,34,56,|,1763,963
5,1,28,1,32,20,986,1748,50,11,16,tye,1759,1036
5,1,28,1,32,21,1128,1749,45,11,79,START,1760,1173
5,1,28,1,32,22,1178,1749,61,11,91,LOADING,1760,1239
5,1,28,1,32,23,1321,1750,44,11,0,FINGH,1761,1365
5,1,28,1,32,24,1370,1750,61,11,0,LOADING,1761,1431
5,1,28,1,32,25,1472,1746,3,1,42,|,1747,1475
5,1,28,1,32,26,1514,1750,33,11,11,TME,1761,1547
5,1,28,1,32,27,1551,1750,29,11,75,GUT,1761,1580
4,1,28,1,33,0,135,1756,1440,29,-1,,1785,1575
5,1,28,1,33,1,135,1756,115,29,96,Yannick,1785,250
5,1,28,1,33,2,267,1763,115,19,94,Mercier,1782,382
5,1,28,1,33,3,986,1762,61,11,90,ARRIVEE,1773,1047
5,1,28,1,33,4,1098,1763,46,10,59,DEBUT,1773,1144
5,1,28,1,33,5,1149,1763,18,10,91,OU,1773,1167
5,1,28,1,33,6,1172,1763,99,11,91,CHARGEMENT,1774,1271
5,1,28,1,33,7,1310,1764,20,10,95,FIN,1774,1330
5,1,28,1,33,8,1336,1764,18,10,91,DU,1774,1354
5,1,28,1,33,9,1360,1764,97,10,91,CHARGEMENT,1774,1457
5,1,28,1,33,10,1520,1760,55,22,96,DEPART,1782,1575
4,1,28,1,34,0,53,1793,1526,33,-1,,1826,1579
5,1,28,1,34,1,53,1797,24,16,50,\~,1813,77
5,1,28,1,34,2,150,1802,56,17,96,Shipper,1819,206
5,1,28,1,34,3,214,1806,34,10,96,name,1816,248
5,1,28,1,34,4,257,1793,49,33,70,(please,1826,306
5,1,28,1,34,5,313,1793,53,33,0,prin),1826,366
5,1,28,1,34,6,471,1800,41,1,0,â,1801,512
5,1,28,1,34,7,969,1796,78,19,96,05:54,1815,1047
5,1,28,1,34,8,1136,1797,77,19,96,05:59,1816,1213
5,1,28,1,34,9,1336,1798,77,18,94,06:23,1816,1413
5,1,28,1,34,10,1502,1798,77,19,95,06:23,1817,1579
4,1,28,1,35,0,53,1821,1511,26,-1,,1847,1564
5,1,28,1,35,1,53,1821,2,16,82,|,1837,55
5,1,28,1,35,2,79,1827,49,14,82,DRIVER,1841,128
5,1,28,1,35,3,134,1828,56,13,90,NAME,1841,190
5,1,28,1,35,4,185,1817,9,34,90,-,1851,194
5,1,28,1,35,5,197,1828,37,13,96,NOM,1841,234
5,1,28,1,35,6,241,1828,21,14,93,DU,1842,262
5,1,28,1,35,7,268,1828,116,14,88,CONDUGTEUR,1842,384
5,1,28,1,35,8,484,1824,57,2,26,a,1826,541
5,1,28,1,35,9,578,1825,7,1,6,a,1826,585
5,1,28,1,35,10,762,1826,17,18,82,DR,1844,779
5,1,28,1,35,11,952,1831,85,14,91,IGNATURE,1845,1037
5,1,28,1,35,12,1044,1832,145,15,48,DUCBNOUCTEUR,1847,1189
5,1,28,1,35,13,1276,1832,53,14,96,TOTAL,1846,1329
5,1,28,1,35,14,1334,1832,83,14,93,QUANTITY,1846,1417
5,1,28,1,35,15,1423,1840,4,2,92,-,1842,1427
5,1,28,1,35,16,1433,1833,61,14,91,QUANT.,1847,1494
5,1,28,1,35,17,1500,1833,64,14,91,TOTALE,1847,1564
4,1,28,1,36,0,853,1858,678,25,-1,,1883,1531
5,1,28,1,36,1,853,1880,3,3,9,.,1883,856
5,1,28,1,36,2,1318,1860,79,18,87,44001,1878,1397
5,1,28,1,36,3,1434,1858,97,21,91,Litres,1879,1531
4,1,28,1,37,0,135,1886,1276,24,-1,,1910,1411
5,1,28,1,37,1,135,1886,132,19,96,GHISLAIN,1905,267
5,1,28,1,37,2,318,1888,114,18,89,LAPRISE,1906,432
5,1,28,1,37,3,1285,1891,79,18,40,38641,1909,1364
5,1,28,1,37,4,1369,1887,3,32,40,_,1919,1372
5,1,28,1,37,5,1384,1891,27,19,93,kg,1910,1411
2,1,29,0,0,0,1616,147,16,1765,-1,,1912,1632
3,1,29,1,0,0,1616,147,16,1765,-1,,1912,1632
4,1,29,1,1,0,1616,147,16,1765,-1,,1912,1632
5,1,29,1,1,1,1616,147,16,1765,95, ,1912,1632
2,1,30,0,0,0,51,995,9,907,-1,,1902,60
3,1,30,1,0,0,51,995,9,907,-1,,1902,60
4,1,30,1,1,0,51,995,9,907,-1,,1902,60
5,1,30,1,1,1,51,995,9,907,95, ,1902,60
2,1,31,0,0,0,75,1918,1524,68,-1,,1986,1599
3,1,31,1,0,0,75,1918,1524,17,-1,,1935,1599
4,1,31,1,1,0,75,1918,1524,17,-1,,1935,1599
5,1,31,1,1,1,75,1918,67,11,88,PRODUCT,1929,142
5,1,31,1,1,2,151,1914,16,23,54,=|,1937,167
5,1,31,1,1,3,168,1918,36,11,54,TANK,1929,204
5,1,31,1,1,4,209,1918,68,12,40,GAPACITY|,1930,277
5,1,31,1,1,5,284,1919,49,11,92,WATER,1930,333
5,1,31,1,1,6,339,1919,21,11,78,DIP|,1930,360
5,1,31,1,1,7,613,1920,45,11,91,AFTER,1931,658
5,1,31,1,1,8,664,1920,30,12,24,DIPS),1932,694
5,1,31,1,1,9,706,1920,52,12,96,ENDING,1932,758
5,1,31,1,1,10,763,1921,50,11,88,INVENT,1932,813
5,1,31,1,1,11,858,1921,69,12,96,PRODUCT,1933,927
5,1,31,1,1,12,1154,1922,55,12,91,BEFORE,1934,1209
5,1,31,1,1,13,1214,1922,31,12,91,DIPS,1934,1245
5,1,31,1,1,14,1254,1918,8,24,96,|,1942,1262
5,1,31,1,1,15,1270,1922,56,12,96,BEFORE,1934,1326
5,1,31,1,1,16,1332,1923,49,11,96,INVENT,1934,1381
5,1,31,1,1,17,1386,1918,8,24,96,|,1942,1394
5,1,31,1,1,18,1398,1924,44,10,96,AFTER,1934,1442
5,1,31,1,1,19,1448,1924,30,10,72,DIPS,1934,1478
5,1,31,1,1,20,1492,1924,53,10,94,ENDING,1934,1545
5,1,31,1,1,21,1550,1924,49,11,95,INVENT,1935,1599
3,1,31,2,0,0,78,1930,1509,27,-1,,1957,1587
4,1,31,2,1,0,78,1930,1509,27,-1,,1957,1587
5,1,31,2,1,1,78,1930,60,24,94,PRODUIT,1954,138
5,1,31,2,1,2,171,1935,96,12,91,CONTENANCE,1947,267
5,1,31,2,1,3,275,1931,10,24,93,|,1955,285
5,1,31,2,1,4,287,1936,67,11,88,MEASURE,1947,354
5,1,31,2,1,5,361,1931,6,24,88,|,1955,367
5,1,31,2,1,6,378,1936,46,11,15,AVANT,1947,424
5,1,31,2,1,7,429,1936,15,11,15,LE,1947,444
5,1,31,2,1,8,492,1937,82,11,80,INVENTAIRE,1948,574
5,1,31,2,1,9,594,1939,2,2,2,~,1941,596
5,1,31,2,1,10,604,1933,9,23,92,|,1956,613
5,1,31,2,1,11,619,1937,46,11,91,APRES,1948,665
5,1,31,2,1,12,670,1938,16,10,95,LE,1948,686
5,1,31,2,1,13,719,1934,82,23,23,INVENTAIRE,1957,801
5,1,31,2,1,14,862,1938,61,11,90,PRODUIT,1949,923
5,1,31,2,1,15,1164,1939,46,11,96,AVANT,1950,1210
5,1,31,2,1,16,1215,1940,16,10,57,LE,1950,1231
5,1,31,2,1,17,1284,1940,82,11,16,INVENTAIRE,1951,1366
5,1,31,2,1,18,1403,1940,46,11,92,APRES,1951,1449
5,1,31,2,1,19,1454,1940,16,11,95,LE,1951,1470
5,1,31,2,1,20,1506,1940,81,12,92,INVENTAIRE,1952,1587
3,1,31,3,0,0,169,1950,1396,36,-1,,1986,1565
4,1,31,3,1,0,169,1950,1396,24,-1,,1974,1565
5,1,31,3,1,1,169,1952,17,11,79,DU,1963,186
5,1,31,3,1,2,192,1952,80,11,58,RESERVIOR:,1963,272
5,1,31,3,1,3,375,1952,74,12,66,JAUGEAGE,1964,449
5,1,31,3,1,4,496,1954,75,11,89,JAUGEAGE,1965,571
5,1,31,3,1,5,613,1954,75,11,88,JAUGEAGE,1965,688
5,1,31,3,1,6,736,1950,50,24,17,APRES:,1974,786
5,1,31,3,1,7,1161,1956,75,11,89,JAUGEAGE,1967,1236
5,1,31,3,1,8,1289,1956,75,12,87,JAUGEAGE,1968,1364
5,1,31,3,1,9,1390,1957,1,12,66,|,1969,1391
5,1,31,3,1,10,1397,1956,75,12,89,JAUGEAGE,1968,1472
5,1,31,3,1,11,1520,1957,45,11,90,APRES,1968,1565
4,1,31,3,2,0,534,1968,858,18,-1,,1986,1392
5,1,31,3,2,1,534,1969,43,1,61,AGE,1970,577
5,1,31,3,2,2,605,1968,9,9,63,|,1977,614
5,1,31,3,2,3,632,1969,6,2,41,AU,1971,638
5,1,31,3,2,4,1250,1972,3,1,0,;,1973,1253
5,1,31,3,2,5,1389,1973,3,13,82,1,1986,1392
2,1,32,0,0,0,586,1965,1025,11,-1,,1976,1611
3,1,32,1,0,0,586,1965,1025,11,-1,,1976,1611
4,1,32,1,1,0,586,1965,1025,11,-1,,1976,1611
5,1,32,1,1,1,586,1965,1025,11,95, ,1976,1611
2,1,33,0,0,0,64,1961,1547,17,-1,,1978,1611
3,1,33,1,0,0,64,1961,1547,17,-1,,1978,1611
4,1,33,1,1,0,64,1961,1547,17,-1,,1978,1611
5,1,33,1,1,1,64,1961,1547,17,95, ,1978,1611
2,1,34,0,0,0,651,2027,967,10,-1,,2037,1618
3,1,34,1,0,0,651,2027,967,10,-1,,2037,1618
4,1,34,1,1,0,651,2027,967,10,-1,,2037,1618
5,1,34,1,1,1,651,2027,967,10,95, ,2037,1618
2,1,35,0,0,0,74,2026,431,6,-1,,2032,505
3,1,35,1,0,0,74,2026,431,6,-1,,2032,505
4,1,35,1,1,0,74,2026,431,6,-1,,2032,505
5,1,35,1,1,1,74,2026,431,6,95, ,2032,505
2,1,36,0,0,0,1129,2091,313,6,-1,,2097,1442
3,1,36,1,0,0,1129,2091,313,6,-1,,2097,1442
4,1,36,1,1,0,1129,2091,313,6,-1,,2097,1442
5,1,36,1,1,1,1129,2091,313,6,95, ,2097,1442
2,1,37,0,0,0,106,2086,837,10,-1,,2096,943
3,1,37,1,0,0,106,2086,837,10,-1,,2096,943
4,1,37,1,1,0,106,2086,837,10,-1,,2096,943
5,1,37,1,1,1,106,2086,837,10,95, ,2096,943
2,1,38,0,0,0,163,1911,3,202,-1,,2113,166
3,1,38,1,0,0,163,1911,3,202,-1,,2113,166
4,1,38,1,1,0,163,1911,3,202,-1,,2113,166
5,1,38,1,1,1,163,1911,3,202,95, ,2113,166
2,1,39,0,0,0,1143,1916,5,236,-1,,2152,1148
3,1,39,1,0,0,1143,1916,5,236,-1,,2152,1148
4,1,39,1,1,0,1143,1916,5,236,-1,,2152,1148
5,1,39,1,1,1,1143,1916,5,236,95, ,2152,1148
2,1,40,0,0,0,361,1912,5,237,-1,,2149,366
3,1,40,1,0,0,361,1912,5,237,-1,,2149,366
4,1,40,1,1,0,361,1912,5,237,-1,,2149,366
5,1,40,1,1,1,361,1912,5,237,95, ,2149,366
2,1,41,0,0,0,693,1916,6,234,-1,,2150,699
3,1,41,1,0,0,693,1916,6,234,-1,,2150,699
4,1,41,1,1,0,693,1916,6,234,-1,,2150,699
5,1,41,1,1,1,693,1916,6,234,95,,2150,699
1,1,0,0,0,0,0,0,1700,2200,-1,,2200,1700
2,1,1,0,0,0,907,88,611,22,-1,,110,1518
3,1,1,1,0,0,907,88,611,22,-1,,110,1518
4,1,1,1,1,0,907,88,611,22,-1,,110,1518
5,1,1,1,1,1,907,89,116,21,96,VEHICLE,110,1023
5,1,1,1,1,2,1034,89,121,21,96,LOADING,110,1155
5,1,1,1,1,3,1168,89,113,21,93,REPORT,110,1281
5,1,1,1,1,4,1290,101,7,2,92,-,103,1297
5,1,1,1,1,5,1308,89,55,21,94,BILL,110,1363
5,1,1,1,1,6,1372,89,37,21,93,OF,110,1409
5,1,1,1,1,7,1419,88,99,22,90,LADING,110,1518
2,1,2,0,0,0,64,136,1397,15,-1,,151,1461
3,1,2,1,0,0,64,136,1397,15,-1,,151,1461
4,1,2,1,1,0,64,136,1397,15,-1,,151,1461
5,1,2,1,1,1,64,136,1397,15,95, ,151,1461
2,1,3,0,0,0,1061,239,567,7,-1,,246,1628
3,1,3,1,0,0,1061,239,567,7,-1,,246,1628
4,1,3,1,1,0,1061,239,567,7,-1,,246,1628
5,1,3,1,1,1,1061,239,567,7,95, ,246,1628
2,1,4,0,0,0,59,236,613,7,-1,,243,672
3,1,4,1,0,0,59,236,613,7,-1,,243,672
4,1,4,1,1,0,59,236,613,7,-1,,243,672
5,1,4,1,1,1,59,236,613,7,95, ,243,672
2,1,5,0,0,0,341,238,331,4,-1,,242,672
3,1,5,1,0,0,341,238,331,4,-1,,242,672
4,1,5,1,1,0,341,238,331,4,-1,,242,672
5,1,5,1,1,1,341,238,331,4,95, ,242,672
2,1,6,0,0,0,667,241,2,44,-1,,285,669
3,1,6,1,0,0,667,241,2,44,-1,,285,669
4,1,6,1,1,0,667,241,2,44,-1,,285,669
5,1,6,1,1,1,667,241,2,44,95, ,285,669
2,1,7,0,0,0,848,240,3,58,-1,,298,851
3,1,7,1,0,0,848,240,3,58,-1,,298,851
4,1,7,1,1,0,848,240,3,58,-1,,298,851
5,1,7,1,1,1,848,240,3,58,95, ,298,851
2,1,8,0,0,0,267,409,580,5,-1,,414,847
3,1,8,1,0,0,267,409,580,5,-1,,414,847
4,1,8,1,1,0,267,409,580,5,-1,,414,847
5,1,8,1,1,1,267,409,580,5,95, ,414,847
2,1,9,0,0,0,163,479,83,2,-1,,481,246
3,1,9,1,0,0,163,479,83,2,-1,,481,246
4,1,9,1,1,0,163,479,83,2,-1,,481,246
5,1,9,1,1,1,163,479,83,2,95, ,481,246
2,1,10,0,0,0,401,479,449,5,-1,,484,850
3,1,10,1,0,0,401,479,449,5,-1,,484,850
4,1,10,1,1,0,401,479,449,5,-1,,484,850
5,1,10,1,1,1,401,479,449,5,95, ,484,850
2,1,11,0,0,0,709,520,699,8,-1,,528,1408
3,1,11,1,0,0,709,520,699,8,-1,,528,1408
4,1,11,1,1,0,709,520,699,8,-1,,528,1408
5,1,11,1,1,1,709,520,699,8,95, ,528,1408
2,1,12,0,0,0,57,164,6,481,-1,,645,63
3,1,12,1,0,0,57,164,6,481,-1,,645,63
4,1,12,1,1,0,57,164,6,481,-1,,645,63
5,1,12,1,1,1,57,164,6,481,95, ,645,63
2,1,13,0,0,0,708,481,4,195,-1,,676,712
3,1,13,1,0,0,708,481,4,195,-1,,676,712
4,1,13,1,1,0,708,481,4,195,-1,,676,712
5,1,13,1,1,1,708,481,4,195,95, ,676,712
2,1,14,0,0,0,1397,677,230,3,-1,,680,1627
3,1,14,1,0,0,1397,677,230,3,-1,,680,1627
4,1,14,1,1,0,1397,677,230,3,-1,,680,1627
5,1,14,1,1,1,1397,677,230,3,95, ,680,1627
2,1,15,0,0,0,959,673,668,9,-1,,682,1627
3,1,15,1,0,0,959,673,668,9,-1,,682,1627
4,1,15,1,1,0,959,673,668,9,-1,,682,1627
5,1,15,1,1,1,959,673,668,9,95, ,682,1627
2,1,16,0,0,0,58,671,722,7,-1,,678,780
3,1,16,1,0,0,58,671,722,7,-1,,678,780
4,1,16,1,1,0,58,671,722,7,-1,,678,780
5,1,16,1,1,1,58,671,722,7,95, ,678,780
2,1,17,0,0,0,57,739,1569,11,-1,,750,1626
3,1,17,1,0,0,57,739,1569,11,-1,,750,1626
4,1,17,1,1,0,57,739,1569,11,-1,,750,1626
5,1,17,1,1,1,57,739,1569,11,95, ,750,1626
2,1,18,0,0,0,534,741,1092,10,-1,,751,1626
3,1,18,1,0,0,534,741,1092,10,-1,,751,1626
4,1,18,1,1,0,534,741,1092,10,-1,,751,1626
5,1,18,1,1,1,534,741,1092,10,95, ,751,1626
2,1,19,0,0,0,1277,676,3,334,-1,,1010,1280
3,1,19,1,0,0,1277,676,3,334,-1,,1010,1280
4,1,19,1,1,0,1277,676,3,334,-1,,1010,1280
5,1,19,1,1,1,1277,676,3,334,95, ,1010,1280
2,1,20,0,0,0,941,686,5,692,-1,,1378,946
3,1,20,1,0,0,941,686,5,692,-1,,1378,946
4,1,20,1,1,0,941,686,5,692,-1,,1378,946
5,1,20,1,1,1,941,686,5,692,95, ,1378,946
2,1,21,0,0,0,1274,676,8,862,-1,,1538,1282
3,1,21,1,0,0,1274,676,8,862,-1,,1538,1282
4,1,21,1,1,0,1274,676,8,862,-1,,1538,1282
5,1,21,1,1,1,1274,676,8,862,95, ,1538,1282
2,1,22,0,0,0,247,674,8,1002,-1,,1676,255
3,1,22,1,0,0,247,674,8,1002,-1,,1676,255
4,1,22,1,1,0,247,674,8,1002,-1,,1676,255
5,1,22,1,1,1,247,674,8,1002,95, ,1676,255
2,1,23,0,0,0,1412,677,9,1014,-1,,1691,1421
3,1,23,1,0,0,1412,677,9,1014,-1,,1691,1421
4,1,23,1,1,0,1412,677,9,1014,-1,,1691,1421
5,1,23,1,1,1,1412,677,9,1014,95, ,1691,1421
2,1,24,0,0,0,1120,676,8,1014,-1,,1690,1128
3,1,24,1,0,0,1120,676,8,1014,-1,,1690,1128
4,1,24,1,1,0,1120,676,8,1014,-1,,1690,1128
5,1,24,1,1,1,1120,676,8,1014,95, ,1690,1128
2,1,25,0,0,0,57,1683,338,4,-1,,1687,395
3,1,25,1,0,0,57,1683,338,4,-1,,1687,395
4,1,25,1,1,0,57,1683,338,4,-1,,1687,395
5,1,25,1,1,1,57,1683,338,4,95, ,1687,395
2,1,26,0,0,0,551,1686,562,4,-1,,1690,1113
3,1,26,1,0,0,551,1686,562,4,-1,,1690,1113
4,1,26,1,1,0,551,1686,562,4,-1,,1690,1113
5,1,26,1,1,1,551,1686,562,4,95, ,1690,1113
2,1,27,0,0,0,954,1742,549,6,-1,,1748,1503
3,1,27,1,0,0,954,1742,549,6,-1,,1748,1503
4,1,27,1,1,0,954,1742,549,6,-1,,1748,1503
5,1,27,1,1,1,954,1742,549,6,95, ,1748,1503
2,1,28,0,0,0,1495,678,9,1152,-1,,1830,1504
3,1,28,1,0,0,1495,678,9,1152,-1,,1830,1504
4,1,28,1,1,0,1495,678,9,1152,-1,,1830,1504
5,1,28,1,1,1,1495,678,9,1152,95, ,1830,1504
2,1,29,0,0,0,954,1688,2,140,-1,,1828,956
3,1,29,1,0,0,954,1688,2,140,-1,,1828,956
4,1,29,1,1,0,954,1688,2,140,-1,,1828,956
5,1,29,1,1,1,954,1688,2,140,95, ,1828,956
2,1,30,0,0,0,1079,1744,2,84,-1,,1828,1081
3,1,30,1,0,0,1079,1744,2,84,-1,,1828,1081
4,1,30,1,1,0,1079,1744,2,84,-1,,1828,1081
5,1,30,1,1,1,1079,1744,2,84,95, ,1828,1081
2,1,31,0,0,0,927,1824,696,8,-1,,1832,1623
3,1,31,1,0,0,927,1824,696,8,-1,,1832,1623
4,1,31,1,1,0,927,1824,696,8,-1,,1832,1623
5,1,31,1,1,1,927,1824,696,8,95, ,1832,1623
2,1,32,0,0,0,54,1821,399,5,-1,,1826,453
3,1,32,1,0,0,54,1821,399,5,-1,,1826,453
4,1,32,1,1,0,54,1821,399,5,-1,,1826,453
5,1,32,1,1,1,54,1821,399,5,95, ,1826,453
2,1,33,0,0,0,1617,142,16,1751,-1,,1893,1633
3,1,33,1,0,0,1617,142,16,1751,-1,,1893,1633
4,1,33,1,1,0,1617,142,16,1751,-1,,1893,1633
5,1,33,1,1,1,1617,142,16,1751,95, ,1893,1633
2,1,34,0,0,0,930,1861,699,67,-1,,1928,1629
3,1,34,1,0,0,930,1861,699,67,-1,,1928,1629
4,1,34,1,1,0,930,1861,699,27,-1,,1888,1629
5,1,34,1,1,1,930,1861,390,27,95, ,1888,1320
5,1,34,1,1,2,1532,1861,97,27,95, ,1888,1629
4,1,34,1,2,0,930,1888,699,40,-1,,1928,1629
5,1,34,1,2,1,930,1888,699,40,95, ,1928,1629
2,1,35,0,0,0,55,116,1572,1798,-1,,1914,1627
3,1,35,1,0,0,55,116,1572,1792,-1,,1908,1627
4,1,35,1,1,0,143,116,1481,28,-1,,144,1624
5,1,35,1,1,1,143,123,74,21,95,Page:,144,217
5,1,35,1,1,2,242,120,12,19,94,1,139,254
5,1,35,1,1,3,475,121,44,19,96,530,140,519
5,1,35,1,1,4,810,117,132,22,95,RAPPORT,139,942
5,1,35,1,1,5,952,117,35,21,91,DE,138,987
5,1,35,1,1,6,998,117,196,22,82,CHARGEMENT,139,1194
5,1,35,1,1,7,1204,129,6,3,92,-,132,1210
5,1,35,1,1,8,1220,117,137,22,90,VEHICULE,139,1357
5,1,35,1,1,9,1368,129,6,2,91,-,131,1374
5,1,35,1,1,10,1384,116,240,28,57,CONNAISSEMENT,144,1624
4,1,35,1,2,0,132,143,621,40,-1,,183,753
5,1,35,1,2,1,132,151,109,15,95,DOCUMENT,166,241
5,1,35,1,2,2,248,151,81,15,77,NUMBER,166,329
5,1,35,1,2,3,359,151,61,19,77,6934,170,420
5,1,35,1,2,4,532,147,36,25,63,ORE,172,568
5,1,35,1,2,5,574,143,93,40,0,DEXSEDITION,183,667
4,1,35,1,3,0,162,170,143,15,-1,,185,305
5,1,35,1,3,1,162,170,11,15,81,DU,185,173
5,1,35,1,3,2,252,170,53,15,94,DOCUMENT,185,305
4,1,35,1,4,0,131,169,1475,37,-1,,206,1606
5,1,35,1,4,1,131,169,23,16,68,No,185,154
5,1,35,1,4,2,176,169,73,17,12,DUDOCY,186,249
5,1,35,1,4,3,474,185,1,10,50,|,195,475
5,1,35,1,4,4,522,182,133,22,54,mm/ad/yy,204,655
5,1,35,1,4,5,751,174,2,23,78,|,197,753
5,1,35,1,4,6,796,185,28,20,78,24,205,824
5,1,35,1,4,7,836,184,77,22,87,HOUR,206,913
5,1,35,1,4,8,924,184,117,22,69,NUMBER,206,1041
5,1,35,1,4,9,1062,182,207,22,50,_(613)996-6666,204,1269
5,1,35,1,4,10,1287,169,27,48,13,_-,217,1314
5,1,35,1,4,11,1324,184,121,22,96,NUMERO,206,1445
5,1,35,1,4,12,1455,184,29,22,96,24,206,1484
5,1,35,1,4,13,1494,184,112,22,95,HEURES,206,1606
4,1,35,1,5,0,144,206,1483,34,-1,,240,1627
5,1,35,1,5,1,144,212,109,17,96,0362682,229,253
5,1,35,1,5,2,276,212,93,19,96,10/007,231,369
5,1,35,1,5,3,474,206,1,34,39,|,240,475
5,1,35,1,5,4,524,212,129,19,39,10/08/24,231,653
5,1,35,1,5,5,1046,214,232,22,93,COLLECT,236,1278
5,1,35,1,5,6,1175,208,14,42,93,-,250,1189
5,1,35,1,5,7,1203,214,74,22,92,FRAIS,236,1277
5,1,35,1,5,8,1288,214,81,22,91,VIRES,236,1369
5,1,35,1,5,9,1626,235,1,4,59,|,239,1627
4,1,35,1,6,0,72,240,1538,26,-1,,266,1610
5,1,35,1,6,1,72,243,197,14,65,CONSIGNEE/CUSTOMER,257,269
5,1,35,1,6,2,276,251,4,2,88,-,253,280
5,1,35,1,6,3,286,243,183,14,92,DESTINATAIRE/CLIENT,257,469
5,1,35,1,6,4,684,234,68,36,26,LOCATION,270,752
5,1,35,1,6,5,761,234,72,36,0,WuuETEyr,270,833
5,1,35,1,6,6,842,241,1,1,49,|,242,843
5,1,35,1,6,7,858,244,101,13,53,CONSIGNOA,257,959
5,1,35,1,6,8,966,252,4,1,90,-,253,970
5,1,35,1,6,9,976,245,105,12,88,EXPEDITEUR,257,1081
5,1,35,1,6,10,1172,242,65,1,20,a,243,1237
5,1,35,1,6,11,1461,237,18,37,73,No,274,1479
5,1,35,1,6,12,1471,241,139,25,18,DETASLISSEMENT,266,1610
4,1,35,1,7,0,142,273,1443,29,-1,,302,1585
5,1,35,1,7,1,142,274,80,17,92,PETRO,291,222
5,1,35,1,7,2,240,274,99,17,96,CANADA,291,339
5,1,35,1,7,3,356,274,163,17,96,LUBRICANTS,291,519
5,1,35,1,7,4,540,274,47,17,96,INC,291,587
5,1,35,1,7,5,667,273,168,29,39,(0005064508,302,835
5,1,35,1,7,6,856,274,98,17,92,SUNCOR,291,954
5,1,35,1,7,7,972,274,99,18,96,ENERGY,292,1071
5,1,35,1,7,8,1088,274,133,17,96,MONTREAL,291,1221
5,1,35,1,7,9,1474,273,111,18,95,0082041,291,1585
4,1,35,1,8,0,142,299,1329,24,-1,,323,1471
5,1,35,1,8,1,142,304,62,17,91,PCLI,321,204
5,1,35,1,8,2,226,311,11,2,91,-,313,237
5,1,35,1,8,3,258,304,96,19,95,QUEBEC,323,354
5,1,35,1,8,4,374,303,45,18,96,302,321,419
5,1,35,1,8,5,672,302,163,19,95,0009406423,321,835
5,1,35,1,8,6,848,299,87,22,7,11675,321,935
5,1,35,1,8,7,956,308,47,13,96,rue,321,1003
5,1,35,1,8,8,1024,303,163,18,96,Sherbrooke,321,1187
5,1,35,1,8,9,1207,305,46,16,96,est,321,1253
5,1,35,1,8,10,1448,302,23,1,0,i,303,1471
4,1,35,1,9,0,142,332,1344,22,-1,,354,1486
5,1,35,1,9,1,142,332,45,18,96,385,350,187
5,1,35,1,9,2,209,333,146,17,95,SOUTHDOWN,350,355
5,1,35,1,9,3,373,333,64,17,96,ROAD,350,437
5,1,35,1,9,4,854,333,143,21,95,"Montreal,",354,997
5,1,35,1,9,5,1022,334,31,20,62,QC,354,1053
5,1,35,1,9,6,1072,333,49,18,87,H1B,351,1121
5,1,35,1,9,7,1141,333,44,19,71,1C3,352,1185
5,1,35,1,9,8,1280,333,68,21,91,(613),354,1348
5,1,35,1,9,9,1361,333,125,19,91,996-6666,352,1486
4,1,35,1,10,0,140,362,378,20,-1,,382,518
5,1,35,1,10,1,140,363,192,19,95,"MISSISSAUGA,",382,332
5,1,35,1,10,2,357,363,32,17,92,ON,380,389
5,1,35,1,10,3,406,362,49,18,0,L5d,380,455
5,1,35,1,10,4,474,362,44,18,84,2Â¥3,380,518
4,1,35,1,11,0,555,391,549,23,-1,,414,1104
5,1,35,1,11,1,555,411,4,3,0,.,414,559
5,1,35,1,11,2,634,412,7,1,55,_,413,641
5,1,35,1,11,3,855,391,116,21,96,Yannick,412,971
5,1,35,1,11,4,988,392,116,20,95,Mercier,412,1104
4,1,35,1,12,0,59,409,782,31,-1,,440,841
5,1,35,1,12,1,59,409,1,11,49,},420,60
5,1,35,1,12,2,267,415,1,25,93,|,440,268
5,1,35,1,12,3,274,414,62,12,93,RELEASE,426,336
5,1,35,1,12,4,342,414,47,14,44,(C-cl-A),428,389
5,1,35,1,12,5,394,415,59,11,95,NUMBER,426,453
5,1,35,1,12,6,564,415,79,11,92,CUSTOMER,426,643
5,1,35,1,12,7,648,415,75,12,95,PURCHASE,427,723
5,1,35,1,12,8,728,415,49,12,45,ORDER,427,777
5,1,35,1,12,9,783,416,58,11,96,NUMBER,427,841
4,1,35,1,13,0,59,427,746,14,-1,,441,805
5,1,35,1,13,1,59,427,1,14,92,|,441,60
5,1,35,1,13,2,614,429,17,11,94,No,440,631
5,1,35,1,13,3,636,429,18,11,96,DE,440,654
5,1,35,1,13,4,659,429,68,11,95,DEMANDE,440,727
5,1,35,1,13,5,732,429,19,11,95,DU,440,751
5,1,35,1,13,6,756,429,49,11,71,CLIENT,440,805
4,1,35,1,14,0,267,451,1,25,-1,,476,268
5,1,35,1,14,1,267,451,1,25,86,|,476,268
4,1,35,1,15,0,72,480,778,36,-1,,516,850
5,1,35,1,15,1,72,480,225,23,71,CARRIER-TRANSPORTEUR,503,297
5,1,35,1,15,2,565,481,11,1,41,7,482,576
5,1,35,1,15,3,674,482,7,1,0,-,483,681
4,1,35,1,16,0,141,513,1484,32,-1,,545,1625
5,1,35,1,16,1,141,513,48,18,91,GEO,531,189
5,1,35,1,16,2,206,514,17,17,96,A,531,223
5,1,35,1,16,3,240,515,65,16,96,HALL,531,305
5,1,35,1,16,4,574,514,111,18,82,0101535,532,685
5,1,35,1,16,5,702,510,11,44,10,|,554,713
5,1,35,1,16,6,730,529,71,15,0,~VeniclÃ©,544,801
5,1,35,1,16,7,806,518,71,26,8,NUMBER,544,877
5,1,35,1,16,8,920,523,69,21,62,LICENSE,544,989
5,1,35,1,16,9,999,524,67,20,78,NUWBER,544,1066
5,1,35,1,16,10,1097,526,1,11,72,|,537,1098
5,1,35,1,16,11,1128,531,79,13,16,ADDRESS,544,1207
5,1,35,1,16,12,1214,531,21,13,95,OF,544,1235
5,1,35,1,16,13,1242,531,56,13,95,METER,544,1298
5,1,35,1,16,14,1304,531,34,13,95,AND,544,1338
5,1,35,1,16,15,1344,531,67,14,62,TRADER,545,1411
5,1,35,1,16,16,1568,526,57,1,26,|,527,1625
4,1,35,1,17,0,142,543,1333,24,-1,,567,1475
5,1,35,1,17,1,142,543,62,18,92,8800,561,204
5,1,35,1,17,2,226,552,11,2,92,-,554,237
5,1,35,1,17,3,258,543,30,19,85,6E,562,288
5,1,35,1,17,4,306,544,148,18,91,CROISSANT,562,454
5,1,35,1,17,5,709,552,2,5,73,|,557,711
5,1,35,1,17,6,734,552,19,13,73,No,565,753
5,1,35,1,17,7,760,552,21,14,91,DU,566,781
5,1,35,1,17,8,788,552,81,14,90,VEHICULE,566,869
5,1,35,1,17,9,919,553,72,13,96,NOMBRE,566,991
5,1,35,1,17,10,998,553,21,13,91,DE,566,1019
5,1,35,1,17,11,1026,553,61,13,90,PERMIS,566,1087
5,1,35,1,17,12,1095,545,12,31,89,|,576,1107
5,1,35,1,17,13,1114,553,91,13,86,L'ADRESSE,566,1205
5,1,35,1,17,14,1211,553,22,14,96,DE,567,1233
5,1,35,1,17,15,1239,553,56,14,96,METRE,567,1295
5,1,35,1,17,16,1302,553,20,14,96,ET,567,1322
5,1,35,1,17,17,1328,553,21,14,93,DE,567,1349
5,1,35,1,17,18,1356,553,119,14,91,COMMERCANT,567,1475
4,1,35,1,18,0,140,569,1363,33,-1,,602,1503
5,1,35,1,18,1,140,569,83,33,96,ANJOU,602,223
5,1,35,1,18,2,724,575,61,19,72,1111,594,785
5,1,35,1,18,3,1107,577,78,18,93,11675,595,1185
5,1,35,1,18,4,1206,582,48,14,95,rue,596,1254
5,1,35,1,18,5,1274,577,163,19,96,Sherbrooke,596,1437
5,1,35,1,18,6,1456,579,47,17,96,est,596,1503
4,1,35,1,19,0,140,604,1295,26,-1,,630,1435
5,1,35,1,19,1,140,604,49,19,20,H1J,623,189
5,1,35,1,19,2,208,604,45,19,38,1A1,623,253
5,1,35,1,19,3,483,604,87,25,2,EE,629,570
5,1,35,1,19,4,589,604,77,25,16,aces,629,666
5,1,35,1,19,5,723,606,62,19,96,1096,625,785
5,1,35,1,19,6,1104,608,143,21,96,"Montreal,",629,1247
5,1,35,1,19,7,1272,609,31,21,92,QC,630,1303
5,1,35,1,19,8,1322,608,49,18,84,H1B,626,1371
5,1,35,1,19,9,1390,608,45,19,33,1c3,627,1435
4,1,35,1,20,0,59,634,1260,25,-1,,659,1319
5,1,35,1,20,1,59,648,1,5,87,|,653,60
5,1,35,1,20,2,147,634,206,21,56,(514)352-5550,655,353
5,1,35,1,20,3,1112,638,68,21,44,(613),659,1180
5,1,35,1,20,4,1190,638,129,18,44,996-6666,656,1319
4,1,35,1,21,0,107,673,1240,27,-1,,700,1347
5,1,35,1,21,1,107,673,64,2,24,a,675,171
5,1,35,1,21,2,792,675,114,2,22,rn,677,906
5,1,35,1,21,3,939,676,10,7,73,|,683,949
5,1,35,1,21,4,1158,686,93,14,82,MEASURED,700,1251
5,1,35,1,21,5,1329,677,18,1,6,-,678,1347
4,1,35,1,22,0,72,694,1521,25,-1,,719,1593
5,1,35,1,22,1,72,694,143,13,89,PRODUCT/METER,707,215
5,1,35,1,22,2,1172,706,57,13,68,LITRES,719,1229
5,1,35,1,22,3,1302,698,105,13,81,CORRECTED,711,1407
5,1,35,1,22,4,1414,687,12,34,71,|,721,1426
5,1,35,1,22,5,1435,698,46,13,94,TEMP,711,1481
5,1,35,1,22,6,1493,687,12,34,94,|,721,1505
5,1,35,1,22,7,1522,698,71,14,94,DENSITY,712,1593
4,1,35,1,23,0,72,708,1520,36,-1,,744,1592
5,1,35,1,23,1,72,721,132,14,76,PRODUIT/METER,735,204
5,1,35,1,23,2,212,743,7,1,0,_,744,219
5,1,35,1,23,3,364,708,81,14,0,BOpwET,722,445
5,1,35,1,23,4,451,709,112,13,10,DESCAIBTION=,722,563
5,1,35,1,23,5,580,709,111,14,18,DESCRIPTION,723,691
5,1,35,1,23,6,698,710,21,13,55,DU,723,719
5,1,35,1,23,7,726,710,75,13,58,PRODUIT,723,801
5,1,35,1,23,8,1158,726,92,13,92,MESUREES,739,1250
5,1,35,1,23,9,1327,726,62,13,14,TO1sC,739,1389
5,1,35,1,23,10,1424,726,71,13,45,|CELSIUS|,739,1495
5,1,35,1,23,11,1522,726,70,14,68,DENSITE,740,1592
4,1,35,1,24,0,57,756,1527,27,-1,,783,1584
5,1,35,1,24,1,57,771,1,12,96,|,783,58
5,1,35,1,24,2,142,756,93,19,93,103265,775,235
5,1,35,1,24,3,248,752,17,33,93,|,785,265
5,1,35,1,24,4,272,758,49,18,95,NOT,776,321
5,1,35,1,24,5,338,758,148,18,95,REGULATED,776,486
5,1,35,1,24,6,504,760,83,16,96,UNDER,776,587
5,1,35,1,24,7,604,759,49,18,96,TDG,777,653
5,1,35,1,24,8,973,759,94,19,96,0.9645,778,1067
5,1,35,1,24,9,1172,760,79,19,95,44001,779,1251
5,1,35,1,24,10,1323,760,78,19,91,42439,779,1401
5,1,35,1,24,11,1424,760,60,19,87,|61.3,779,1484
5,1,35,1,24,12,1506,761,78,18,87,|910.6,779,1584
4,1,35,1,25,0,139,788,947,22,-1,,810,1086
5,1,35,1,25,1,139,788,96,18,90,MTR271,806,235
5,1,35,1,25,2,247,784,14,32,78,|,816,261
5,1,35,1,25,3,272,789,82,17,95,HEAVY,806,354
5,1,35,1,25,4,370,789,101,18,93,VACUUM,807,471
5,1,35,1,25,5,488,790,97,17,84,GASOIL,807,585
5,1,35,1,25,6,594,789,85,21,53,(HVGO),810,679
5,1,35,1,25,7,970,792,47,16,90,API,808,1017
5,1,35,1,25,8,1039,790,47,19,76,54B,809,1086
4,1,35,1,26,0,258,944,473,44,-1,,988,731
5,1,35,1,26,1,258,944,131,44,19,[2-55,988,389
5,1,35,1,26,2,457,952,274,34,0," O8F-10-Z0&""",986,731
4,1,35,1,27,0,250,999,514,49,-1,,1048,764
5,1,35,1,27,1,250,1010,125,38,0,/300,1048,375
5,1,35,1,27,2,456,999,109,49,2,WVGO,1048,565
5,1,35,1,27,3,594,1005,170,42,9,F7YRT,1047,764
4,1,35,1,28,0,56,1048,585,63,-1,,1111,641
5,1,35,1,28,1,56,1048,1,6,91,|,1054,57
5,1,35,1,28,2,258,1054,147,57,59,[3520,1111,405
5,1,35,1,28,3,458,1056,123,39,0,Breck,1095,581
5,1,35,1,28,4,602,1062,39,33,93,2,1095,641
4,1,35,1,29,0,1497,1379,2,10,-1,,1389,1499
5,1,35,1,29,1,1497,1379,2,10,90,|,1389,1499
4,1,35,1,30,0,304,1487,379,24,-1,,1511,683
5,1,35,1,30,1,304,1488,79,18,94,Total,1506,383
5,1,35,1,30,2,403,1487,96,20,96,Litres,1507,499
5,1,35,1,30,3,519,1488,32,23,96,by,1511,551
5,1,35,1,30,4,570,1488,113,19,96,Product,1507,683
4,1,35,1,31,0,271,1518,1128,24,-1,,1542,1399
5,1,35,1,31,1,271,1518,95,19,95,103265,1537,366
5,1,35,1,31,2,468,1521,83,17,84,HEAVY,1538,551
5,1,35,1,31,3,568,1520,101,19,93,VACUUM,1539,669
5,1,35,1,31,4,686,1521,90,18,88,GASOIL,1539,776
5,1,35,1,31,5,792,1520,85,22,90,(HVGO),1542,877
5,1,35,1,31,6,1170,1521,79,20,95,44001,1541,1249
5,1,35,1,31,7,1320,1522,79,19,95,42439,1541,1399
4,1,35,1,32,0,248,1672,1375,24,-1,,1696,1623
5,1,35,1,32,1,248,1677,3,8,37,1,1685,251
5,1,35,1,32,2,437,1686,110,2,7,â_â,1688,547
5,1,35,1,32,3,752,1687,24,1,62,â,1688,776
5,1,35,1,32,4,1280,1689,38,1,0,oe,1690,1318
5,1,35,1,32,5,1415,1689,35,2,51,â,1691,1450
5,1,35,1,32,6,1515,1690,10,1,46,_,1691,1525
5,1,35,1,32,7,1621,1672,2,24,85,|,1696,1623
4,1,35,1,33,0,68,1697,1555,21,-1,,1718,1623
5,1,35,1,33,1,68,1697,3,13,60,I,1710,71
5,1,35,1,33,2,78,1698,49,16,87,hereby,1714,127
5,1,35,1,33,3,132,1698,54,13,83,declare,1711,186
5,1,35,1,33,4,192,1698,26,13,56,that,1711,218
5,1,35,1,33,5,224,1698,22,13,96,the,1711,246
5,1,35,1,33,6,252,1700,61,11,96,contents,1711,313
5,1,35,1,33,7,318,1698,13,13,91,of,1711,331
5,1,35,1,33,8,337,1699,24,13,91,this,1712,361
5,1,35,1,33,9,368,1699,93,16,93,consignment,1715,461
5,1,35,1,33,10,466,1702,23,10,96,are,1712,489
5,1,35,1,33,11,494,1700,29,16,92,fully,1716,523
5,1,35,1,33,12,528,1700,27,12,92,and,1712,555
5,1,35,1,33,13,561,1700,75,16,87,accurately,1716,636
5,1,35,1,33,14,642,1700,71,13,89,described,1713,713
5,1,35,1,33,15,719,1701,44,12,86,abave,1713,763
5,1,35,1,33,16,768,1700,17,17,96,by,1717,785
5,1,35,1,33,17,790,1701,23,13,96,the,1714,813
5,1,35,1,33,18,818,1704,48,13,96,proper,1717,866
5,1,35,1,33,19,871,1701,60,17,87,shipping,1718,931
5,1,35,1,33,20,1621,1698,2,3,95,|,1701,1623
4,1,35,1,34,0,68,1718,878,19,-1,,1737,946
5,1,35,1,34,1,68,1720,44,12,93,"name,",1732,112
5,1,35,1,34,2,118,1720,23,10,94,are,1730,141
5,1,35,1,34,3,148,1718,58,16,68,properly,1734,206
5,1,35,1,34,4,212,1718,67,13,95,classified,1731,279
5,1,35,1,34,5,284,1718,27,13,96,and,1731,311
5,1,35,1,34,6,316,1718,75,17,96,"packaged,",1735,391
5,1,35,1,34,7,398,1718,35,14,96,have,1732,433
5,1,35,1,34,8,438,1719,77,16,96,dangerous,1735,515
5,1,35,1,34,9,522,1719,43,16,96,goods,1735,565
5,1,35,1,34,10,572,1720,43,16,96,safety,1736,615
5,1,35,1,34,11,621,1720,43,13,96,marks,1733,664
5,1,35,1,34,12,670,1720,59,16,96,properly,1736,729
5,1,35,1,34,13,736,1720,47,13,96,affixed,1733,783
5,1,35,1,34,14,788,1724,15,9,97,or,1733,803
5,1,35,1,34,15,808,1720,69,17,94,displayed,1737,877
5,1,35,1,34,16,883,1724,17,10,91,on,1734,900
5,1,35,1,34,17,906,1721,40,15,96,"them,",1736,946
4,1,35,1,35,0,68,1736,1553,25,-1,,1761,1621
5,1,35,1,35,1,68,1736,26,13,96,and,1749,94
5,1,35,1,35,2,100,1740,23,9,95,ara,1749,123
5,1,35,1,35,3,129,1736,11,13,96,in,1749,140
5,1,35,1,35,4,146,1737,15,13,86,ail,1750,161
5,1,35,1,35,5,168,1739,61,14,96,respects,1753,229
5,1,35,1,35,6,235,1737,11,13,89,in,1750,246
5,1,35,1,35,7,252,1740,47,13,96,proper,1753,299
5,1,35,1,35,8,304,1738,65,13,31,condition,1751,369
5,1,35,1,35,9,376,1738,18,13,89,for,1751,394
5,1,35,1,35,10,400,1739,64,15,82,iransport,1754,464
5,1,35,1,35,11,470,1739,70,16,86,according,1755,540
5,1,35,1,35,12,546,1740,13,12,91,to,1752,559
5,1,35,1,35,13,564,1739,23,13,95,the,1752,587
5,1,35,1,35,14,592,1739,107,16,95,Transportation,1755,699
5,1,35,1,35,15,704,1740,13,12,96,of,1752,717
5,1,35,1,35,16,724,1740,79,16,96,Dangerous,1756,803
5,1,35,1,35,17,809,1740,48,13,94,Goods,1753,857
5,1,35,1,35,18,864,1740,85,16,27,Regulations,1756,949
5,1,35,1,35,19,957,1730,9,33,27,|,1763,966
5,1,35,1,35,20,987,1748,32,11,0,â7yge,1759,1019
5,1,35,1,35,21,1025,1748,12,11,19,qn,1759,1037
5,1,35,1,35,22,1130,1748,44,12,94,START,1760,1174
5,1,35,1,35,23,1180,1748,60,12,91,LOADING,1760,1240
5,1,35,1,35,24,1311,1734,55,31,50,FINISH,1765,1366
5,1,35,1,35,25,1374,1734,58,31,52,LOADING,1765,1432
5,1,35,1,35,26,1515,1746,66,15,53,TiMeouT,1761,1581
4,1,35,1,36,0,136,1762,1441,20,-1,,1782,1577
5,1,35,1,36,1,136,1762,116,19,96,Yannick,1781,252
5,1,35,1,36,2,268,1764,65,18,93,Mere,1782,333
5,1,35,1,36,3,338,1763,11,18,84,L,1781,349
5,1,35,1,36,4,354,1768,29,14,95,er,1782,383
5,1,35,1,36,5,987,1762,60,11,83,ARRIVEE,1773,1047
5,1,35,1,36,6,1099,1762,46,11,85,OEBUT,1773,1145
5,1,35,1,36,7,1150,1762,19,11,91,DU,1773,1169
5,1,35,1,36,8,1174,1762,98,12,72,CHARGEMENT,1774,1272
5,1,35,1,36,9,1311,1763,20,11,96,FIN,1774,1331
5,1,35,1,36,10,1337,1764,18,10,89,DU,1774,1355
5,1,35,1,36,11,1360,1763,99,11,40,CHARGEMENT,1774,1459
5,1,35,1,36,12,1522,1764,55,10,81,DEPART,1774,1577
4,1,35,1,37,0,55,1795,1526,30,-1,,1825,1581
5,1,35,1,37,1,55,1811,1,5,89,|,1816,56
5,1,35,1,37,2,151,1795,56,30,95,Shipper,1825,207
5,1,35,1,37,3,214,1795,33,30,94,name,1825,247
5,1,35,1,37,4,259,1795,48,30,96,(please,1825,307
5,1,35,1,37,5,315,1795,38,30,96,print),1825,353
5,1,35,1,37,6,492,1800,37,2,44,â,1802,529
5,1,35,1,37,7,970,1797,78,18,95,04:16,1815,1048
5,1,35,1,37,8,1137,1798,78,17,96,04:24,1815,1215
5,1,35,1,37,9,1338,1798,77,18,96,04:50,1816,1415
5,1,35,1,37,10,1504,1799,77,18,96,04:50,1817,1581
4,1,35,1,38,0,68,1824,1497,22,-1,,1846,1565
5,1,35,1,38,1,68,1827,61,13,90,ORIVER,1840,129
5,1,35,1,38,2,136,1828,45,13,92,NAME,1841,181
5,1,35,1,38,3,188,1835,3,2,92,-,1837,191
5,1,35,1,38,4,198,1828,37,13,96,NOM,1841,235
5,1,35,1,38,5,242,1824,25,17,89,DU,1841,267
5,1,35,1,38,6,270,1828,116,14,90,CONDUCTEUR,1842,386
5,1,35,1,38,7,588,1825,61,18,86,DRIVER,1843,649
5,1,35,1,38,8,656,1825,70,18,78,NUMBER,1843,726
5,1,35,1,38,9,738,1821,14,33,68,|,1854,752
5,1,35,1,38,10,764,1830,59,13,95,DRIVER,1843,823
5,1,35,1,38,11,830,1827,95,17,92,SIGNATURE,1844,925
5,1,35,1,38,12,932,1838,4,2,92,-,1840,936
5,1,35,1,38,13,942,1831,96,13,60,SBNATURE,1844,1038
5,1,35,1,38,14,1044,1832,23,13,75,DU,1845,1067
5,1,35,1,38,15,1073,1832,117,13,75,CONDUCTEUR,1845,1190
5,1,35,1,38,16,1230,1827,29,4,56,|â,1831,1259
5,1,35,1,38,17,1276,1827,53,18,58,TOTAL,1845,1329
5,1,35,1,38,18,1336,1832,83,14,0,QUANTITY,1846,1419
5,1,35,1,38,19,1424,1840,5,2,0,-,1842,1429
5,1,35,1,38,20,1434,1832,61,14,93,QUANT.,1846,1495
5,1,35,1,38,21,1502,1832,63,14,93,TOTALE,1846,1565
4,1,35,1,39,0,574,1844,887,18,-1,,1862,1461
5,1,35,1,39,1,574,1844,19,13,96,No,1857,593
5,1,35,1,39,2,600,1844,22,13,91,DU,1857,622
5,1,35,1,39,3,628,1844,117,14,66,GONBUSTEUA,1858,745
5,1,35,1,39,4,1458,1858,3,4,48,:,1862,1461
4,1,35,1,40,0,780,1852,752,56,-1,,1908,1532
5,1,35,1,40,1,780,1852,150,56,20,CPEA,1908,930
5,1,35,1,40,2,982,1853,39,51,27,FZ,1904,1021
5,1,35,1,40,3,1039,1871,56,17,56,â2,1888,1095
5,1,35,1,40,4,1320,1858,79,19,84,44001,1877,1399
5,1,35,1,40,5,1435,1860,97,18,91,Litres,1878,1532
4,1,35,1,41,0,138,1882,1274,32,-1,,1914,1412
5,1,35,1,41,1,138,1882,113,31,90,OSBALDO,1913,251
5,1,35,1,41,2,304,1883,181,31,89,QUINTANILLA,1914,485
5,1,35,1,41,3,604,1887,127,19,75,00026113,1906,731
5,1,35,1,41,4,1286,1889,79,19,66,38645,1908,1365
5,1,35,1,41,5,1386,1889,26,19,66,kg,1908,1412
2,1,36,0,0,0,52,1070,9,835,-1,,1905,61
3,1,36,1,0,0,52,1070,9,835,-1,,1905,61
4,1,36,1,1,0,52,1070,9,835,-1,,1905,61
5,1,36,1,1,1,52,1070,9,835,95, ,1905,61
2,1,37,0,0,0,951,1916,193,49,-1,,1965,1144
3,1,37,1,0,0,951,1916,193,49,-1,,1965,1144
4,1,37,1,1,0,951,1916,193,16,-1,,1932,1144
5,1,37,1,1,1,951,1921,36,10,95,TANK,1931,987
5,1,37,1,1,2,992,1916,72,16,74,CAPACITY,1932,1064
5,1,37,1,1,3,1068,1921,49,11,74,WATER,1932,1117
5,1,37,1,1,4,1122,1921,22,11,89,DIP|,1932,1144
4,1,37,1,2,0,954,1937,185,12,-1,,1949,1139
5,1,37,1,2,1,954,1937,97,11,50,CONTENANGE,1948,1051
5,1,37,1,2,2,1057,1928,11,30,92,|,1958,1068
5,1,37,1,2,3,1072,1938,67,11,92,MEASURE,1949,1139
4,1,37,1,3,0,952,1954,167,11,-1,,1965,1119
5,1,37,1,3,1,952,1954,104,11,90,DURESERVIOR,1965,1056
5,1,37,1,3,2,1061,1944,9,31,73,|,1975,1070
5,1,37,1,3,3,1082,1954,37,11,21,_DEAU,1965,1119
2,1,38,0,0,0,860,1920,67,28,-1,,1948,927
3,1,38,1,0,0,860,1920,67,28,-1,,1948,927
4,1,38,1,1,0,860,1920,67,11,-1,,1931,927
5,1,38,1,1,1,860,1920,67,11,69,PRODUCT,1931,927
4,1,38,1,2,0,863,1937,61,11,-1,,1948,924
5,1,38,1,2,1,863,1937,61,11,95,PRODUIT,1948,924
2,1,39,0,0,0,1155,1922,92,44,-1,,1966,1247
3,1,39,1,0,0,1155,1922,92,44,-1,,1966,1247
4,1,39,1,1,0,1155,1922,92,10,-1,,1932,1247
5,1,39,1,1,1,1155,1922,56,10,93,BEFORE,1932,1211
5,1,39,1,1,2,1216,1922,31,10,71,DIFS,1932,1247
4,1,39,1,2,0,1166,1938,66,11,-1,,1949,1232
5,1,39,1,2,1,1166,1938,45,11,95,AVANT,1949,1211
5,1,39,1,2,2,1216,1938,16,11,95,LE,1949,1232
4,1,39,1,3,0,1162,1954,76,12,-1,,1966,1238
5,1,39,1,3,1,1162,1954,76,12,12,JAUGEAGE,1966,1238
2,1,40,0,0,0,1269,1922,332,50,-1,,1972,1601
3,1,40,1,0,0,1269,1922,332,50,-1,,1972,1601
4,1,40,1,1,0,1272,1922,329,11,-1,,1933,1601
5,1,40,1,1,1,1272,1922,55,11,70,BEFORE,1933,1327
5,1,40,1,1,2,1332,1922,51,11,93,INVENT,1933,1383
5,1,40,1,1,3,1386,1913,7,31,82,|,1944,1393
5,1,40,1,1,4,1399,1922,44,11,89,AFTER,1933,1443
5,1,40,1,1,5,1449,1922,30,11,87,DIPS|,1933,1479
5,1,40,1,1,6,1494,1922,51,11,94,ENDING,1933,1545
5,1,40,1,1,7,1552,1913,49,31,38,INVENT,1944,1601
4,1,40,1,2,0,1286,1938,303,12,-1,,1950,1589
5,1,40,1,2,1,1286,1938,82,11,75,INVENTAIRE,1949,1368
5,1,40,1,2,2,1387,1930,10,30,88,|,1960,1397
5,1,40,1,2,3,1405,1938,66,12,92,APRESLE,1950,1471
5,1,40,1,2,4,1479,1930,8,30,70,|,1960,1487
5,1,40,1,2,5,1494,1930,8,30,18,â,1960,1502
5,1,40,1,2,6,1508,1939,81,11,52,INVENTAIRE,1950,1589
4,1,40,1,3,0,1269,1955,298,17,-1,,1972,1567
5,1,40,1,3,1,1269,1955,96,16,63,__JAUGEAGE,1971,1365
5,1,40,1,3,2,1372,1947,23,30,66,_|,1977,1395
5,1,40,1,3,3,1397,1955,77,17,79,JAUSEAGE,1972,1474
5,1,40,1,3,4,1522,1956,45,10,91,APRES,1966,1567
2,1,41,0,0,0,49,1861,1580,300,-1,,2161,1629
3,1,41,1,0,0,49,1861,1580,300,-1,,2161,1629
4,1,41,1,1,0,49,1861,1580,300,-1,,2161,1629
5,1,41,1,1,1,49,1861,1580,300,95,  ,2161,1629
2,1,42,0,0,0,77,1916,67,29,-1,,1945,144
3,1,42,1,0,0,77,1916,67,29,-1,,1945,144
4,1,42,1,1,0,77,1916,67,12,-1,,1928,144
5,1,42,1,1,1,77,1916,67,12,96,PRODUCT,1928,144
4,1,42,1,2,0,80,1934,61,11,-1,,1945,141
5,1,42,1,2,1,80,1934,61,11,82,PROOUIT,1945,141
2,1,43,0,0,0,170,1917,109,45,-1,,1962,279
3,1,43,1,0,0,170,1917,109,45,-1,,1962,279
4,1,43,1,1,0,170,1917,109,12,-1,,1929,279
5,1,43,1,1,1,170,1918,36,10,95,TANK,1928,206
5,1,43,1,1,2,211,1917,68,12,86,CAPACITY),1929,279
4,1,43,1,2,0,173,1934,96,11,-1,,1945,269
5,1,43,1,2,1,173,1934,96,11,91,CONTENANCE,1945,269
4,1,43,1,3,0,170,1951,104,11,-1,,1962,274
5,1,43,1,3,1,170,1951,19,11,80,OU,1962,189
5,1,43,1,3,2,194,1951,80,11,90,RESERVIOR,1962,274
2,1,44,0,0,0,286,1918,175,45,-1,,1963,461
3,1,44,1,0,0,286,1918,175,45,-1,,1963,461
4,1,44,1,1,0,286,1918,175,12,-1,,1930,461
5,1,44,1,1,1,286,1918,49,11,75,WATER,1929,335
5,1,44,1,1,2,340,1918,21,11,91,DIP|,1929,361
5,1,44,1,1,3,370,1918,55,11,96,BEFORE,1929,425
5,1,44,1,1,4,430,1918,31,12,50,DIPS.,1930,461
4,1,44,1,2,0,380,1936,65,10,-1,,1946,445
5,1,44,1,2,1,380,1936,45,10,95,AVANT,1946,425
5,1,44,1,2,2,430,1936,15,10,96,LE,1946,445
4,1,44,1,3,0,377,1952,74,11,-1,,1963,451
5,1,44,1,3,1,377,1952,74,11,84,JAUGEAGE,1963,451
2,1,45,0,0,0,480,1919,111,45,-1,,1964,591
3,1,45,1,0,0,480,1919,111,45,-1,,1964,591
4,1,45,1,1,0,480,1919,111,11,-1,,1930,591
5,1,45,1,1,1,480,1919,55,11,91,BEFORE,1930,535
5,1,45,1,1,2,540,1919,51,11,88,INVENT,1930,591
4,1,45,1,2,0,494,1936,81,11,-1,,1947,575
5,1,45,1,2,1,494,1936,81,11,70,INVENTAIRE,1947,575
4,1,45,1,3,0,498,1952,75,12,-1,,1964,573
5,1,45,1,3,1,498,1952,75,12,90,JAUGEAGE,1964,573
2,1,46,0,0,0,615,1919,200,45,-1,,1964,815
3,1,46,1,0,0,615,1919,200,45,-1,,1964,815
4,1,46,1,1,0,615,1919,200,12,-1,,1931,815
5,1,46,1,1,1,615,1919,45,11,90,AFTER,1930,660
5,1,46,1,1,2,666,1920,21,10,69,"DIPS,",1930,687
5,1,46,1,1,3,708,1920,51,11,95,ENDING,1931,759
5,1,46,1,1,4,765,1920,50,11,92,INVENT,1931,815
4,1,46,1,2,0,621,1936,182,12,-1,,1948,803
5,1,46,1,2,1,621,1936,66,11,70,APRESLE,1947,687
5,1,46,1,2,2,696,1929,12,28,59,|,1957,708
5,1,46,1,2,3,721,1936,82,12,86,INVENTAIRE,1948,803
4,1,46,1,3,0,615,1952,168,12,-1,,1964,783
5,1,46,1,3,1,615,1952,75,12,56,JAUGEAGE,1964,690
5,1,46,1,3,2,738,1953,45,11,92,APRES,1964,783
2,1,47,0,0,0,906,1966,347,6,-1,,1972,1253
3,1,47,1,0,0,906,1966,347,6,-1,,1972,1253
4,1,47,1,1,0,906,1966,347,6,-1,,1972,1253
5,1,47,1,1,1,906,1966,347,6,95, ,1972,1253
2,1,48,0,0,0,58,1964,721,7,-1,,1971,779
3,1,48,1,0,0,58,1964,721,7,-1,,1971,779
4,1,48,1,1,0,58,1964,721,7,-1,,1971,779
5,1,48,1,1,1,58,1964,721,7,95, ,1971,779
2,1,49,0,0,0,114,2026,496,4,-1,,2030,610
3,1,49,1,0,0,114,2026,496,4,-1,,2030,610
4,1,49,1,1,0,114,2026,496,4,-1,,2030,610
5,1,49,1,1,1,114,2026,496,4,95, ,2030,610
2,1,50,0,0,0,747,2027,871,8,-1,,2035,1618
3,1,50,1,0,0,747,2027,871,8,-1,,2035,1618
4,1,50,1,1,0,747,2027,871,8,-1,,2035,1618
5,1,50,1,1,1,747,2027,871,8,95, ,2035,1618
2,1,51,0,0,0,147,2085,1303,10,-1,,2095,1450
3,1,51,1,0,0,147,2085,1303,10,-1,,2095,1450
4,1,51,1,1,0,147,2085,1303,10,-1,,2095,1450
5,1,51,1,1,1,147,2085,1303,10,95, ,2095,1450
2,1,52,0,0,0,747,2087,703,8,-1,,2095,1450
3,1,52,1,0,0,747,2087,703,8,-1,,2095,1450
4,1,52,1,1,0,747,2087,703,8,-1,,2095,1450
5,1,52,1,1,1,747,2087,703,8,95, ,2095,1450
2,1,53,0,0,0,463,1912,3,193,-1,,2105,466
3,1,53,1,0,0,463,1912,3,193,-1,,2105,466
4,1,53,1,1,0,463,1912,3,193,-1,,2105,466
5,1,53,1,1,1,463,1912,3,193,95, ,2105,466
2,1,54,0,0,0,164,1910,4,238,-1,,2148,168
3,1,54,1,0,0,164,1910,4,238,-1,,2148,168
4,1,54,1,1,0,164,1910,4,238,-1,,2148,168
5,1,54,1,1,1,164,1910,4,238,95, ,2148,168
2,1,55,0,0,0,607,1912,4,238,-1,,2150,611
3,1,55,1,0,0,607,1912,4,238,-1,,2150,611
4,1,55,1,1,0,607,1912,4,238,-1,,2150,611
5,1,55,1,1,1,607,1912,4,238,95, ,2150,611
2,1,56,0,0,0,1145,1914,4,238,-1,,2152,1149
3,1,56,1,0,0,1145,1914,4,238,-1,,2152,1149
4,1,56,1,1,0,1145,1914,4,238,-1,,2152,1149
5,1,56,1,1,1,1145,1914,4,238,95, ,2152,1149
2,1,57,0,0,0,280,1911,4,237,-1,,2148,284
3,1,57,1,0,0,280,1911,4,237,-1,,2148,284
4,1,57,1,1,0,280,1911,4,237,-1,,2148,284
5,1,57,1,1,1,280,1911,4,237,95, ,2148,284
2,1,58,0,0,0,1062,1933,3,219,-1,,2152,1065
3,1,58,1,0,0,1062,1933,3,219,-1,,2152,1065
4,1,58,1,1,0,1062,1933,3,219,-1,,2152,1065
5,1,58,1,1,1,1062,1933,3,219,95,,2152,1065
1,1,0,0,0,0,0,0,1700,2200,-1,,2200,1700
2,1,1,0,0,0,911,90,611,24,-1,,114,1522
3,1,1,1,0,0,911,90,611,24,-1,,114,1522
4,1,1,1,1,0,911,90,611,24,-1,,114,1522
5,1,1,1,1,1,911,90,116,22,96,VEHICLE,112,1027
5,1,1,1,1,2,1039,91,121,22,96,LOADING,113,1160
5,1,1,1,1,3,1172,91,112,22,93,REPORT,113,1284
5,1,1,1,1,4,1280,86,14,38,92,-,124,1294
5,1,1,1,1,5,1312,92,54,21,95,BILL,113,1366
5,1,1,1,1,6,1376,92,36,22,93,OF,114,1412
5,1,1,1,1,7,1423,92,99,22,91,LADING,114,1522
2,1,2,0,0,0,1280,144,331,5,-1,,149,1611
3,1,2,1,0,0,1280,144,331,5,-1,,149,1611
4,1,2,1,1,0,1280,144,331,5,-1,,149,1611
5,1,2,1,1,1,1280,144,331,5,95, ,149,1611
2,1,3,0,0,0,499,138,610,11,-1,,149,1109
3,1,3,1,0,0,499,138,610,11,-1,,149,1109
4,1,3,1,1,0,499,138,610,11,-1,,149,1109
5,1,3,1,1,1,499,138,610,11,95, ,149,1109
2,1,4,0,0,0,217,136,892,14,-1,,150,1109
3,1,4,1,0,0,217,136,892,14,-1,,150,1109
4,1,4,1,1,0,217,136,892,14,-1,,150,1109
5,1,4,1,1,1,217,136,892,14,95, ,150,1109
2,1,5,0,0,0,277,235,420,8,-1,,243,697
3,1,5,1,0,0,277,235,420,8,-1,,243,697
4,1,5,1,1,0,277,235,420,8,-1,,243,697
5,1,5,1,1,1,277,235,420,8,95, ,243,697
2,1,6,0,0,0,63,476,342,6,-1,,482,405
3,1,6,1,0,0,63,476,342,6,-1,,482,405
4,1,6,1,1,0,63,476,342,6,-1,,482,405
5,1,6,1,1,1,63,476,342,6,95, ,482,405
2,1,7,0,0,0,715,518,910,13,-1,,531,1625
3,1,7,1,0,0,715,518,910,13,-1,,531,1625
4,1,7,1,1,0,715,518,910,13,-1,,531,1625
5,1,7,1,1,1,715,518,910,13,95, ,531,1625
2,1,8,0,0,0,1002,520,623,11,-1,,531,1625
3,1,8,1,0,0,1002,520,623,11,-1,,531,1625
4,1,8,1,1,0,1002,520,623,11,-1,,531,1625
5,1,8,1,1,1,1002,520,623,11,95, ,531,1625
2,1,9,0,0,0,1145,675,306,7,-1,,682,1451
3,1,9,1,0,0,1145,675,306,7,-1,,682,1451
4,1,9,1,1,0,1145,675,306,7,-1,,682,1451
5,1,9,1,1,1,1145,675,306,7,95, ,682,1451
2,1,10,0,0,0,619,674,74,3,-1,,677,693
3,1,10,1,0,0,619,674,74,3,-1,,677,693
4,1,10,1,1,0,619,674,74,3,-1,,677,693
5,1,10,1,1,1,619,674,74,3,95, ,677,693
2,1,11,0,0,0,906,673,545,10,-1,,683,1451
3,1,11,1,0,0,906,673,545,10,-1,,683,1451
4,1,11,1,1,0,906,673,545,10,-1,,683,1451
5,1,11,1,1,1,906,673,545,10,95, ,683,1451
2,1,12,0,0,0,522,740,845,13,-1,,753,1367
3,1,12,1,0,0,522,740,845,13,-1,,753,1367
4,1,12,1,1,0,522,740,845,13,-1,,753,1367
5,1,12,1,1,1,522,740,845,13,95, ,753,1367
2,1,13,0,0,0,67,741,318,4,-1,,745,385
3,1,13,1,0,0,67,741,318,4,-1,,745,385
4,1,13,1,1,0,67,741,318,4,-1,,745,385
5,1,13,1,1,1,67,741,318,4,95, ,745,385
2,1,14,0,0,0,941,685,10,534,-1,,1219,951
3,1,14,1,0,0,941,685,10,534,-1,,1219,951
4,1,14,1,1,0,941,685,10,534,-1,,1219,951
5,1,14,1,1,1,941,685,10,534,95, ,1219,951
2,1,15,0,0,0,57,568,8,717,-1,,1285,65
3,1,15,1,0,0,57,568,8,717,-1,,1285,65
4,1,15,1,1,0,57,568,8,717,-1,,1285,65
5,1,15,1,1,1,57,568,8,717,95, ,1285,65
2,1,16,0,0,0,1275,677,11,666,-1,,1343,1286
3,1,16,1,0,0,1275,677,11,666,-1,,1343,1286
4,1,16,1,1,0,1275,677,11,666,-1,,1343,1286
5,1,16,1,1,1,1275,677,11,666,95, ,1343,1286
2,1,17,0,0,0,244,514,19,1172,-1,,1686,263
3,1,17,1,0,0,244,514,19,1172,-1,,1686,263
4,1,17,1,1,0,244,514,19,1172,-1,,1686,263
5,1,17,1,1,1,244,514,19,1172,95, ,1686,263
2,1,18,0,0,0,1411,678,16,1014,-1,,1692,1427
3,1,18,1,0,0,1411,678,16,1014,-1,,1692,1427
4,1,18,1,1,0,1411,678,16,1014,-1,,1692,1427
5,1,18,1,1,1,1411,678,16,1014,95, ,1692,1427
2,1,19,0,0,0,1119,677,15,1011,-1,,1688,1134
3,1,19,1,0,0,1119,677,15,1011,-1,,1688,1134
4,1,19,1,1,0,1119,677,15,1011,-1,,1688,1134
5,1,19,1,1,1,1119,677,15,1011,95, ,1688,1134
2,1,20,0,0,0,810,1685,498,7,-1,,1692,1308
3,1,20,1,0,0,810,1685,498,7,-1,,1692,1308
4,1,20,1,1,0,810,1685,498,7,-1,,1692,1308
5,1,20,1,1,1,810,1685,498,7,95, ,1692,1308
2,1,21,0,0,0,533,1682,775,12,-1,,1694,1308
3,1,21,1,0,0,533,1682,775,12,-1,,1694,1308
4,1,21,1,1,0,533,1682,775,12,-1,,1694,1308
5,1,21,1,1,1,533,1682,775,12,95, ,1694,1308
2,1,22,0,0,0,61,1681,324,6,-1,,1687,385
3,1,22,1,0,0,61,1681,324,6,-1,,1687,385
4,1,22,1,1,0,61,1681,324,6,-1,,1687,385
5,1,22,1,1,1,61,1681,324,6,95, ,1687,385
2,1,23,0,0,0,50,1689,933,292,-1,,1981,983
3,1,23,1,0,0,50,1689,933,292,-1,,1981,983
4,1,23,1,1,0,934,1689,49,40,-1,,1729,983
5,1,23,1,1,1,934,1689,49,40,95, ,1729,983
4,1,23,1,2,0,837,1733,88,60,-1,,1793,925
5,1,23,1,2,1,837,1733,88,60,95,    ,1793,925
4,1,23,1,3,0,564,1793,344,17,-1,,1810,908
5,1,23,1,3,1,564,1793,344,17,95, ,1810,908
4,1,23,1,4,0,564,1810,338,21,-1,,1831,902
5,1,23,1,4,1,564,1810,338,21,95, ,1831,902
4,1,23,1,5,0,564,1831,314,21,-1,,1852,878
5,1,23,1,5,1,564,1831,314,21,95, ,1852,878
4,1,23,1,6,0,564,1852,361,15,-1,,1867,925
5,1,23,1,6,1,564,1852,361,15,95, ,1867,925
4,1,23,1,7,0,52,1867,873,10,-1,,1877,925
5,1,23,1,7,1,52,1867,873,10,95, ,1877,925
4,1,23,1,8,0,51,1877,89,40,-1,,1917,140
5,1,23,1,8,1,51,1877,89,40,95,    ,1917,140
4,1,23,1,9,0,51,1917,13,22,-1,,1939,64
5,1,23,1,9,1,51,1917,13,22,95,     ,1939,64
4,1,23,1,10,0,51,1939,14,17,-1,,1956,65
5,1,23,1,10,1,51,1939,14,17,95,      ,1956,65
4,1,23,1,11,0,50,1956,559,25,-1,,1981,609
5,1,23,1,11,1,50,1956,559,25,95,  ,1981,609
2,1,24,0,0,0,969,1741,652,9,-1,,1750,1621
3,1,24,1,0,0,969,1741,652,9,-1,,1750,1621
4,1,24,1,1,0,969,1741,652,9,-1,,1750,1621
5,1,24,1,1,1,969,1741,652,9,95, ,1750,1621
2,1,25,0,0,0,288,1799,75,3,-1,,1802,363
3,1,25,1,0,0,288,1799,75,3,-1,,1802,363
4,1,25,1,1,0,288,1799,75,3,-1,,1802,363
5,1,25,1,1,1,288,1799,75,3,95, ,1802,363
2,1,26,0,0,0,1493,678,18,1142,-1,,1820,1511
3,1,26,1,0,0,1493,678,18,1142,-1,,1820,1511
4,1,26,1,1,0,1493,678,18,1142,-1,,1820,1511
5,1,26,1,1,1,1493,678,18,1142,95, ,1820,1511
2,1,27,0,0,0,1019,1793,238,112,-1,,1905,1257
3,1,27,1,0,0,1019,1793,238,112,-1,,1905,1257
4,1,27,1,1,0,1233,1793,24,32,-1,,1825,1257
5,1,27,1,1,1,1233,1793,24,32,95, ,1825,1257
4,1,27,1,2,0,1233,1825,24,31,-1,,1856,1257
5,1,27,1,2,1,1233,1825,24,31,95,  ,1856,1257
4,1,27,1,3,0,1019,1856,238,49,-1,,1905,1257
5,1,27,1,3,1,1019,1856,238,49,95,   ,1905,1257
2,1,28,0,0,0,608,1821,853,14,-1,,1835,1461
3,1,28,1,0,0,608,1821,853,14,-1,,1835,1461
4,1,28,1,1,0,608,1821,853,14,-1,,1835,1461
5,1,28,1,1,1,608,1821,853,14,95, ,1835,1461
2,1,29,0,0,0,57,118,1579,1790,-1,,1908,1636
3,1,29,1,0,0,56,118,1576,1790,-1,,1908,1632
4,1,29,1,1,0,147,118,1481,28,-1,,146,1628
5,1,29,1,1,1,147,121,74,21,96,Page:,142,221
5,1,29,1,1,2,246,120,12,18,95,1,138,258
5,1,29,1,1,3,375,121,148,25,0,530,146,523
5,1,29,1,1,4,815,118,131,22,96,RAPPORT,140,946
5,1,29,1,1,5,957,119,34,21,92,DE,140,991
5,1,29,1,1,6,1002,119,212,27,90,CHARGEMENT,146,1214
5,1,29,1,1,7,1199,114,16,37,92,-,151,1215
5,1,29,1,1,8,1224,120,136,22,91,VEHICULE,142,1360
5,1,29,1,1,9,1371,132,7,2,93,-,134,1378
5,1,29,1,1,10,1388,120,240,22,78,CONNAISSEMENT,142,1628
4,1,29,1,2,0,64,140,607,42,-1,,182,671
5,1,29,1,2,1,64,140,10,17,32,[,157,74
5,1,29,1,2,2,135,141,113,45,56,DOCUMENT,186,248
5,1,29,1,2,3,254,150,79,32,56,NUMBER,182,333
5,1,29,1,2,4,362,150,61,18,84,6966,168,423
5,1,29,1,2,5,478,152,1,4,66,|,156,479
5,1,29,1,2,6,517,141,56,45,45,pie,186,573
5,1,29,1,2,7,577,141,94,45,1,neutesition,186,671
4,1,29,1,3,0,522,175,1088,37,-1,,212,1610
5,1,29,1,3,1,522,175,137,37,94,mm/dd/yy,212,659
5,1,29,1,3,2,799,183,30,20,94,24,203,829
5,1,29,1,3,3,839,183,78,21,94,HOUR,204,917
5,1,29,1,3,4,928,183,118,22,89,NUMBER,205,1046
5,1,29,1,3,5,1067,182,206,20,88,(613)996-6666,202,1273
5,1,29,1,3,6,1311,184,137,22,88,-NUMERO,206,1448
5,1,29,1,3,7,1459,185,29,20,96,24,205,1488
5,1,29,1,3,8,1498,185,112,22,96,HEURES,207,1610
4,1,29,1,4,0,148,194,1224,45,-1,,239,1372
5,1,29,1,4,1,148,208,108,19,95,0362697,227,256
5,1,29,1,4,2,279,209,94,20,95,10/007,229,373
5,1,29,1,4,3,465,194,15,45,94,|,239,480
5,1,29,1,4,4,528,210,128,20,96,10/08/24,230,656
5,1,29,1,4,5,1049,214,232,22,88,COLLECT,236,1281
5,1,29,1,4,6,1179,210,15,35,88,-,245,1194
5,1,29,1,4,7,1208,214,71,22,91,FRAIS,236,1279
5,1,29,1,4,8,1292,215,80,21,90,VIRES,236,1372
4,1,29,1,5,0,70,235,1566,37,-1,,272,1636
5,1,29,1,5,1,70,235,203,18,44,âCONSIGNEE/CUSTOMER,253,273
5,1,29,1,5,2,279,248,4,2,89,-,250,283
5,1,29,1,5,3,290,241,182,14,56,DESTINATAIRE/CLIENT,255,472
5,1,29,1,5,4,687,247,28,17,19,ROB,264,715
5,1,29,1,5,5,725,245,29,19,0,ena,264,754
5,1,29,1,5,6,758,239,78,26,0,UegeueNT,265,836
5,1,29,1,5,7,847,235,12,34,92,|,269,859
5,1,29,1,5,8,862,240,101,17,91,CONSIGNOR,257,963
5,1,29,1,5,9,970,251,4,2,91,-,253,974
5,1,29,1,5,10,980,244,106,13,40,EXPEDITEUR,257,1086
5,1,29,1,5,11,1307,241,5,2,43,7,243,1312
5,1,29,1,5,12,1465,237,139,35,19,TEN,272,1604
5,1,29,1,5,13,1618,237,18,35,45,||,272,1636
4,1,29,1,6,0,147,269,1442,23,-1,,292,1589
5,1,29,1,6,1,147,270,79,18,91,PETRO,288,226
5,1,29,1,6,2,244,271,99,17,96,CANADA,288,343
5,1,29,1,6,3,360,271,164,19,96,LUBRICANTS,290,524
5,1,29,1,6,4,544,272,46,18,96,INC,290,590
5,1,29,1,6,5,678,271,161,19,77,0005064508,290,839
5,1,29,1,6,6,861,273,97,18,77,|SUNCOR,291,958
5,1,29,1,6,7,977,274,98,18,96,ENERGY,292,1075
5,1,29,1,6,8,1093,274,131,18,96,MONTREAL,292,1224
5,1,29,1,6,9,1449,269,1,11,84,|,280,1450
5,1,29,1,6,10,1478,274,111,18,93,0082041,292,1589
4,1,29,1,7,0,147,299,1474,23,-1,,322,1621
5,1,29,1,7,1,147,301,61,17,91,PCLI,318,208
5,1,29,1,7,2,229,309,11,2,91,-,311,240
5,1,29,1,7,3,260,301,97,21,96,QUEBEC,322,357
5,1,29,1,7,4,378,301,44,18,96,302,319,422
5,1,29,1,7,5,672,299,166,21,74,0009406423,320,838
5,1,29,1,7,6,857,300,82,21,83,11675,321,939
5,1,29,1,7,7,960,308,48,14,95,rue,322,1008
5,1,29,1,7,8,1028,303,162,19,95,Sherbrooke,322,1190
5,1,29,1,7,9,1210,305,46,17,96,est,322,1256
5,1,29,1,7,10,1460,302,161,2,18,a,304,1621
4,1,29,1,8,0,147,330,1342,26,-1,,356,1489
5,1,29,1,8,1,147,330,44,18,96,385,348,191
5,1,29,1,8,2,213,331,145,18,96,SOUTHDOWN,349,358
5,1,29,1,8,3,376,333,64,17,96,ROAD,350,440
5,1,29,1,8,4,851,333,150,21,69,"|Montreal,",354,1001
5,1,29,1,8,5,1027,335,30,21,87,QC,356,1057
5,1,29,1,8,6,1076,335,48,17,87,H1B,352,1124
5,1,29,1,8,7,1145,335,43,17,84,1C3,352,1188
5,1,29,1,8,8,1282,335,69,20,22,(613),355,1351
5,1,29,1,8,9,1363,335,126,18,22,996-6666,353,1489
4,1,29,1,9,0,143,361,378,21,-1,,382,521
5,1,29,1,9,1,143,361,191,21,96,"MISSISSAUGA,",382,334
5,1,29,1,9,2,360,362,31,18,91,ON,380,391
5,1,29,1,9,3,410,361,48,19,88,L5J,380,458
5,1,29,1,9,4,477,361,44,19,30,2Â¥3,380,521
4,1,29,1,10,0,269,387,838,27,-1,,414,1107
5,1,29,1,10,1,269,411,293,3,26,HY,414,562
5,1,29,1,10,2,630,412,32,2,52,_,414,662
5,1,29,1,10,3,672,387,303,27,55,Yannick,414,975
5,1,29,1,10,4,991,393,116,19,94,Mercier,412,1107
4,1,29,1,11,0,269,413,576,17,-1,,430,845
5,1,29,1,11,1,269,417,2,3,95,|,420,271
5,1,29,1,11,2,276,413,62,11,93,RELEASE,424,338
5,1,29,1,11,3,344,414,48,14,72,(C-of-A),428,392
5,1,29,1,11,4,397,414,59,12,95,NUMBER,426,456
5,1,29,1,11,5,560,419,1,11,81,|,430,561
5,1,29,1,11,6,567,415,78,11,95,CUSTOMER,426,645
5,1,29,1,11,7,651,415,76,11,96,PURCHASE,426,727
5,1,29,1,11,8,731,415,49,11,96,ORDER,426,780
5,1,29,1,11,9,786,416,59,11,48,NUMBER:,427,845
4,1,29,1,12,0,617,429,190,11,-1,,440,807
5,1,29,1,12,1,617,429,16,11,96,No,440,633
5,1,29,1,12,2,639,429,17,11,96,DE,440,656
5,1,29,1,12,3,662,429,68,11,96,DEMANDE,440,730
5,1,29,1,12,4,736,429,17,11,96,DU,440,753
5,1,29,1,12,5,759,429,48,11,95,CLIENT,440,807
4,1,29,1,13,0,75,478,737,24,-1,,502,812
5,1,29,1,13,1,75,478,73,23,93,CARRIER,501,148
5,1,29,1,13,2,155,496,4,2,91,-,498,159
5,1,29,1,13,3,164,479,136,23,87,TRANSPORTEUR,502,300
5,1,29,1,13,4,362,479,12,1,25,7,480,374
5,1,29,1,13,5,758,482,21,1,0,a,483,779
4,1,29,1,14,0,145,513,1269,33,-1,,546,1414
5,1,29,1,14,1,145,513,47,18,95,GEO,531,192
5,1,29,1,14,2,209,514,17,16,94,A,530,226
5,1,29,1,14,3,242,514,65,17,96,HALL,531,307
5,1,29,1,14,4,577,514,111,19,95,0101535,533,688
5,1,29,1,14,5,705,510,19,44,0,|,554,724
5,1,29,1,14,6,733,523,152,21,0,VenicleNUMBER,544,885
5,1,29,1,14,7,909,523,160,22,11, LICENSENUMBER,545,1069
5,1,29,1,14,8,1101,526,1,10,51,|,536,1102
5,1,29,1,14,9,1131,532,78,13,77,ADDRESS,545,1209
5,1,29,1,14,10,1216,532,21,13,96,OF,545,1237
5,1,29,1,14,11,1244,532,56,13,96,METER,545,1300
5,1,29,1,14,12,1306,532,34,13,94,AND,545,1340
5,1,29,1,14,13,1346,532,68,14,94,TRADER,546,1414
4,1,29,1,15,0,147,542,1331,26,-1,,568,1478
5,1,29,1,15,1,147,542,60,19,91,8800,561,207
5,1,29,1,15,2,228,552,11,2,91,-,554,239
5,1,29,1,15,3,261,543,29,18,40,6&,561,290
5,1,29,1,15,4,309,544,147,18,92,CROISSANT,562,456
5,1,29,1,15,5,736,552,137,14,72,NoDUVEHICULE,566,873
5,1,29,1,15,6,897,544,17,33,31,=,577,914
5,1,29,1,15,7,922,554,72,13,36,NOMBRE,567,994
5,1,29,1,15,8,1000,554,22,13,36,DE,567,1022
5,1,29,1,15,9,1029,554,62,13,51,PERMIS,567,1091
5,1,29,1,15,10,1118,554,89,14,62, L'ADRESSE,568,1207
5,1,29,1,15,11,1214,554,21,14,96,DE,568,1235
5,1,29,1,15,12,1242,554,56,14,96,METRE,568,1298
5,1,29,1,15,13,1305,555,19,13,96,ET,568,1324
5,1,29,1,15,14,1331,555,21,13,91,OE,568,1352
5,1,29,1,15,15,1358,555,120,13,54,COMMEACANT,568,1478
4,1,29,1,16,0,143,569,1362,33,-1,,602,1505
5,1,29,1,16,1,143,569,81,33,96,ANJOU,602,224
5,1,29,1,16,2,726,576,61,19,69,1139,595,787
5,1,29,1,16,3,1111,578,76,18,96,11675,596,1187
5,1,29,1,16,4,1208,583,48,13,96,rue,596,1256
5,1,29,1,16,5,1276,578,164,19,96,Sherbrooke,597,1440
5,1,29,1,16,6,1459,581,46,16,96,est,597,1505
4,1,29,1,17,0,143,597,1294,37,-1,,634,1437
5,1,29,1,17,1,143,604,49,19,22,H1d,623,192
5,1,29,1,17,2,211,604,44,18,87,1Ai,622,255
5,1,29,1,17,3,476,601,1,21,82,|,622,477
5,1,29,1,17,4,490,597,62,37,65,GARRIER,634,552
5,1,29,1,17,5,561,597,100,37,17,CERTIFIOATION,634,661
5,1,29,1,17,6,726,607,61,18,95,1085,625,787
5,1,29,1,17,7,1107,608,143,22,95,"Montreal,",630,1250
5,1,29,1,17,8,1275,610,30,20,89,QC,630,1305
5,1,29,1,17,9,1324,609,49,18,85,H1B,627,1373
5,1,29,1,17,10,1393,610,44,18,63,1C3,628,1437
4,1,29,1,18,0,151,632,1170,27,-1,,659,1321
5,1,29,1,18,1,151,634,66,21,11,(514),655,217
5,1,29,1,18,2,227,635,128,19,11,352-5550,654,355
5,1,29,1,18,3,476,632,1,22,88,|,654,477
5,1,29,1,18,4,1115,639,67,20,91,(613),659,1182
5,1,29,1,18,5,1196,639,125,19,91,996-6666,658,1321
4,1,29,1,19,0,63,664,1565,16,-1,,680,1628
5,1,29,1,19,1,63,672,129,2,0,âââoee,674,192
5,1,29,1,19,2,246,674,9,1,25,a,675,255
5,1,29,1,19,3,256,674,202,1,20,Ree,675,458
5,1,29,1,19,4,540,675,75,1,21,ââ,676,615
5,1,29,1,19,5,710,664,4,13,0,[,677,714
5,1,29,1,19,6,853,676,96,2,16,a,678,949
5,1,29,1,19,7,1047,677,4,1,3,-,678,1051
5,1,29,1,19,8,1455,678,54,1,0,a,679,1509
5,1,29,1,19,9,1589,679,39,1,79,__|,680,1628
4,1,29,1,20,0,1160,687,93,14,-1,,701,1253
5,1,29,1,20,1,1160,687,93,14,96,MEASURED,701,1253
4,1,29,1,21,0,75,693,1519,20,-1,,713,1594
5,1,29,1,21,1,75,693,141,14,89,PRODUCT/METER,707,216
5,1,29,1,21,2,1304,699,105,13,95,CORRECTED,712,1409
5,1,29,1,21,3,1418,689,12,33,95,|,722,1430
5,1,29,1,21,4,1438,699,45,13,95,TEMP,712,1483
5,1,29,1,21,5,1495,689,12,33,91,|,722,1507
5,1,29,1,21,6,1525,700,69,13,91,DENSITY,713,1594
4,1,29,1,22,0,571,707,711,13,-1,,720,1282
5,1,29,1,22,1,571,717,4,2,15,.,719,575
5,1,29,1,22,2,1174,707,108,13,54,LITRES,720,1282
4,1,29,1,23,0,75,709,1547,45,-1,,754,1622
5,1,29,1,23,1,75,721,135,22,47,PACDUITIMETER,743,210
5,1,29,1,23,2,229,742,5,1,3,;,743,234
5,1,29,1,23,3,366,709,82,36,66,PRODUCT,745,448
5,1,29,1,23,4,453,709,111,13,93,DESCRIPTION,722,564
5,1,29,1,23,5,567,705,12,25,91,-,730,579
5,1,29,1,23,6,582,710,111,13,82,DESCRIPTION,723,693
5,1,29,1,23,7,700,711,25,35,50,pu,746,725
5,1,29,1,23,8,730,711,73,12,87,PRODUIT,723,803
5,1,29,1,23,9,1160,725,92,14,91,MESUREES,739,1252
5,1,29,1,23,10,1330,726,22,13,91,To,739,1352
5,1,29,1,23,11,1359,726,32,22,60,isc,748,1391
5,1,29,1,23,12,1427,710,69,43,33,ceLsius,753,1496
5,1,29,1,23,13,1525,711,69,43,53,DENSITE,754,1594
5,1,29,1,23,14,1599,748,23,2,0,_,750,1622
4,1,29,1,24,0,145,755,1441,25,-1,,780,1586
5,1,29,1,24,1,145,755,92,18,95,103265,773,237
5,1,29,1,24,2,253,751,15,33,95,|,784,268
5,1,29,1,24,3,274,757,48,18,96,NOT,775,322
5,1,29,1,24,4,341,757,147,18,96,REGULATED,775,488
5,1,29,1,24,5,507,759,81,16,96,UNDER,775,588
5,1,29,1,24,6,607,759,48,17,96,TDG,776,655
5,1,29,1,24,7,976,759,95,19,95,0.9644,778,1071
5,1,29,1,24,8,1175,760,78,19,96,43999,779,1253
5,1,29,1,24,9,1325,760,77,19,94,42433,779,1402
5,1,29,1,24,10,1426,761,61,18,65,61.4,779,1487
5,1,29,1,24,11,1509,761,77,19,64,910.6,780,1586
4,1,29,1,25,0,142,786,947,23,-1,,809,1089
5,1,29,1,25,1,142,786,96,18,88,MTR271,804,238
5,1,29,1,25,2,252,782,14,32,94,|,814,266
5,1,29,1,25,3,274,788,82,17,95,HEAVY,805,356
5,1,29,1,25,4,373,788,101,17,93,VACUUM,805,474
5,1,29,1,25,5,490,788,98,18,88,GASOIL,806,588
5,1,29,1,25,6,597,788,85,21,85,(HVGO),809,682
5,1,29,1,25,7,972,791,49,16,87,API,807,1021
5,1,29,1,25,8,1043,790,46,17,76,54B,807,1089
4,1,29,1,26,0,456,890,346,75,-1,,965,802
5,1,29,1,26,1,456,920,85,43,92,at.,963,541
5,1,29,1,26,2,615,932,37,10,0,>,942,652
5,1,29,1,26,3,679,925,70,32,10,Le,957,749
5,1,29,1,26,4,754,890,48,70,66,J,960,802
4,1,29,1,27,0,418,970,381,73,-1,,1043,799
5,1,29,1,27,1,418,981,70,60,75,Rac,1041,488
5,1,29,1,27,2,503,981,36,60,66,ke,1041,539
5,1,29,1,27,3,551,985,71,45,52,#93,1030,622
5,1,29,1,27,4,652,970,142,73,21,itor,1043,794
5,1,29,1,27,5,794,1011,5,5,10,.,1016,799
4,1,29,1,28,0,1625,1042,2,8,-1,,1050,1627
5,1,29,1,28,1,1625,1042,2,8,96,|,1050,1627
4,1,29,1,29,0,497,1069,4,8,-1,,1077,501
5,1,29,1,29,1,497,1069,4,8,34,â,1077,501
4,1,29,1,30,0,414,1055,866,57,-1,,1112,1280
5,1,29,1,30,1,414,1069,107,43,67,Siahe,1112,521
5,1,29,1,30,2,648,1055,117,43,36,10:5,1098,765
5,1,29,1,30,3,1278,1093,2,5,72,|,1098,1280
4,1,29,1,31,0,563,1128,11,11,-1,,1139,574
5,1,29,1,31,1,563,1128,11,11,58,=,1139,574
4,1,29,1,32,0,370,1128,366,61,-1,,1189,736
5,1,29,1,32,1,370,1128,129,61,0,tal,1189,499
5,1,29,1,32,2,519,1133,79,37,45,Fl,1170,598
5,1,29,1,32,3,634,1138,102,35,67,18:20,1173,736
4,1,29,1,33,0,390,1184,368,62,-1,,1246,758
5,1,29,1,33,1,390,1204,107,42,55,"Trike,",1246,497
5,1,29,1,33,2,526,1184,78,52,46,"abl,",1236,604
5,1,29,1,33,3,632,1199,126,36,43,(2:95,1235,758
4,1,29,1,34,0,305,1488,973,24,-1,,1512,1278
5,1,29,1,34,1,305,1488,80,19,96,Total,1507,385
5,1,29,1,34,2,405,1488,96,20,95,Litres,1508,501
5,1,29,1,34,3,520,1489,33,23,96,by,1512,553
5,1,29,1,34,4,572,1489,113,19,96,Product,1508,685
5,1,29,1,34,5,1277,1509,1,3,95,|,1512,1278
4,1,29,1,35,0,274,1519,1126,24,-1,,1543,1400
5,1,29,1,35,1,274,1519,94,19,96,103265,1538,368
5,1,29,1,35,2,470,1521,83,17,96,HEAVY,1538,553
5,1,29,1,35,3,570,1521,101,19,93,VACUUM,1540,671
5,1,29,1,35,4,688,1522,93,18,84,GASOIL,1540,781
5,1,29,1,35,5,794,1521,85,22,84,(HVGO),1543,879
5,1,29,1,35,6,1173,1523,77,19,96,43999,1542,1250
5,1,29,1,35,7,1322,1523,78,19,92,42433,1542,1400
4,1,29,1,36,0,943,1559,1,12,-1,,1571,944
5,1,29,1,36,1,943,1559,1,12,73,|,1571,944
4,1,29,1,37,0,57,1680,1440,44,-1,,1724,1497
5,1,29,1,37,1,57,1680,2,34,83,|,1714,59
5,1,29,1,37,2,71,1697,1,13,96,|,1710,72
5,1,29,1,37,3,80,1697,49,17,93,hereby,1714,129
5,1,29,1,37,4,134,1698,54,13,88,dectare,1711,188
5,1,29,1,37,5,194,1698,26,13,96,that,1711,220
5,1,29,1,37,6,226,1698,22,13,96,the,1711,248
5,1,29,1,37,7,254,1700,61,11,96,contents,1711,315
5,1,29,1,37,8,320,1699,14,13,96,of,1712,334
5,1,29,1,37,9,339,1699,25,13,95,this,1712,364
5,1,29,1,37,10,370,1681,93,38,93,consignment,1719,463
5,1,29,1,37,11,468,1702,23,10,94,are,1712,491
5,1,29,1,37,12,493,1682,32,38,63,fully,1720,525
5,1,29,1,37,13,531,1700,26,13,96,and,1713,557
5,1,29,1,37,14,563,1701,75,15,96,accurately,1716,638
5,1,29,1,37,15,644,1700,71,13,96,described,1713,715
5,1,29,1,37,16,721,1701,44,13,89,above,1714,765
5,1,29,1,37,17,769,1688,18,29,95,by,1717,787
5,1,29,1,37,18,793,1688,22,26,94,the,1714,815
5,1,29,1,37,19,820,1704,48,13,95,proper,1717,868
5,1,29,1,37,20,874,1702,60,16,95,shipping,1718,934
5,1,29,1,37,21,1323,1690,20,1,0,-,1691,1343
5,1,29,1,37,22,1451,1687,46,37,0,â_,1724,1497
4,1,29,1,38,0,57,1715,879,23,-1,,1738,936
5,1,29,1,38,1,57,1715,1,15,93,|,1730,58
5,1,29,1,38,2,70,1720,44,12,93,"name,",1732,114
5,1,29,1,38,3,120,1720,23,10,96,are,1730,143
5,1,29,1,38,4,150,1718,58,16,96,properly,1734,208
5,1,29,1,38,5,214,1718,67,13,29,classified,1731,281
5,1,29,1,38,6,287,1718,26,14,97,and,1732,313
5,1,29,1,38,7,318,1718,75,17,84,packaged.,1735,393
5,1,29,1,38,8,400,1718,35,14,96,have,1732,435
5,1,29,1,38,9,440,1718,77,18,96,dangerous,1736,517
5,1,29,1,38,10,524,1720,43,16,96,goods,1736,567
5,1,29,1,38,11,574,1720,43,16,95,safety,1736,617
5,1,29,1,38,12,623,1720,44,13,96,marks,1733,667
5,1,29,1,38,13,672,1720,59,17,73,properly,1737,731
5,1,29,1,38,14,738,1720,47,14,96,affixed,1734,785
5,1,29,1,38,15,791,1724,14,10,87,or,1734,805
5,1,29,1,38,16,810,1720,70,18,96,displayed,1738,880
5,1,29,1,38,17,886,1724,17,10,96,on,1734,903
5,1,29,1,38,18,909,1722,27,12,50,thee,1734,936
4,1,29,1,39,0,57,1737,1525,26,-1,,1763,1582
5,1,29,1,39,1,57,1742,1,15,73,|,1757,58
5,1,29,1,39,2,70,1737,26,13,73,and,1750,96
5,1,29,1,39,3,102,1740,23,10,96,are,1750,125
5,1,29,1,39,4,131,1738,11,12,96,in,1750,142
5,1,29,1,39,5,148,1737,15,13,96,all,1750,163
5,1,29,1,39,6,170,1739,61,15,96,respects,1754,231
5,1,29,1,39,7,237,1738,11,12,96,in,1750,248
5,1,29,1,39,8,254,1741,47,13,94,proper,1754,301
5,1,29,1,39,9,307,1738,64,13,96,condition,1751,371
5,1,29,1,39,10,378,1739,19,13,96,for,1752,397
5,1,29,1,39,11,402,1739,65,16,96,transport,1755,467
5,1,29,1,39,12,472,1739,70,17,91,according,1756,542
5,1,29,1,39,13,549,1741,12,11,81,to,1752,561
5,1,29,1,39,14,567,1740,22,12,95,the,1752,589
5,1,29,1,39,15,594,1739,107,17,69,Transportation,1756,701
5,1,29,1,39,16,706,1740,13,13,96,of,1753,719
5,1,29,1,39,17,726,1740,79,16,96,Dangerous,1756,805
5,1,29,1,39,18,811,1740,48,14,96,Goods,1754,859
5,1,29,1,39,19,866,1741,46,16,38,Regu,1757,912
5,1,29,1,39,20,990,1744,49,16,11,TiIMEIN,1760,1039
5,1,29,1,39,21,1120,1745,8,1,29,~,1746,1128
5,1,29,1,39,22,1131,1745,46,15,29,START,1760,1177
5,1,29,1,39,23,1182,1749,59,12,96,LOADING,1761,1241
5,1,29,1,39,24,1297,1746,70,16,55,FINISH,1762,1367
5,1,29,1,39,25,1373,1750,60,12,93,LOADING,1762,1433
5,1,29,1,39,26,1499,1749,1,14,75,|,1763,1500
5,1,29,1,39,27,1517,1751,32,11,60,TIME,1762,1549
5,1,29,1,39,28,1554,1751,28,11,95,OUT,1762,1582
4,1,29,1,40,0,139,1763,1439,20,-1,,1783,1578
5,1,29,1,40,1,139,1763,115,19,96,Yannick,1782,254
5,1,29,1,40,2,270,1763,115,20,96,Mercier,1783,385
5,1,29,1,40,3,990,1763,60,11,39,ARQIVEE,1774,1050
5,1,29,1,40,4,1101,1763,70,11,92,DEBUT,1774,1171
5,1,29,1,40,5,1154,1759,18,23,88,DU,1782,1172
5,1,29,1,40,6,1176,1763,97,11,80,CHARGEMENT,1774,1273
5,1,29,1,40,7,1312,1764,21,11,93,FIN,1775,1333
5,1,29,1,40,8,1342,1764,15,11,86,OU,1775,1357
5,1,29,1,40,9,1365,1764,95,12,86,CHARGEMENT,1776,1460
5,1,29,1,40,10,1523,1765,55,11,90,DEPART,1776,1578
4,1,29,1,41,0,57,1777,1525,54,-1,,1831,1582
5,1,29,1,41,1,57,1795,1,10,76,|,1805,58
5,1,29,1,41,2,153,1798,202,22,52,Shipper,1820,355
5,1,29,1,41,3,217,1791,34,33,95,name,1824,251
5,1,29,1,41,4,259,1798,53,22,95,(please,1820,312
5,1,29,1,41,5,319,1791,42,33,52,print),1824,361
5,1,29,1,41,6,973,1797,77,18,0,O6Â¥:10,1815,1050
5,1,29,1,41,7,1081,1777,2,51,64,|,1828,1083
5,1,29,1,41,8,1139,1798,79,18,94,05:18,1816,1218
5,1,29,1,41,9,1339,1799,77,18,95,05:42,1817,1416
5,1,29,1,41,10,1498,1799,84,32,40,[05:42,1831,1582
4,1,29,1,42,0,57,1822,1509,25,-1,,1847,1566
5,1,29,1,42,1,57,1822,74,19,72,DRIVER,1841,131
5,1,29,1,42,2,138,1824,363,18,0,NAME-NOMDUGONDUGTEURâSâ=~S~S*,1842,501
5,1,29,1,42,3,908,1835,5,4,26,Bt,1839,913
5,1,29,1,42,4,937,1822,14,33,42,A,1855,951
5,1,29,1,42,5,985,1832,55,13,42,QRATURE,1845,1040
5,1,29,1,42,6,1047,1832,21,13,91,DU,1845,1068
5,1,29,1,42,7,1075,1832,117,14,80,CONDUCTEUR,1846,1192
5,1,29,1,42,8,1278,1825,52,31,96,TOTAL,1856,1330
5,1,29,1,42,9,1338,1829,79,18,93,QUANTITY,1847,1417
5,1,29,1,42,10,1426,1840,4,3,91,-,1843,1430
5,1,29,1,42,11,1436,1829,60,18,93,"QUANT,",1847,1496
5,1,29,1,42,12,1503,1834,63,13,92,TOTALE,1847,1566
4,1,29,1,43,0,1322,1859,211,19,-1,,1878,1533
5,1,29,1,43,1,1322,1859,77,19,80,43999,1878,1399
5,1,29,1,43,2,1436,1859,97,19,80,Litres,1878,1533
4,1,29,1,44,0,140,1886,1274,22,-1,,1908,1414
5,1,29,1,44,1,140,1886,81,18,78,SIMON,1904,221
5,1,29,1,44,2,272,1887,81,17,90,JOBIN,1904,353
5,1,29,1,44,3,1288,1890,78,18,57,38639,1908,1366
5,1,29,1,44,4,1387,1890,27,18,57,kg,1908,1414
2,1,30,0,0,0,1615,146,26,1764,-1,,1910,1641
3,1,30,1,0,0,1615,146,26,1764,-1,,1910,1641
4,1,30,1,1,0,1615,146,26,1764,-1,,1910,1641
5,1,30,1,1,1,1615,146,26,1764,95, ,1910,1641
2,1,31,0,0,0,1414,1887,216,28,-1,,1915,1630
3,1,31,1,0,0,1414,1887,216,28,-1,,1915,1630
4,1,31,1,1,0,1414,1887,216,28,-1,,1915,1630
5,1,31,1,1,1,1414,1887,216,25,95,  ,1912,1630
5,1,31,1,1,2,1598,1912,32,3,95,  ,1915,1630
2,1,32,0,0,0,353,1877,1277,59,-1,,1936,1630
3,1,32,1,0,0,353,1877,1277,59,-1,,1936,1630
4,1,32,1,1,0,564,1877,361,28,-1,,1905,925
5,1,32,1,1,1,564,1877,361,28,95, ,1905,925
4,1,32,1,2,0,353,1905,1277,31,-1,,1936,1630
5,1,32,1,2,1,353,1905,935,8,95,   ,1913,1288
5,1,32,1,2,2,1602,1915,28,21,95,     ,1936,1630
2,1,33,0,0,0,1482,1916,2,20,-1,,1936,1484
3,1,33,1,0,0,1482,1916,2,20,-1,,1936,1484
4,1,33,1,1,0,1482,1916,2,20,-1,,1936,1484
5,1,33,1,1,1,1482,1916,2,20,95,    ,1936,1484
2,1,34,0,0,0,221,1905,1067,73,-1,,1978,1288
3,1,34,1,0,0,221,1905,1067,73,-1,,1978,1288
4,1,34,1,1,0,221,1905,1067,34,-1,,1939,1288
5,1,34,1,1,1,221,1905,51,6,95, ,1911,272
5,1,34,1,1,2,694,1913,594,26,95,        ,1939,1288
4,1,34,1,2,0,693,1945,259,22,-1,,1967,952
5,1,34,1,2,1,693,1945,259,22,95,       ,1967,952
4,1,34,1,3,0,692,1967,262,11,-1,,1978,954
5,1,34,1,3,1,692,1967,262,11,95,  ,1978,954
2,1,35,0,0,0,463,1912,607,22,-1,,1934,1070
3,1,35,1,0,0,463,1912,607,22,-1,,1934,1070
4,1,35,1,1,0,463,1912,607,22,-1,,1934,1070
5,1,35,1,1,1,463,1912,19,22,95,   ,1934,482
5,1,35,1,1,2,593,1912,17,1,95, ,1913,610
5,1,35,1,1,3,1063,1916,7,18,95,  ,1934,1070
2,1,36,0,0,0,146,1913,464,21,-1,,1934,610
3,1,36,1,0,0,146,1913,464,21,-1,,1934,610
4,1,36,1,1,0,146,1913,464,21,-1,,1934,610
5,1,36,1,1,1,146,1913,26,21,95,  ,1934,172
5,1,36,1,1,2,593,1913,17,21,95,  ,1934,610
2,1,37,0,0,0,1070,1921,532,50,-1,,1971,1602
3,1,37,1,0,0,1070,1921,532,50,-1,,1971,1602
4,1,37,1,1,0,1070,1921,532,12,-1,,1933,1602
5,1,37,1,1,1,1070,1921,49,11,96,WATER,1932,1119
5,1,37,1,1,2,1125,1921,21,11,64,DIP),1932,1146
5,1,37,1,1,3,1157,1921,56,11,96,BEFORE,1932,1213
5,1,37,1,1,4,1219,1921,29,11,87,DIPS,1932,1248
5,1,37,1,1,5,1257,1913,10,28,89,|,1941,1267
5,1,37,1,1,6,1273,1921,56,11,73,BEFORE,1932,1329
5,1,37,1,1,7,1334,1921,50,11,73,INVENT,1932,1384
5,1,37,1,1,8,1388,1913,7,28,96,|,1941,1395
5,1,37,1,1,9,1400,1921,45,11,96,AFTER,1932,1445
5,1,37,1,1,10,1450,1921,31,11,26,DIPS),1932,1481
5,1,37,1,1,11,1496,1921,49,11,93,ENDING,1932,1545
5,1,37,1,1,12,1553,1922,49,11,93,INVENT,1933,1602
4,1,37,1,2,0,1167,1937,423,13,-1,,1950,1590
5,1,37,1,2,1,1167,1937,47,11,96,AVANT,1948,1214
5,1,37,1,2,2,1219,1937,14,11,96,LE,1948,1233
5,1,37,1,2,3,1287,1937,82,12,59,INVENTAIRE,1949,1369
5,1,37,1,2,4,1383,1931,15,28,58,=|,1959,1398
5,1,37,1,2,5,1406,1937,66,13,91,APRESLE,1950,1472
5,1,37,1,2,6,1481,1931,15,28,23,|,1959,1496
5,1,37,1,2,7,1509,1938,81,12,61,INVENTAIRE,1950,1590
4,1,37,1,3,0,1165,1953,403,18,-1,,1971,1568
5,1,37,1,3,1,1165,1953,74,12,71,JAUGEAGE,1965,1239
5,1,37,1,3,2,1292,1954,75,17,78,JAUGEAGE,1971,1367
5,1,37,1,3,3,1383,1947,15,28,53,|,1975,1398
5,1,37,1,3,4,1400,1955,75,11,19,JAUGEAGE.,1966,1475
5,1,37,1,3,5,1522,1955,46,11,55,APRES,1966,1568
2,1,38,0,0,0,953,1920,188,50,-1,,1970,1141
3,1,38,1,0,0,953,1920,188,50,-1,,1970,1141
4,1,38,1,1,0,953,1920,110,11,-1,,1931,1063
5,1,38,1,1,1,953,1920,36,11,91,TANK,1931,989
5,1,38,1,1,2,995,1920,68,11,87,CAPACITY|,1931,1063
4,1,38,1,2,0,957,1936,184,12,-1,,1948,1141
5,1,38,1,2,1,957,1936,96,12,74,CONTENANCE,1948,1053
5,1,38,1,2,2,1060,1929,10,28,95,|,1957,1070
5,1,38,1,2,3,1073,1937,68,11,95,MEASURE,1948,1141
4,1,38,1,3,0,954,1953,168,17,-1,,1970,1122
5,1,38,1,3,1,954,1953,104,17,90,DURESERVIOR,1970,1058
5,1,38,1,3,2,1063,1945,8,29,67,|,1974,1071
5,1,38,1,3,3,1085,1953,37,11,67,DEAU,1964,1122
2,1,39,0,0,0,78,1916,620,39,-1,,1955,698
3,1,39,1,0,0,78,1916,620,30,-1,,1946,698
4,1,39,1,1,0,78,1916,620,14,-1,,1930,698
5,1,39,1,1,1,78,1916,68,12,93,PRODUCT,1928,146
5,1,39,1,1,2,158,1909,12,28,66,|,1937,170
5,1,39,1,1,3,172,1917,36,11,91,TANK,1928,208
5,1,39,1,1,4,212,1917,69,11,7,CAPACITY],1928,281
5,1,39,1,1,5,288,1917,49,11,91,WATER,1928,337
5,1,39,1,1,6,342,1917,21,11,89,DIP|,1928,363
5,1,39,1,1,7,372,1917,55,11,95,BEFORE,1928,427
5,1,39,1,1,8,432,1917,31,12,0,"DIPS,",1929,463
5,1,39,1,1,9,610,1918,1,3,84,|,1921,611
5,1,39,1,1,10,617,1919,44,11,88,AFTER,1930,661
5,1,39,1,1,11,667,1919,31,11,46,OlPS|,1930,698
4,1,39,1,2,0,81,1927,608,28,-1,,1955,689
5,1,39,1,2,1,81,1932,61,12,85,PRODUIT,1944,142
5,1,39,1,2,2,161,1926,10,28,89,|,1954,171
5,1,39,1,2,3,174,1933,97,11,82,CONTENANGE,1944,271
5,1,39,1,2,4,280,1926,10,28,92,|,1954,290
5,1,39,1,2,5,291,1933,67,12,88,MEASURE,1945,358
5,1,39,1,2,6,366,1926,5,28,88,|,1954,371
5,1,39,1,2,7,382,1934,45,11,66,AVANT,1945,427
5,1,39,1,2,8,432,1934,15,12,66,LE,1946,447
5,1,39,1,2,9,496,1927,81,28,74,INVENTAIRE,1955,577
5,1,39,1,2,10,622,1935,47,11,90,APRES,1946,669
5,1,39,1,2,11,674,1935,15,11,95,LE,1946,689
2,1,40,0,0,0,172,1949,520,22,-1,,1971,692
3,1,40,1,0,0,172,1949,520,22,-1,,1971,692
4,1,40,1,1,0,172,1949,520,22,-1,,1971,692
5,1,40,1,1,1,172,1949,107,18,84,DURESERVIOR,1967,279
5,1,40,1,1,2,290,1966,2,1,78,|,1967,292
5,1,40,1,1,3,297,1951,42,16,78,DEAU,1967,339
5,1,40,1,1,4,354,1943,17,28,71,|,1971,371
5,1,40,1,1,5,378,1951,75,11,82,JAUGEAGE,1962,453
5,1,40,1,1,6,500,1951,75,11,48,JAUGEAGE,1962,575
5,1,40,1,1,7,609,1965,4,6,46,|,1971,613
5,1,40,1,1,8,617,1951,75,12,87,JAUGEAGE,1963,692
2,1,41,0,0,0,482,1918,111,12,-1,,1930,593
3,1,41,1,0,0,482,1918,111,12,-1,,1930,593
4,1,41,1,1,0,482,1918,111,12,-1,,1930,593
5,1,41,1,1,1,482,1918,55,11,92,BEFORE,1929,537
5,1,41,1,1,2,542,1919,51,11,87,INVENT,1930,593
2,1,42,0,0,0,1568,1936,62,35,-1,,1971,1630
3,1,42,1,0,0,1568,1936,62,35,-1,,1971,1630
4,1,42,1,1,0,1617,1936,13,19,-1,,1955,1630
5,1,42,1,1,1,1617,1936,13,19,95,        ,1955,1630
4,1,42,1,2,0,1568,1955,62,16,-1,,1971,1630
5,1,42,1,2,1,1568,1955,62,16,95,   ,1971,1630
2,1,43,0,0,0,1387,1937,13,34,-1,,1971,1400
3,1,43,1,0,0,1387,1937,13,34,-1,,1971,1400
4,1,43,1,1,0,1388,1937,11,18,-1,,1955,1399
5,1,43,1,1,1,1388,1937,11,18,95,       ,1955,1399
4,1,43,1,2,0,1387,1955,13,16,-1,,1971,1400
5,1,43,1,2,1,1387,1955,13,16,95,   ,1971,1400
2,1,44,0,0,0,1143,1937,12,34,-1,,1971,1155
3,1,44,1,0,0,1143,1937,12,34,-1,,1971,1155
4,1,44,1,1,0,1143,1937,12,18,-1,,1955,1155
5,1,44,1,1,1,1143,1937,12,18,95,       ,1955,1155
4,1,44,1,2,0,1143,1955,12,16,-1,,1971,1155
5,1,44,1,2,1,1143,1955,12,16,95,   ,1971,1155
2,1,45,0,0,0,339,1935,37,41,-1,,1976,376
3,1,45,1,0,0,339,1935,37,41,-1,,1976,376
4,1,45,1,1,0,360,1935,15,21,-1,,1956,375
5,1,45,1,1,1,360,1935,15,21,95,         ,1956,375
4,1,45,1,2,0,339,1956,37,20,-1,,1976,376
5,1,45,1,2,1,339,1956,37,20,95,  ,1976,376
2,1,46,0,0,0,1475,1966,47,6,-1,,1972,1522
3,1,46,1,0,0,1475,1966,47,6,-1,,1972,1522
4,1,46,1,1,0,1475,1966,47,6,-1,,1972,1522
5,1,46,1,1,1,1475,1966,47,6,95, ,1972,1522
2,1,47,0,0,0,182,1958,1436,21,-1,,1979,1618
3,1,47,1,0,0,182,1958,1436,21,-1,,1979,1618
4,1,47,1,1,0,182,1958,1436,21,-1,,1979,1618
5,1,47,1,1,1,182,1958,1436,21,95, ,1979,1618
2,1,48,0,0,0,50,1978,1580,185,-1,,2163,1630
3,1,48,1,0,0,50,1978,1580,185,-1,,2163,1630
4,1,48,1,1,0,50,1978,1580,185,-1,,2163,1630
5,1,48,1,1,1,50,1978,1580,185,95,    ,2163,1630
2,1,49,0,0,0,1237,2029,331,7,-1,,2036,1568
3,1,49,1,0,0,1237,2029,331,7,-1,,2036,1568
4,1,49,1,1,0,1237,2029,331,7,-1,,2036,1568
5,1,49,1,1,1,1237,2029,331,7,95, ,2036,1568
2,1,50,0,0,0,622,2023,946,16,-1,,2039,1568
3,1,50,1,0,0,622,2023,946,16,-1,,2039,1568
4,1,50,1,1,0,622,2023,946,16,-1,,2039,1568
5,1,50,1,1,1,622,2023,946,16,95, ,2039,1568
2,1,51,0,0,0,69,2025,391,6,-1,,2031,460
3,1,51,1,0,0,69,2025,391,6,-1,,2031,460
4,1,51,1,1,0,69,2025,391,6,-1,,2031,460
5,1,51,1,1,1,69,2025,391,6,95, ,2031,460
2,1,52,0,0,0,1146,2090,475,9,-1,,2099,1621
3,1,52,1,0,0,1146,2090,475,9,-1,,2099,1621
4,1,52,1,1,0,1146,2090,475,9,-1,,2099,1621
5,1,52,1,1,1,1146,2090,475,9,95, ,2099,1621
2,1,53,0,0,0,210,2086,782,11,-1,,2097,992
3,1,53,1,0,0,210,2086,782,11,-1,,2097,992
4,1,53,1,1,0,210,2086,782,11,-1,,2097,992
5,1,53,1,1,1,210,2086,782,11,95, ,2097,992
2,1,54,0,0,0,1481,1917,4,209,-1,,2126,1485
3,1,54,1,0,0,1481,1917,4,209,-1,,2126,1485
4,1,54,1,1,0,1481,1917,4,209,-1,,2126,1485
5,1,54,1,1,1,1481,1917,4,209,95, ,2126,1485
2,1,55,0,0,0,1258,1917,5,234,-1,,2151,1263
3,1,55,1,0,0,1258,1917,5,234,-1,,2151,1263
4,1,55,1,1,0,1258,1917,5,234,-1,,2151,1263
5,1,55,1,1,1,1258,1917,5,234,95, ,2151,1263
2,1,56,0,0,0,1063,1914,5,239,-1,,2153,1068
3,1,56,1,0,0,1063,1914,5,239,-1,,2153,1068
4,1,56,1,1,0,1063,1914,5,239,-1,,2153,1068
5,1,56,1,1,1,1063,1914,5,239,95, ,2153,1068
2,1,57,0,0,0,463,1912,6,238,-1,,2150,469
3,1,57,1,0,0,463,1912,6,238,-1,,2150,469
4,1,57,1,1,0,463,1912,6,238,-1,,2150,469
5,1,57,1,1,1,463,1912,6,238,95,,2150,469
