level,page_num,block_num,par_num,line_num,word_num,left,top,width,height,conf,text,bottom,right,label
1,1,0,0,0,0,0,0,1700,2200,-1,,2200,1700,0.0
2,1,1,0,0,0,896,90,610,24,-1,,114,1506,0.0
3,1,1,1,0,0,896,90,610,24,-1,,114,1506,0.0
4,1,1,1,1,0,896,90,610,24,-1,,114,1506,0.0
5,1,1,1,1,1,896,90,116,22,96,VEHICLE,112,1012,0.0
5,1,1,1,1,2,1023,91,121,22,96,LOADING,113,1144,0.0
5,1,1,1,1,3,1156,92,113,21,92,REPORT,113,1269,0.0
5,1,1,1,1,4,1278,104,7,2,90,-,106,1285,0.0
5,1,1,1,1,5,1296,92,54,21,95,BILL,113,1350,0.0
5,1,1,1,1,6,1360,92,36,21,93,OF,113,1396,0.0
5,1,1,1,1,7,1407,92,99,22,92,LADING,114,1506,0.0
2,1,2,0,0,0,1066,144,545,6,-1,,150,1611,0.0
3,1,2,1,0,0,1066,144,545,6,-1,,150,1611,0.0
4,1,2,1,1,0,1066,144,545,6,-1,,150,1611,0.0
5,1,2,1,1,1,1066,144,545,6,95, ,150,1611,0.0
2,1,3,0,0,0,1013,241,341,5,-1,,246,1354,0.0
3,1,3,1,0,0,1013,241,341,5,-1,,246,1354,0.0
4,1,3,1,1,0,1013,241,341,5,-1,,246,1354,0.0
5,1,3,1,1,1,1013,241,341,5,95, ,246,1354,0.0
2,1,4,0,0,0,672,256,34,11,-1,,267,706,0.0
3,1,4,1,0,0,672,256,34,11,-1,,267,706,0.0
4,1,4,1,1,0,672,256,34,11,-1,,267,706,0.0
5,1,4,1,1,1,672,256,34,11,95, ,267,706,0.0
2,1,5,0,0,0,47,118,1565,240,-1,,358,1612,0.0
3,1,5,1,0,0,121,118,1491,54,-1,,172,1612,0.0
4,1,5,1,1,0,132,118,1480,30,-1,,148,1612,0.0
5,1,5,1,1,1,132,122,73,22,95,Page:,144,205,0.0
5,1,5,1,1,2,230,120,12,24,92,2,144,242,0.0
5,1,5,1,1,3,461,122,47,26,96,530,148,508,0.0
5,1,5,1,1,4,799,118,131,28,96,RAPPORT,146,930,0.0
5,1,5,1,1,5,941,120,34,20,92,DE,140,975,0.0
5,1,5,1,1,6,986,120,196,27,92,CHARGEMENT,147,1182,0.0
5,1,5,1,1,7,1192,132,6,2,89,-,134,1198,0.0
5,1,5,1,1,8,1208,120,137,22,89,VEHICULE,142,1345,0.0
5,1,5,1,1,9,1356,132,6,3,91,-,135,1362,0.0
5,1,5,1,1,10,1373,120,239,22,90,CONNAISSEMENT,142,1612,0.0
4,1,5,1,2,0,121,147,535,25,-1,,172,656,0.0
5,1,5,1,2,1,121,150,196,15,71,DOGUMENTNUMBER,165,317,0.0
5,1,5,1,2,2,347,151,60,18,84,6363,169,407,0.0
5,1,5,1,2,3,463,150,1,12,46,|,162,464,0.0
5,1,5,1,2,4,494,140,13,39,46,—,179,507,0.0
5,1,5,1,2,5,523,148,43,23,0,RATE,171,566,0.0
5,1,5,1,2,6,572,144,59,28,0,SYEPER,172,631,0.0
5,1,5,1,2,7,640,161,16,11,57,oy,172,656,0.0
3,1,5,2,0,0,48,166,1546,73,-1,,239,1594,0.0
4,1,5,2,1,0,48,166,1546,49,-1,,215,1594,0.0
5,1,5,2,1,1,48,193,2,5,46,|,198,50,0.0
5,1,5,2,1,2,120,168,23,16,40,Ne,184,143,0.0
5,1,5,2,1,3,151,168,142,16,0,bUDOCUMENT,184,293,0.0
5,1,5,2,1,4,506,166,100,49,0,mia/ad/,215,606,0.0
5,1,5,2,1,5,612,166,31,49,35,yy,215,643,0.0
5,1,5,2,1,6,784,185,29,21,89,24,206,813,0.0
5,1,5,2,1,7,824,184,77,23,89,HOUR,207,901,0.0
5,1,5,2,1,8,920,185,107,21,73,NUMBER,206,1027,0.0
5,1,5,2,1,9,1043,183,214,21,32,(613]996-6666,204,1257,0.0
5,1,5,2,1,10,1295,198,6,2,73,-,200,1301,0.0
5,1,5,2,1,11,1313,186,120,22,96,NUMERO,208,1433,0.0
5,1,5,2,1,12,1443,187,29,21,96,24,208,1472,0.0
5,1,5,2,1,13,1483,186,111,23,96,HEURES,209,1594,0.0
4,1,5,2,2,0,133,211,1224,28,-1,,239,1357,0.0
5,1,5,2,2,1,133,211,109,19,96,0362418,230,242,1.0
5,1,5,2,2,2,264,212,93,19,96,10/006,231,357,0.0
5,1,5,2,2,3,512,212,128,21,96,10/07/24,233,640,2.0
5,1,5,2,2,4,1030,210,146,28,86,‘COLLECT,238,1176,0.0
5,1,5,2,2,5,1164,206,17,37,91,-,243,1181,0.0
5,1,5,2,2,6,1192,217,72,22,91,FRAIS,239,1264,0.0
5,1,5,2,2,7,1278,217,79,22,91,VIRES,239,1357,0.0
3,1,5,3,0,0,47,226,1550,43,-1,,269,1597,0.0
4,1,5,3,1,0,47,226,1550,43,-1,,269,1597,0.0
5,1,5,3,1,1,47,230,2,12,52,|,242,49,0.0
5,1,5,3,1,2,62,226,184,39,43,CONSIGNEE;CUSTOMER,265,246,0.0
5,1,5,3,1,3,260,244,7,12,73,-,256,267,0.0
5,1,5,3,1,4,274,236,183,30,92,DESTINATAIRE/CLIENT,266,457,0.0
5,1,5,3,1,5,672,241,30,26,23,Roo,267,702,0.0
5,1,5,3,1,6,700,241,148,26,0,eyaaeeNent,267,848,0.0
5,1,5,3,1,7,832,237,12,34,91,|,271,844,0.0
5,1,5,3,1,8,847,242,111,18,92,CONSIGNOR,260,958,0.0
5,1,5,3,1,9,951,237,9,34,92,-,271,960,0.0
5,1,5,3,1,10,965,243,105,17,22,EXPEDITEUR,260,1070,0.0
5,1,5,3,1,11,1433,244,4,2,30,|,246,1437,0.0
5,1,5,3,1,12,1448,244,149,25,5,nora,269,1597,0.0
3,1,5,4,0,0,47,270,1563,88,-1,,358,1610,0.0
4,1,5,4,1,0,47,270,1527,25,-1,,295,1574,0.0
5,1,5,4,1,1,47,270,1,22,91,|,292,48,0.0
5,1,5,4,1,2,131,274,79,17,91,PETRO,291,210,0.0
5,1,5,4,1,3,228,274,99,17,96,CANADA,291,327,0.0
5,1,5,4,1,4,344,274,164,18,95,LUBRICANTS,292,508,0.0
5,1,5,4,1,5,529,275,45,17,96,INC,292,574,0.0
5,1,5,4,1,6,662,273,176,20,93,0005064508,293,838,0.0
5,1,5,4,1,7,845,276,97,18,11,|SUNCOR,294,942,0.0
5,1,5,4,1,8,961,276,98,18,95,ENERGY,294,1059,0.0
5,1,5,4,1,9,1077,276,131,18,96,MONTREAL,294,1208,0.0
5,1,5,4,1,10,1463,276,111,19,96,0082041,295,1574,0.0
4,1,5,4,2,0,131,302,1479,23,-1,,325,1610,0.0
5,1,5,4,2,1,131,304,61,17,89,PCLI,321,192,0.0
5,1,5,4,2,2,213,312,11,2,90,-,314,224,0.0
5,1,5,4,2,3,245,304,96,21,96,QUEBEC,325,341,0.0
5,1,5,4,2,4,362,304,44,18,96,302,322,406,0.0
5,1,5,4,2,5,662,302,161,21,84,0009406423,323,823,0.0
5,1,5,4,2,6,845,306,78,17,84,11675,323,923,0.0
5,1,5,4,2,7,944,310,48,14,96,rue,324,992,0.0
5,1,5,4,2,8,1012,306,163,18,95,Sherbrooke,324,1175,0.0
5,1,5,4,2,9,1194,308,46,16,96,est,324,1240,0.0
5,1,5,4,2,10,1546,304,64,1,0,oO,305,1610,0.0
4,1,5,4,3,0,131,333,1342,25,-1,,358,1473,0.0
5,1,5,4,3,1,131,333,44,18,96,385,351,175,0.0
5,1,5,4,3,2,197,334,145,18,96,SOUTHDOWN,352,342,0.0
5,1,5,4,3,3,361,335,64,17,96,ROAD,352,425,0.0
5,1,5,4,3,4,842,336,143,21,96,"Montreal,",357,985,0.0
5,1,5,4,3,5,1011,338,30,20,87,QC,358,1041,0.0
5,1,5,4,3,6,1061,337,48,17,87,H1B,354,1109,0.0
5,1,5,4,3,7,1129,337,43,18,40,103,355,1172,0.0
5,1,5,4,3,8,1267,337,68,20,75,(613),357,1335,0.0
5,1,5,4,3,9,1349,338,124,17,75,996-6666,355,1473,0.0
2,1,6,0,0,0,129,364,376,20,-1,,384,505,0.0
3,1,6,1,0,0,129,364,376,20,-1,,384,505,0.0
4,1,6,1,1,0,129,364,376,20,-1,,384,505,0.0
5,1,6,1,1,1,129,364,190,20,96,"MISSISSAUGA,",384,319,0.0
5,1,6,1,1,2,344,365,32,17,94,ON,382,376,0.0
5,1,6,1,1,3,394,364,48,18,91,LSJ,382,442,0.0
5,1,6,1,1,4,461,364,44,18,60,2Y¥3,382,505,0.0
2,1,7,0,0,0,261,394,831,48,-1,,442,1092,0.0
3,1,7,1,0,0,261,394,831,48,-1,,442,1092,0.0
4,1,7,1,1,0,285,394,807,24,-1,,418,1092,0.0
5,1,7,1,1,1,285,412,21,2,33,__,414,306,0.0
5,1,7,1,1,2,384,413,51,1,0,ee,414,435,0.0
5,1,7,1,1,3,835,394,124,24,52,Yannick,418,959,0.0
5,1,7,1,1,4,976,395,116,19,96,Mercier,414,1092,0.0
4,1,7,1,2,0,261,416,568,13,-1,,429,829,0.0
5,1,7,1,2,1,261,416,62,11,93,RELEASE,427,323,0.0
5,1,7,1,2,2,328,416,48,13,79,(C-of-A),429,376,0.0
5,1,7,1,2,3,381,416,59,11,66,NUMBER,427,440,0.0
5,1,7,1,2,4,552,417,77,11,96,CUSTOMER,428,629,0.0
5,1,7,1,2,5,635,417,76,11,96,PURCHASE,428,711,0.0
5,1,7,1,2,6,716,418,49,10,94,ORDER,428,765,0.0
5,1,7,1,2,7,770,418,59,11,57,NUMBER,429,829,0.0
4,1,7,1,3,0,602,431,190,11,-1,,442,792,0.0
5,1,7,1,3,1,602,431,16,10,95,No,441,618,0.0
5,1,7,1,3,2,623,431,17,11,83,OE,442,640,0.0
5,1,7,1,3,3,646,431,69,11,88,DEMANCE,442,715,0.0
5,1,7,1,3,4,720,432,18,10,96,DU,442,738,0.0
5,1,7,1,3,5,744,431,48,11,94,CLIENT,442,792,0.0
2,1,8,0,0,0,830,522,716,6,-1,,528,1546,0.0
3,1,8,1,0,0,830,522,716,6,-1,,528,1546,0.0
4,1,8,1,1,0,830,522,716,6,-1,,528,1546,0.0
5,1,8,1,1,1,830,522,716,6,95, ,528,1546,0.0
2,1,9,0,0,0,359,675,79,1,-1,,676,438,0.0
3,1,9,1,0,0,359,675,79,1,-1,,676,438,0.0
4,1,9,1,1,0,359,675,79,1,-1,,676,438,0.0
5,1,9,1,1,1,359,675,79,1,95, ,676,438,0.0
2,1,10,0,0,0,640,675,586,6,-1,,681,1226,0.0
3,1,10,1,0,0,640,675,586,6,-1,,681,1226,0.0
4,1,10,1,1,0,640,675,586,6,-1,,681,1226,0.0
5,1,10,1,1,1,640,675,586,6,95, ,681,1226,0.0
2,1,11,0,0,0,46,741,946,8,-1,,749,992,0.0
3,1,11,1,0,0,46,741,946,8,-1,,749,992,0.0
4,1,11,1,1,0,46,741,946,8,-1,,749,992,0.0
5,1,11,1,1,1,46,741,946,8,95, ,749,992,0.0
2,1,12,0,0,0,1180,749,58,1,-1,,750,1238,0.0
3,1,12,1,0,0,1180,749,58,1,-1,,750,1238,0.0
4,1,12,1,1,0,1180,749,58,1,-1,,750,1238,0.0
5,1,12,1,1,1,1180,749,58,1,95, ,750,1238,0.0
2,1,13,0,0,0,46,344,4,460,-1,,804,50,0.0
3,1,13,1,0,0,46,344,4,460,-1,,804,50,0.0
4,1,13,1,1,0,46,344,4,460,-1,,804,50,0.0
5,1,13,1,1,1,46,344,4,460,95, ,804,50,0.0
2,1,14,0,0,0,45,478,1568,332,-1,,810,1613,0.0
3,1,14,1,0,0,45,478,1568,332,-1,,810,1613,0.0
4,1,14,1,1,0,46,478,701,26,-1,,504,747,0.0
5,1,14,1,1,1,46,478,242,26,0,TCARRIER-TRANSPORTEUR,504,288,0.0
5,1,14,1,1,2,480,480,66,3,0,OO,483,546,0.0
5,1,14,1,1,3,715,482,32,1,0,_,483,747,0.0
4,1,14,1,2,0,129,515,1474,31,-1,,546,1603,0.0
5,1,14,1,2,1,129,515,48,17,96,GEO,532,177,0.0
5,1,14,1,2,2,194,515,16,17,96,A,532,210,0.0
5,1,14,1,2,3,227,516,64,16,96,HALL,532,291,0.0
5,1,14,1,2,4,561,515,111,19,23,9401535,534,672,0.0
5,1,14,1,2,5,718,531,70,13,0,Vesicte,544,788,0.0
5,1,14,1,2,6,794,524,70,21,36,NUMBER,545,864,0.0
5,1,14,1,2,7,907,532,70,13,66,LICENSE,545,977,0.0
5,1,14,1,2,8,983,532,71,14,72,NUMBER,546,1054,0.0
5,1,14,1,2,9,1116,526,78,20,96,ADDRESS,546,1194,0.0
5,1,14,1,2,10,1200,533,22,13,96,OF,546,1222,0.0
5,1,14,1,2,11,1228,533,57,13,96,METER,546,1285,0.0
5,1,14,1,2,12,1291,533,34,13,96,AND,546,1325,0.0
5,1,14,1,2,13,1331,533,67,13,86,TRADER,546,1398,0.0
5,1,14,1,2,14,1473,526,8,1,0,-,527,1481,0.0
5,1,14,1,2,15,1574,526,29,2,5,_,528,1603,0.0
4,1,14,1,3,0,131,544,1332,24,-1,,568,1463,0.0
5,1,14,1,3,1,131,544,61,18,93,8800,562,192,0.0
5,1,14,1,3,2,212,553,12,3,90,-,556,224,0.0
5,1,14,1,3,3,246,544,29,18,88,6E,562,275,0.0
5,1,14,1,3,4,294,546,147,18,89,CROISSANT,564,441,0.0
5,1,14,1,3,5,721,554,20,12,96,No,566,741,0.0
5,1,14,1,3,6,747,554,22,12,93,DU,566,769,0.0
5,1,14,1,3,7,775,554,82,13,92,VEHICULE,567,857,0.0
5,1,14,1,3,8,907,554,72,14,95,NOMBRE,568,979,0.0
5,1,14,1,3,9,985,554,21,14,93,OE,568,1006,0.0
5,1,14,1,3,10,1013,554,62,14,92,PERMIS,568,1075,0.0
5,1,14,1,3,11,1081,546,9,32,82,|,578,1090,0.0
5,1,14,1,3,12,1103,555,89,13,28,L'ADRESSE,568,1192,0.0
5,1,14,1,3,13,1198,555,22,13,96,DE,568,1220,0.0
5,1,14,1,3,14,1226,555,56,13,95,METRE,568,1282,0.0
5,1,14,1,3,15,1290,555,20,13,95,ET,568,1310,0.0
5,1,14,1,3,16,1316,555,20,13,93,DE,568,1336,0.0
5,1,14,1,3,17,1343,555,120,13,91,COMMERCANT,568,1463,0.0
4,1,14,1,4,0,128,570,1362,32,-1,,602,1490,0.0
5,1,14,1,4,1,128,570,81,32,94,ANJOU,602,209,0.0
5,1,14,1,4,2,460,598,3,1,36,7,599,463,0.0
5,1,14,1,4,3,579,598,83,1,1,ee,599,662,0.0
5,1,14,1,4,4,711,576,61,19,96,1136,595,772,0.0
5,1,14,1,4,5,1095,578,77,18,95,11675,596,1172,0.0
5,1,14,1,4,6,1193,583,48,13,95,rue,596,1241,0.0
5,1,14,1,4,7,1260,578,164,19,95,Sherbrooke,597,1424,0.0
5,1,14,1,4,8,1444,581,46,17,95,est,598,1490,0.0
4,1,14,1,5,0,129,600,1484,48,-1,,648,1613,0.0
5,1,14,1,5,1,129,605,48,19,35,HlJ,624,177,0.0
5,1,14,1,5,2,197,605,43,19,34,1Al1,624,240,0.0
5,1,14,1,5,3,460,622,1,22,95,|,644,461,0.0
5,1,14,1,5,4,476,604,31,26,0,GERI,630,507,0.0
5,1,14,1,5,5,520,605,12,25,21,eb,630,532,0.0
5,1,14,1,5,6,544,600,88,48,0,FéanseOmTE,648,632,0.0
5,1,14,1,5,7,640,606,13,24,14,se,630,653,0.0
5,1,14,1,5,8,710,608,63,18,95,1921,626,773,0.0
5,1,14,1,5,9,1092,609,142,21,96,"Montreal,",630,1234,0.0
5,1,14,1,5,10,1260,610,30,21,83,OC,631,1290,0.0
5,1,14,1,5,11,1309,609,49,19,85,H1B,628,1358,0.0
5,1,14,1,5,12,1378,610,44,18,63,1C3,628,1422,0.0
5,1,14,1,5,13,1612,621,1,11,96,|,632,1613,0.0
4,1,14,1,6,0,135,634,1171,25,-1,,659,1306,0.0
5,1,14,1,6,1,135,634,67,21,0,(514),655,202,0.0
5,1,14,1,6,2,213,634,126,19,0,352-5550,653,339,0.0
5,1,14,1,6,3,1099,638,68,21,85,(613),659,1167,0.0
5,1,14,1,6,4,1180,638,126,19,85,996-6666,657,1306,0.0
4,1,14,1,7,0,48,659,1562,24,-1,,683,1610,0.0
5,1,14,1,7,1,48,659,122,24,13,——————,683,170,0.0
5,1,14,1,7,2,299,675,56,1,74,—=,676,355,0.0
5,1,14,1,7,3,447,664,22,13,67,L,677,469,0.0
5,1,14,1,7,4,821,677,11,1,51,=,678,832,0.0
5,1,14,1,7,5,1265,679,2,2,66,.,681,1267,0.0
5,1,14,1,7,6,1392,679,218,2,15,———,681,1610,0.0
4,1,14,1,8,0,1112,686,154,15,-1,,701,1266,0.0
5,1,14,1,8,1,1112,686,1,6,69,|,692,1113,0.0
5,1,14,1,8,2,1145,687,93,14,73,MEASURED,701,1238,0.0
5,1,14,1,8,3,1265,686,1,10,82,|,696,1266,0.0
4,1,14,1,9,0,59,694,1521,31,-1,,725,1580,0.0
5,1,14,1,9,1,59,694,142,14,55,PRODUCTMETER,708,201,0.0
5,1,14,1,9,2,352,709,80,14,96,PRODUCT,723,432,0.0
5,1,14,1,9,3,438,710,112,13,92,DESCRIPTION,723,550,0.0
5,1,14,1,9,4,556,718,4,1,92,-,719,560,0.0
5,1,14,1,9,5,567,710,112,14,92,DESCRIPTION,724,679,0.0
5,1,14,1,9,6,685,711,22,13,96,DU,724,707,0.0
5,1,14,1,9,7,714,711,73,14,96,PRODUIT,725,787,0.0
5,1,14,1,9,8,1159,707,57,14,56,UTRES,721,1216,0.0
5,1,14,1,9,9,1290,699,104,14,62,CORRECTED,713,1394,0.0
5,1,14,1,9,10,1401,695,11,42,72,|,737,1412,0.0
5,1,14,1,9,11,1423,699,45,14,90,TEMP,713,1468,0.0
5,1,14,1,9,12,1482,695,11,42,90,|,737,1493,0.0
5,1,14,1,9,13,1510,700,70,13,77,DENSITY,713,1580,0.0
4,1,14,1,10,0,59,722,1553,30,-1,,752,1612,0.0
5,1,14,1,10,1,59,722,135,22,49,PRODUIT/METER,744,194,0.0
5,1,14,1,10,2,301,745,126,2,26,oe,747,427,0.0
5,1,14,1,10,3,757,747,6,1,0,-,748,763,0.0
5,1,14,1,10,4,1037,748,10,1,0,-,749,1047,0.0
5,1,14,1,10,5,1141,727,96,23,0,MESUREES,750,1237,0.0
5,1,14,1,10,6,1314,727,62,23,31,TO18G,750,1376,0.0
5,1,14,1,10,7,1412,727,69,14,50,|CELSIUS|,741,1481,0.0
5,1,14,1,10,8,1510,728,80,23,87,DENSITE,751,1590,0.0
5,1,14,1,10,9,1599,750,13,2,66,|,752,1612,0.0
4,1,14,1,11,0,45,757,1526,24,-1,,781,1571,0.0
5,1,14,1,11,1,45,761,1,10,94,|,771,46,0.0
5,1,14,1,11,2,129,757,93,18,93,103265,775,222,0.0
5,1,14,1,11,3,237,753,15,33,93,|,786,252,0.0
5,1,14,1,11,4,258,759,49,17,95,NOT,776,307,0.0
5,1,14,1,11,5,326,759,147,18,95,REGULATED,777,473,0.0
5,1,14,1,11,6,492,760,81,17,96,UNDER,777,573,0.0
5,1,14,1,11,7,591,760,49,17,96,TDG,777,640,0.0
5,1,14,1,11,8,960,761,95,18,93,0.9642,779,1055,0.0
5,1,14,1,11,9,1160,761,78,18,96,43998,779,1238,0.0
5,1,14,1,11,10,1310,762,78,18,93,42423,780,1388,0.0
5,1,14,1,11,11,1411,762,60,19,84,|61.7,781,1471,0.0
5,1,14,1,11,12,1487,757,84,24,73,|910.6,781,1571,0.0
4,1,14,1,12,0,127,788,947,22,-1,,810,1074,0.0
5,1,14,1,12,1,127,788,96,18,92,MTR271,806,223,0.0
5,1,14,1,12,2,236,784,14,31,44,|),815,250,0.0
5,1,14,1,12,3,259,790,81,17,96,HEAVY,807,340,0.0
5,1,14,1,12,4,358,790,100,17,93,VACUUM,807,458,0.0
5,1,14,1,12,5,475,789,191,21,48,GASOIL(HVGO),810,666,0.0
5,1,14,1,12,6,957,793,48,16,91,API,809,1005,0.0
5,1,14,1,12,7,1027,791,47,18,88,54B,809,1074,0.0
2,1,15,0,0,0,1487,679,4,324,-1,,1003,1491,0.0
3,1,15,1,0,0,1487,679,4,324,-1,,1003,1491,0.0
4,1,15,1,1,0,1487,679,4,324,-1,,1003,1491,0.0
5,1,15,1,1,1,1487,679,4,324,95, ,1003,1491,0.0
2,1,16,0,0,0,44,985,886,221,-1,,1206,930,0.0
3,1,16,1,0,0,44,985,886,221,-1,,1206,930,0.0
4,1,16,1,1,0,298,985,234,195,-1,,1180,532,0.0
5,1,16,1,1,1,298,985,61,195,57,of,1180,359,0.0
5,1,16,1,1,2,424,989,108,187,11,"A,",1176,532,0.0
4,1,16,1,2,0,44,1151,886,55,-1,,1206,930,0.0
5,1,16,1,2,1,44,1176,1,10,52,|,1186,45,0.0
5,1,16,1,2,2,523,1151,82,55,47,Dont,1206,605,0.0
2,1,17,0,0,0,485,1191,37,21,-1,,1212,522,0.0
3,1,17,1,0,0,372,1191,150,57,-1,,1248,522,0.0
4,1,17,1,1,0,485,1191,37,21,-1,,1212,522,0.0
5,1,17,1,1,1,485,1191,37,21,0,.,1212,522,0.0
2,1,18,0,0,0,1263,707,4,533,-1,,1240,1267,0.0
3,1,18,1,0,0,1263,707,4,533,-1,,1240,1267,0.0
4,1,18,1,1,0,1263,707,4,533,-1,,1240,1267,0.0
5,1,18,1,1,1,1263,707,4,533,95, ,1240,1267,0.0
2,1,19,0,0,0,927,1214,5,314,-1,,1528,932,0.0
3,1,19,1,0,0,927,1214,5,314,-1,,1528,932,0.0
4,1,19,1,1,0,927,1214,5,314,-1,,1528,932,0.0
5,1,19,1,1,1,927,1214,5,314,95, ,1528,932,0.0
2,1,20,0,0,0,258,1463,1127,79,-1,,1542,1385,0.0
3,1,20,1,0,0,258,1463,1127,150,-1,,1613,1385,0.0
4,1,20,1,1,0,290,1463,974,49,-1,,1512,1264,0.0
5,1,20,1,1,1,290,1489,80,18,96,Total,1507,370,0.0
5,1,20,1,1,2,390,1488,96,20,96,Litres,1508,486,0.0
5,1,20,1,1,3,506,1489,32,23,96,by,1512,538,0.0
5,1,20,1,1,4,557,1490,113,18,96,Product,1508,670,0.0
5,1,20,1,1,5,1262,1463,2,41,66,|,1504,1264,0.0
4,1,20,1,2,0,258,1519,1127,23,-1,,1542,1385,0.0
5,1,20,1,2,1,258,1519,94,19,90,103265,1538,352,0.0
5,1,20,1,2,2,456,1521,82,17,96,HEAVY,1538,538,0.0
5,1,20,1,2,3,555,1521,101,18,93,VACUUM,1539,656,0.0
5,1,20,1,2,4,672,1522,96,18,39,GASOTL,1540,768,0.0
5,1,20,1,2,5,779,1521,85,21,39,(HVGO),1542,864,0.0
5,1,20,1,2,6,1157,1523,79,19,96,43998,1542,1236,0.0
5,1,20,1,2,7,1308,1523,77,19,96,42423,1542,1385,3.0
2,1,21,0,0,0,234,675,9,1011,-1,,1686,243,0.0
3,1,21,1,0,0,234,675,9,1011,-1,,1686,243,0.0
4,1,21,1,1,0,234,675,9,1011,-1,,1686,243,0.0
5,1,21,1,1,1,234,675,9,1011,95, ,1686,243,0.0
2,1,22,0,0,0,1107,697,9,993,-1,,1690,1116,0.0
3,1,22,1,0,0,1107,697,9,993,-1,,1690,1116,0.0
4,1,22,1,1,0,1107,697,9,993,-1,,1690,1116,0.0
5,1,22,1,1,1,1107,697,9,993,95, ,1690,1116,0.0
2,1,23,0,0,0,1399,724,9,967,-1,,1691,1408,0.0
3,1,23,1,0,0,1399,724,9,967,-1,,1691,1408,0.0
4,1,23,1,1,0,1399,724,9,967,-1,,1691,1408,0.0
5,1,23,1,1,1,1399,724,9,967,95, ,1691,1408,0.0
2,1,24,0,0,0,56,1697,877,40,-1,,1737,933,0.0
3,1,24,1,0,0,56,1697,873,40,-1,,1737,929,0.0
4,1,24,1,1,0,56,1697,863,21,-1,,1718,919,0.0
5,1,24,1,1,1,56,1697,2,13,45,|,1710,58,0.0
5,1,24,1,1,2,65,1697,49,17,45,hereby,1714,114,0.0
5,1,24,1,1,3,121,1697,52,13,96,declare,1710,173,0.0
5,1,24,1,1,4,179,1698,26,13,95,that,1711,205,0.0
5,1,24,1,1,5,211,1697,21,14,94,the,1711,232,0.0
5,1,24,1,1,6,238,1699,61,13,96,contents,1712,299,0.0
5,1,24,1,1,7,305,1698,13,14,96,of,1712,318,0.0
5,1,24,1,1,8,324,1698,24,14,95,this,1712,348,0.0
5,1,24,1,1,9,354,1699,93,17,96,consignment,1716,447,0.0
5,1,24,1,1,10,453,1703,23,9,96,are,1712,476,0.0
5,1,24,1,1,11,482,1699,28,17,90,fully,1716,510,0.0
5,1,24,1,1,12,516,1699,26,13,96,and,1712,542,0.0
5,1,24,1,1,13,548,1700,75,16,96,accurately,1716,623,0.0
5,1,24,1,1,14,629,1700,70,14,93,described,1714,699,0.0
5,1,24,1,1,15,706,1701,44,13,93,above,1714,750,0.0
5,1,24,1,1,16,756,1700,17,17,96,by,1717,773,0.0
5,1,24,1,1,17,778,1701,22,13,79,Ine,1714,800,0.0
5,1,24,1,1,18,806,1704,47,13,96,proper,1717,853,0.0
5,1,24,1,1,19,858,1701,61,17,95,shipping,1718,919,0.0
4,1,24,1,2,0,56,1717,877,20,-1,,1737,933,0.0
5,1,24,1,2,1,56,1719,44,14,68,"fame,",1733,100,0.0
5,1,24,1,2,2,107,1720,22,10,88,are,1730,129,0.0
5,1,24,1,2,3,135,1717,59,17,94,properly,1734,194,0.0
5,1,24,1,2,4,199,1717,66,14,31,classified,1731,265,0.0
5,1,24,1,2,5,272,1718,25,13,96,and,1731,297,0.0
5,1,24,1,2,6,304,1718,74,17,96,"packaged,",1735,378,0.0
5,1,24,1,2,7,385,1719,35,13,96,have,1732,420,0.0
5,1,24,1,2,8,425,1719,77,17,43,dangerous,1736,502,0.0
5,1,24,1,2,9,508,1719,44,17,95,goods,1736,552,0.0
5,1,24,1,2,10,559,1719,43,17,91,safely,1736,602,0.0
5,1,24,1,2,11,608,1719,43,14,96,marks,1733,651,0.0
5,1,24,1,2,12,658,1719,59,18,94,properly,1737,717,0.0
5,1,24,1,2,13,722,1720,48,14,84,affixed,1734,770,0.0
5,1,24,1,2,14,776,1723,14,11,93,or,1734,790,0.0
5,1,24,1,2,15,796,1720,69,17,83,displayed,1737,865,0.0
5,1,24,1,2,16,871,1723,16,11,96,on,1734,887,0.0
5,1,24,1,2,17,894,1721,39,14,72,them.,1735,933,0.0
2,1,25,0,0,0,581,1686,474,4,-1,,1690,1055,0.0
3,1,25,1,0,0,581,1686,474,4,-1,,1690,1055,0.0
4,1,25,1,1,0,581,1686,474,4,-1,,1690,1055,0.0
5,1,25,1,1,1,581,1686,474,4,95, ,1690,1055,0.0
2,1,26,0,0,0,56,1737,1554,85,-1,,1822,1610,0.0
3,1,26,1,0,0,56,1737,1554,85,-1,,1822,1610,0.0
4,1,26,1,1,0,56,1737,1553,25,-1,,1762,1609,0.0
5,1,26,1,1,1,56,1737,26,13,81,and,1750,82,0.0
5,1,26,1,1,2,88,1740,23,10,94,are,1750,111,0.0
5,1,26,1,1,3,117,1740,10,10,95,in,1750,127,0.0
5,1,26,1,1,4,134,1737,15,13,93,all,1750,149,0.0
5,1,26,1,1,5,155,1738,69,16,95,respects,1754,224,0.0
5,1,26,1,1,6,222,1741,10,9,96,in,1750,232,0.0
5,1,26,1,1,7,239,1741,47,13,96,proper,1754,286,0.0
5,1,26,1,1,8,292,1738,64,13,96,condition,1751,356,0.0
5,1,26,1,1,9,363,1738,18,13,95,for,1751,381,0.0
5,1,26,1,1,10,386,1740,65,15,89,transport,1755,451,0.0
5,1,26,1,1,11,457,1739,70,16,88,according,1755,527,0.0
5,1,26,1,1,12,534,1740,12,12,77,lo,1752,546,0.0
5,1,26,1,1,13,552,1739,22,13,66,Ihe,1752,574,0.0
5,1,26,1,1,14,579,1740,106,16,96,Transportation,1756,685,0.0
5,1,26,1,1,15,692,1740,13,13,96,of,1753,705,0.0
5,1,26,1,1,16,712,1740,79,16,96,Dangerous,1756,791,0.0
5,1,26,1,1,17,796,1740,48,14,90,Goods,1754,844,0.0
5,1,26,1,1,18,851,1740,119,17,96,Regulations,1757,970,0.0
5,1,26,1,1,19,945,1733,8,28,47,|,1761,953,0.0
5,1,26,1,1,20,957,1733,17,28,45,—,1761,974,0.0
5,1,26,1,1,21,974,1748,33,12,40,TIME,1760,1007,0.0
5,1,26,1,1,22,1013,1749,12,11,40,IN,1760,1025,0.0
5,1,26,1,1,23,1066,1745,3,2,77,T,1747,1069,0.0
5,1,26,1,1,24,1105,1738,9,27,84,~,1765,1114,0.0
5,1,26,1,1,25,1109,1745,52,15,94,START,1760,1161,0.0
5,1,26,1,1,26,1166,1745,61,16,93,LOADING,1761,1227,0.0
5,1,26,1,1,27,1309,1746,275,16,48,FINISHLOADING.,1762,1584,0.0
5,1,26,1,1,28,1458,1741,34,26,78,|,1767,1492,0.0
5,1,26,1,1,29,1502,1746,70,16,67,TIMEOUT,1762,1572,0.0
5,1,26,1,1,30,1595,1746,14,2,63,|,1748,1609,0.0
4,1,26,1,2,0,125,1762,1439,21,-1,,1783,1564,0.0
5,1,26,1,2,1,125,1762,114,20,96,Yannick,1782,239,0.0
5,1,26,1,2,2,255,1764,115,19,96,Mercier,1783,370,0.0
5,1,26,1,2,3,974,1763,61,11,87,ARRIVEE,1774,1035,0.0
5,1,26,1,2,4,1087,1763,45,11,25,DESUT,1774,1132,0.0
5,1,26,1,2,5,1137,1764,18,10,25,DU,1774,1155,0.0
5,1,26,1,2,6,1160,1763,99,12,83,CHARGEMENT,1775,1259,0.0
5,1,26,1,2,7,1269,1754,11,31,90,|,1785,1280,0.0
5,1,26,1,2,8,1298,1764,20,11,73,FIN,1775,1318,0.0
5,1,26,1,2,9,1324,1764,18,11,74,DU,1775,1342,0.0
5,1,26,1,2,10,1348,1764,98,11,74,CHARGEMENT,1775,1446,0.0
5,1,26,1,2,11,1509,1764,55,12,91,DEPART,1776,1564,0.0
4,1,26,1,3,0,139,1798,1471,24,-1,,1822,1610,0.0
5,1,26,1,3,1,139,1796,55,32,96,Shipper,1828,194,0.0
5,1,26,1,3,2,201,1796,33,32,96,name,1828,234,0.0
5,1,26,1,3,3,241,1800,54,21,92,(please,1821,295,0.0
5,1,26,1,3,4,303,1796,37,32,74,print),1828,340,0.0
5,1,26,1,3,5,957,1798,79,18,91,00:31,1816,1036,0.0
5,1,26,1,3,6,1067,1816,1,3,37,|,1819,1068,0.0
5,1,26,1,3,7,1125,1799,76,18,95,00:36,1817,1201,0.0
5,1,26,1,3,8,1324,1799,78,19,95,00:59,1818,1402,0.0
5,1,26,1,3,9,1491,1800,77,18,87,00:59,1818,1568,0.0
5,1,26,1,3,10,1609,1805,1,5,47,|,1810,1610,0.0
2,1,27,0,0,0,1275,1745,5,83,-1,,1828,1280,0.0
3,1,27,1,0,0,1275,1745,5,83,-1,,1828,1280,0.0
4,1,27,1,1,0,1275,1745,5,83,-1,,1828,1280,0.0
5,1,27,1,1,1,1275,1745,5,83,95, ,1828,1280,0.0
2,1,28,0,0,0,1483,679,8,1152,-1,,1831,1491,0.0
3,1,28,1,0,0,1483,679,8,1152,-1,,1831,1491,0.0
4,1,28,1,1,0,1483,679,8,1152,-1,,1831,1491,0.0
5,1,28,1,1,1,1483,679,8,1152,95, ,1831,1491,0.0
2,1,29,0,0,0,941,1688,3,141,-1,,1829,944,0.0
3,1,29,1,0,0,941,1688,3,141,-1,,1829,944,0.0
4,1,29,1,1,0,941,1688,3,141,-1,,1829,944,0.0
5,1,29,1,1,1,941,1688,3,141,95, ,1829,944,0.0
2,1,30,0,0,0,42,1823,1510,56,-1,,1879,1552,0.0
3,1,30,1,0,0,42,1823,1510,56,-1,,1879,1552,0.0
4,1,30,1,1,0,42,1823,1510,40,-1,,1863,1552,0.0
5,1,30,1,1,1,42,1824,3,2,0,"""",1826,45,0.0
5,1,30,1,1,2,47,1824,69,18,59,ORIVER,1842,116,0.0
5,1,30,1,1,3,123,1829,46,13,89,NAME,1842,169,0.0
5,1,30,1,1,4,175,1836,4,3,89,-,1839,179,0.0
5,1,30,1,1,5,190,1830,30,13,96,NOM,1843,220,0.0
5,1,30,1,1,6,230,1825,19,18,93,DU,1843,249,0.0
5,1,30,1,1,7,249,1825,123,19,91,CONDUCTEUA,1844,372,0.0
5,1,30,1,1,8,561,1823,76,40,34,NOBIVER,1863,637,0.0
5,1,30,1,1,9,647,1832,62,27,43,NUMBER,1859,709,0.0
5,1,30,1,1,10,734,1827,2,4,88,|,1831,736,0.0
5,1,30,1,1,11,758,1828,155,25,3,DRIVES#SIGNATURE,1853,913,0.0
5,1,30,1,1,12,919,1840,4,2,91,-,1842,923,0.0
5,1,30,1,1,13,930,1828,124,18,94,SIGNATURE,1846,1054,0.0
5,1,30,1,1,14,1036,1823,20,34,88,DU,1857,1056,0.0
5,1,30,1,1,15,1061,1827,116,20,51,CONDUCTEUR,1847,1177,0.0
5,1,30,1,1,16,1262,1829,54,18,95,TOTAL,1847,1316,0.0
5,1,30,1,1,17,1322,1830,93,18,93,QUANTITY,1848,1415,0.0
5,1,30,1,1,18,1410,1825,8,32,90,-,1857,1418,0.0
5,1,30,1,1,19,1421,1830,63,18,91,QUANT.,1848,1484,0.0
5,1,30,1,1,20,1489,1834,63,14,92,TOTALE,1848,1552,0.0
4,1,30,1,2,0,823,1859,695,20,-1,,1879,1518,0.0
5,1,30,1,2,1,823,1859,4,2,0,-,1861,827,0.0
5,1,30,1,2,2,1307,1860,79,19,96,43998,1879,1386,0.0
5,1,30,1,2,3,1422,1860,96,19,91,Litres,1879,1518,0.0
2,1,31,0,0,0,37,1827,1579,335,-1,,2162,1616,0.0
3,1,31,1,0,0,37,1827,1579,335,-1,,2162,1616,0.0
4,1,31,1,1,0,37,1827,1579,335,-1,,2162,1616,0.0
5,1,31,1,1,1,37,1827,1579,335,95,   ,2162,1616,0.0
2,1,32,0,0,0,1605,147,15,1764,-1,,1911,1620,0.0
3,1,32,1,0,0,1605,147,15,1764,-1,,1911,1620,0.0
4,1,32,1,1,0,1605,147,15,1764,-1,,1911,1620,0.0
5,1,32,1,1,1,1605,147,15,1764,95, ,1911,1620,0.0
2,1,33,0,0,0,65,1888,1523,107,-1,,1995,1588,0.0
3,1,33,1,0,0,65,1888,1523,107,-1,,1995,1588,0.0
4,1,33,1,1,0,126,1888,593,19,-1,,1907,719,0.0
5,1,33,1,1,1,126,1888,113,17,93,SYLVAIN,1905,239,0.0
5,1,33,1,1,2,290,1888,98,18,53,GAREAU,1906,388,0.0
5,1,33,1,1,3,591,1888,128,19,96,00007148,1907,719,0.0
4,1,33,1,2,0,65,1917,1523,22,-1,,1939,1588,0.0
5,1,33,1,2,1,65,1917,66,11,95,PRODUCT,1928,131,0.0
5,1,33,1,2,2,143,1911,14,32,42,|,1943,157,0.0
5,1,33,1,2,3,158,1918,36,10,42,TANK,1928,194,0.0
5,1,33,1,2,4,199,1918,67,11,35,CAPACITY,1929,266,0.0
5,1,33,1,2,5,272,1918,49,11,93,WATER,1929,321,0.0
5,1,33,1,2,6,327,1918,85,12,67,DIP/BEFORE,1930,412,0.0
5,1,33,1,2,7,417,1919,31,11,80,DIPS|,1930,448,0.0
5,1,33,1,2,8,467,1919,55,11,1,SEFORE,1930,522,0.0
5,1,33,1,2,9,528,1920,50,10,95,INVENT,1930,578,0.0
5,1,33,1,2,10,589,1911,8,32,69,|,1943,597,0.0
5,1,33,1,2,11,602,1920,44,11,93,AFTER,1931,646,0.0
5,1,33,1,2,12,652,1920,31,11,86,DIPS|,1931,683,0.0
5,1,33,1,2,13,695,1920,52,19,0,ENM{AG,1939,747,0.0
5,1,33,1,2,14,752,1920,51,11,96,INVENT,1931,803,0.0
5,1,33,1,2,15,848,1920,67,11,85,PRODUCT,1931,915,0.0
5,1,33,1,2,16,928,1914,10,28,41,|,1942,938,0.0
5,1,33,1,2,17,938,1921,37,11,41,TANK,1932,975,0.0
5,1,33,1,2,18,980,1921,68,11,80,CAPACITY|,1932,1048,0.0
5,1,33,1,2,19,1056,1922,49,10,91,WATER,1932,1105,0.0
5,1,33,1,2,20,1111,1922,20,10,86,DIF|,1932,1131,0.0
5,1,33,1,2,21,1142,1922,55,10,94,BEFORE,1932,1197,0.0
5,1,33,1,2,22,1202,1922,32,10,92,DIPS,1932,1234,0.0
5,1,33,1,2,23,1243,1914,10,28,92,|,1942,1253,0.0
5,1,33,1,2,24,1258,1922,56,11,96,BEFORE,1933,1314,0.0
5,1,33,1,2,25,1320,1922,50,11,96,INVENT,1933,1370,0.0
5,1,33,1,2,26,1373,1914,8,28,96,|,1942,1381,0.0
5,1,33,1,2,27,1386,1922,44,11,93,AFTER,1933,1430,0.0
5,1,33,1,2,28,1436,1922,30,11,92,DIPS|,1933,1466,0.0
5,1,33,1,2,29,1481,1922,52,11,94,ENDING,1933,1533,0.0
5,1,33,1,2,30,1538,1923,50,11,79,INVENT,1934,1588,0.0
4,1,33,1,3,0,67,1928,1509,28,-1,,1956,1576,0.0
5,1,33,1,3,1,67,1934,61,11,86,PRODUIT,1945,128,0.0
5,1,33,1,3,2,147,1927,10,28,86,|,1955,157,0.0
5,1,33,1,3,3,161,1934,94,11,65,CONTENANCE,1945,255,0.0
5,1,33,1,3,4,269,1934,1,10,82,|,1944,270,0.0
5,1,33,1,3,5,276,1935,66,11,82,MEASURE,1946,342,0.0
5,1,33,1,3,6,350,1927,7,28,94,|,1955,357,0.0
5,1,33,1,3,7,367,1935,45,11,72,AVANT,1946,412,0.0
5,1,33,1,3,8,417,1936,15,10,72,LE,1946,432,0.0
5,1,33,1,3,9,481,1928,81,28,66,INVENTAIRE,1956,562,0.0
5,1,33,1,3,10,608,1936,46,11,60,APRES,1947,654,0.0
5,1,33,1,3,11,659,1936,16,11,60,LE,1947,675,0.0
5,1,33,1,3,12,722,1937,68,11,70,VENTAIRE,1948,790,0.0
5,1,33,1,3,13,850,1937,61,11,92,PRODUIT,1948,911,0.0
5,1,33,1,3,14,927,1930,10,28,90,|,1958,937,0.0
5,1,33,1,3,15,942,1937,96,12,89,CONTENANCE,1949,1038,0.0
5,1,33,1,3,16,1044,1930,10,28,96,|,1958,1054,0.0
5,1,33,1,3,17,1059,1938,67,11,84,MEASURE,1949,1126,0.0
5,1,33,1,3,18,1133,1930,7,28,84,|,1958,1140,0.0
5,1,33,1,3,19,1152,1938,46,11,45,AVANT,1949,1198,0.0
5,1,33,1,3,20,1203,1938,15,11,45,LE.,1949,1218,0.0
5,1,33,1,3,21,1272,1938,82,11,86,INVENTAIRE,1949,1354,0.0
5,1,33,1,3,22,1373,1931,10,28,92,|,1959,1383,0.0
5,1,33,1,3,23,1392,1938,66,12,92,APRESLE,1950,1458,0.0
5,1,33,1,3,24,1466,1931,15,28,34,|,1959,1481,0.0
5,1,33,1,3,25,1495,1939,81,11,73,INVENTAIRE,1950,1576,0.0
4,1,33,1,4,0,151,1950,1309,45,-1,,1995,1460,0.0
5,1,33,1,4,1,151,1950,25,45,3,P,1995,176,0.0
5,1,33,1,4,2,182,1951,78,11,90,RESERVIOR,1962,260,0.0
5,1,33,1,4,3,271,1944,5,28,56,|,1972,276,0.0
5,1,33,1,4,4,288,1952,36,11,56,DEAU,1963,324,0.0
5,1,33,1,4,5,341,1944,15,28,69,|,1972,356,0.0
5,1,33,1,4,6,364,1952,74,11,61,JAUGEAGE,1963,438,0.0
5,1,33,1,4,7,485,1952,75,12,91,JAUGEAGE,1964,560,0.0
5,1,33,1,4,8,602,1953,75,11,54,YAUGEAGE,1964,677,0.0
5,1,33,1,4,9,692,1968,3,1,0,|4/,1969,695,0.0
5,1,33,1,4,10,725,1968,11,1,42,AF,1969,736,0.0
5,1,33,1,4,11,885,1954,158,17,27,____|DURESERVIOR,1971,1043,0.0
5,1,33,1,4,12,1050,1946,8,29,61,|,1975,1058,0.0
5,1,33,1,4,13,1071,1954,36,11,27,DEAU,1965,1107,0.0
5,1,33,1,4,14,1150,1954,74,12,85,JAUGEAGE,1966,1224,0.0
5,1,33,1,4,15,1277,1955,75,11,73,JAUGEAGE,1966,1352,0.0
5,1,33,1,4,16,1368,1947,13,28,37,|,1975,1381,0.0
5,1,33,1,4,17,1386,1955,74,11,88,JAUGEAGE,1966,1460,0.0
2,1,34,0,0,0,948,1967,659,7,-1,,1974,1607,0.0
3,1,34,1,0,0,948,1967,659,7,-1,,1974,1607,0.0
4,1,34,1,1,0,948,1967,659,7,-1,,1974,1607,0.0
5,1,34,1,1,1,948,1967,659,7,95, ,1974,1607,0.0
2,1,35,0,0,0,171,1965,550,5,-1,,1970,721,0.0
3,1,35,1,0,0,171,1965,550,5,-1,,1970,721,0.0
4,1,35,1,1,0,171,1965,550,5,-1,,1970,721,0.0
5,1,35,1,1,1,171,1965,550,5,95, ,1970,721,0.0
2,1,36,0,0,0,948,2030,342,3,-1,,2033,1290,0.0
3,1,36,1,0,0,948,2030,342,3,-1,,2033,1290,0.0
4,1,36,1,1,0,948,2030,342,3,-1,,2033,1290,0.0
5,1,36,1,1,1,948,2030,342,3,95, ,2033,1290,0.0
2,1,37,0,0,0,316,2088,996,7,-1,,2095,1312,0.0
3,1,37,1,0,0,316,2088,996,7,-1,,2095,1312,0.0
4,1,37,1,1,0,316,2088,996,7,-1,,2095,1312,0.0
5,1,37,1,1,1,316,2088,996,7,95, ,2095,1312,0.0
2,1,38,0,0,0,565,2089,747,6,-1,,2095,1312,0.0
3,1,38,1,0,0,565,2089,747,6,-1,,2095,1312,0.0
4,1,38,1,1,0,565,2089,747,6,-1,,2095,1312,0.0
5,1,38,1,1,1,565,2089,747,6,95, ,2095,1312,0.0
2,1,39,0,0,0,683,1913,4,238,-1,,2151,687,0.0
3,1,39,1,0,0,683,1913,4,238,-1,,2151,687,0.0
4,1,39,1,1,0,683,1913,4,238,-1,,2151,687,0.0
5,1,39,1,1,1,683,1913,4,238,95, ,2151,687,0.0
2,1,40,0,0,0,1049,1915,4,237,-1,,2152,1053,0.0
3,1,40,1,0,0,1049,1915,4,237,-1,,2152,1053,0.0
4,1,40,1,1,0,1049,1915,4,237,-1,,2152,1053,0.0
5,1,40,1,1,1,1049,1915,4,237,95, ,2152,1053,0.0
2,1,41,0,0,0,1133,1915,3,237,-1,,2152,1136,0.0
3,1,41,1,0,0,1133,1915,3,237,-1,,2152,1136,0.0
4,1,41,1,1,0,1133,1915,3,237,-1,,2152,1136,0.0
5,1,41,1,1,1,1133,1915,3,237,95, ,2152,1136,0.0
2,1,42,0,0,0,1244,1917,3,235,-1,,2152,1247,0.0
3,1,42,1,0,0,1244,1917,3,235,-1,,2152,1247,0.0
4,1,42,1,1,0,1244,1917,3,235,-1,,2152,1247,0.0
5,1,42,1,1,1,1244,1917,3,235,95,,2152,1247,0.0
1,1,0,0,0,0,0,0,1700,2200,-1,,2200,1700,0.0
2,1,1,0,0,0,910,92,612,22,-1,,114,1522,0.0
3,1,1,1,0,0,910,92,612,22,-1,,114,1522,0.0
4,1,1,1,1,0,910,92,612,22,-1,,114,1522,0.0
5,1,1,1,1,1,910,92,116,22,96,VEHICLE,114,1026,0.0
5,1,1,1,1,2,1038,92,121,22,85,LOADING,114,1159,0.0
5,1,1,1,1,3,1172,92,112,22,93,REPORT,114,1284,0.0
5,1,1,1,1,4,1282,88,14,38,92,-,126,1296,0.0
5,1,1,1,1,5,1312,92,54,22,96,BILL,114,1366,0.0
5,1,1,1,1,6,1376,92,36,22,93,OF,114,1412,0.0
5,1,1,1,1,7,1423,92,99,22,91,LADING,114,1522,0.0
2,1,2,0,0,0,1252,144,350,5,-1,,149,1602,0.0
3,1,2,1,0,0,1252,144,350,5,-1,,149,1602,0.0
4,1,2,1,1,0,1252,144,350,5,-1,,149,1602,0.0
5,1,2,1,1,1,1252,144,350,5,95, ,149,1602,0.0
2,1,3,0,0,0,623,143,422,6,-1,,149,1045,0.0
3,1,3,1,0,0,623,143,422,6,-1,,149,1045,0.0
4,1,3,1,1,0,623,143,422,6,-1,,149,1045,0.0
5,1,3,1,1,1,623,143,422,6,95, ,149,1045,0.0
2,1,4,0,0,0,87,143,62,4,-1,,147,149,0.0
3,1,4,1,0,0,87,143,62,4,-1,,147,149,0.0
4,1,4,1,1,0,87,143,62,4,-1,,147,149,0.0
5,1,4,1,1,1,87,143,62,4,95, ,147,149,0.0
2,1,5,0,0,0,948,240,61,1,-1,,241,1009,0.0
3,1,5,1,0,0,948,240,61,1,-1,,241,1009,0.0
4,1,5,1,1,0,948,240,61,1,-1,,241,1009,0.0
5,1,5,1,1,1,948,240,61,1,95, ,241,1009,0.0
2,1,6,0,0,0,63,236,623,5,-1,,241,686,0.0
3,1,6,1,0,0,63,236,623,5,-1,,241,686,0.0
4,1,6,1,1,0,63,236,623,5,-1,,241,686,0.0
5,1,6,1,1,1,63,236,623,5,95, ,241,686,0.0
2,1,7,0,0,0,76,120,1556,203,-1,,323,1632,0.0
3,1,7,1,0,0,76,120,1556,203,-1,,323,1632,0.0
4,1,7,1,1,0,147,120,1485,28,-1,,148,1632,0.0
5,1,7,1,1,1,147,125,74,21,96,Page:,146,221,0.0
5,1,7,1,1,2,245,124,13,22,95,1,146,258,0.0
5,1,7,1,1,3,476,124,47,24,95,530,148,523,0.0
5,1,7,1,1,4,815,120,130,27,96,RAPPORT,147,945,0.0
5,1,7,1,1,5,956,121,36,26,92,DE,147,992,0.0
5,1,7,1,1,6,1001,120,197,27,91,CHARGEMENT,147,1198,0.0
5,1,7,1,1,7,1207,132,7,3,90,-,135,1214,0.0
5,1,7,1,1,8,1224,121,136,26,90,VEHICULE,147,1360,0.0
5,1,7,1,1,9,1371,133,7,2,92,-,135,1378,0.0
5,1,7,1,1,10,1388,121,244,27,56,CONNAISSEMENT.,148,1632,0.0
4,1,7,1,2,0,135,144,1497,37,-1,,181,1632,0.0
5,1,7,1,2,1,135,152,110,15,96,DOCUMENT,167,245,0.0
5,1,7,1,2,2,252,152,81,15,81,NUMBER,167,333,0.0
5,1,7,1,2,3,362,153,61,17,81,6391,170,423,0.0
5,1,7,1,2,4,536,149,37,23,87,DATE,172,573,0.0
5,1,7,1,2,5,581,144,50,37,63,DEXPED,181,631,0.0
5,1,7,1,2,6,643,149,28,24,57,TION,173,671,0.0
5,1,7,1,2,7,1630,165,2,16,93,|,181,1632,0.0
4,1,7,1,3,0,135,170,1475,42,-1,,212,1610,0.0
5,1,7,1,3,1,135,170,22,15,96,No,185,157,0.0
5,1,7,1,3,2,169,170,21,15,90,DU,185,190,0.0
5,1,7,1,3,3,204,170,105,15,95,DOCUMENT,185,309,0.0
5,1,7,1,3,4,522,171,137,41,13,mm/dd/yy,212,659,0.0
5,1,7,1,3,5,799,185,29,20,96,24,205,828,0.0
5,1,7,1,3,6,839,184,77,22,96,HOUR,206,916,0.0
5,1,7,1,3,7,927,184,117,22,69,NUMBER,206,1044,0.0
5,1,7,1,3,8,1053,183,220,28,36,_(613)996-6666,211,1273,0.0
5,1,7,1,3,9,1311,185,137,22,81,-NUMERO,207,1448,0.0
5,1,7,1,3,10,1458,186,29,20,96,24,206,1487,0.0
5,1,7,1,3,11,1498,186,112,21,95,HEURES,207,1610,0.0
4,1,7,1,4,0,147,211,1484,25,-1,,236,1631,0.0
5,1,7,1,4,1,147,211,111,18,96,0362431,229,258,1.0
5,1,7,1,4,2,280,212,93,18,95,10/006,230,373,0.0
5,1,7,1,4,3,528,212,129,19,95,10/07/24,231,657,2.0
5,1,7,1,4,4,1048,215,234,21,92,COLLECT,236,1282,0.0
5,1,7,1,4,5,1181,211,15,33,93,-,244,1196,0.0
5,1,7,1,4,6,1209,215,72,21,91,FRAIS,236,1281,0.0
5,1,7,1,4,7,1292,215,80,21,91,VIRES,236,1372,0.0
5,1,7,1,4,8,1630,219,1,11,95,|,230,1631,0.0
4,1,7,1,5,0,76,238,1548,27,-1,,265,1624,0.0
5,1,7,1,5,1,76,238,197,17,57,CONSIGNEE/CUSTCMER,255,273,0.0
5,1,7,1,5,2,280,250,4,1,87,-,251,284,0.0
5,1,7,1,5,3,290,239,183,17,84,DESTINATAIRE/OLIENT,256,473,0.0
5,1,7,1,5,4,687,239,30,25,0,ee,264,717,0.0
5,1,7,1,5,5,715,239,121,26,0,Riegetienr,265,836,0.0
5,1,7,1,5,6,851,239,2,4,93,|,243,853,0.0
5,1,7,1,5,7,862,240,101,17,87,CONSIGNOR,257,963,0.0
5,1,7,1,5,8,970,252,3,1,91,-,253,973,0.0
5,1,7,1,5,9,980,244,105,13,92,EXPEDITEUR,257,1085,0.0
5,1,7,1,5,10,1162,240,44,2,39,—,242,1206,0.0
5,1,7,1,5,11,1448,241,4,2,38,],243,1452,0.0
4,1,7,1,6,0,146,272,1444,20,-1,,292,1590,0.0
5,1,7,1,6,1,146,272,80,17,90,PETRO,289,226,0.0
5,1,7,1,6,2,244,272,99,17,96,CANADA,289,343,0.0
5,1,7,1,6,3,360,272,164,18,96,LUBRICANTS,290,524,0.0
5,1,7,1,6,4,545,272,46,18,96,INC,290,591,0.0
5,1,7,1,6,5,679,272,161,18,88,0005064508,290,840,0.0
5,1,7,1,6,6,860,273,97,18,83,|SUNCOR,291,957,0.0
5,1,7,1,6,7,976,274,98,17,96,ENERGY,291,1074,0.0
5,1,7,1,6,8,1092,274,132,17,96,MONTREAL,291,1224,0.0
5,1,7,1,6,9,1479,274,111,18,95,0082041,292,1590,0.0
4,1,7,1,7,0,146,299,1479,24,-1,,323,1625,0.0
5,1,7,1,7,1,146,302,62,18,91,PCLI,320,208,0.0
5,1,7,1,7,2,230,310,11,2,91,-,312,241,0.0
5,1,7,1,7,3,262,302,96,21,96,QUEBEC,323,358,0.0
5,1,7,1,7,4,378,302,45,18,96,302,320,423,0.0
5,1,7,1,7,5,675,299,164,22,83,0009406423,321,839,0.0
5,1,7,1,7,6,860,303,78,18,90,11675,321,938,0.0
5,1,7,1,7,7,960,308,47,13,96,rue,321,1007,0.0
5,1,7,1,7,8,1027,303,164,19,96,Sherbrooke,322,1191,0.0
5,1,7,1,7,9,1211,306,45,16,96,est,322,1256,0.0
5,1,7,1,7,10,1450,300,2,2,0,:,302,1452,0.0
5,1,7,1,7,11,1597,302,28,1,88,=],303,1625,0.0
2,1,8,0,0,0,144,332,1345,81,-1,,413,1489,0.0
3,1,8,1,0,0,144,332,1345,81,-1,,413,1489,0.0
4,1,8,1,1,0,146,332,1343,24,-1,,356,1489,0.0
5,1,8,1,1,1,146,332,45,19,96,385,351,191,0.0
5,1,8,1,1,2,212,333,147,18,96,SOUTHDOWN,351,359,0.0
5,1,8,1,1,3,377,334,64,18,96,ROAD,352,441,0.0
5,1,8,1,1,4,858,334,142,21,96,"Montreal,",355,1000,0.0
5,1,8,1,1,5,1026,335,30,21,92,QC,356,1056,0.0
5,1,8,1,1,6,1075,334,49,18,81,H1B,352,1124,0.0
5,1,8,1,1,7,1144,334,44,19,69,1C3,353,1188,0.0
5,1,8,1,1,8,1283,334,68,21,78,(613),355,1351,0.0
5,1,8,1,1,9,1364,334,125,19,78,996-6666,353,1489,0.0
4,1,8,1,2,0,144,344,708,43,-1,,387,852,0.0
5,1,8,1,2,1,144,364,191,20,96,"MISSISSAUGA,",384,335,0.0
5,1,8,1,2,2,360,364,32,18,90,ON,382,392,0.0
5,1,8,1,2,3,409,364,49,18,52,L5J,382,458,0.0
5,1,8,1,2,4,478,364,43,18,61,2Y3,382,521,0.0
5,1,8,1,2,5,851,344,1,43,67,|,387,852,0.0
4,1,8,1,3,0,858,394,249,19,-1,,413,1107,0.0
5,1,8,1,3,1,858,394,116,19,95,Yannick,413,974,0.0
5,1,8,1,3,2,991,394,116,19,96,Mercier,413,1107,0.0
2,1,9,0,0,0,568,417,277,25,-1,,442,845,0.0
3,1,9,1,0,0,568,417,277,25,-1,,442,845,0.0
4,1,9,1,1,0,568,417,277,11,-1,,428,845,0.0
5,1,9,1,1,1,568,417,78,11,92,CUSTOMER,428,646,0.0
5,1,9,1,1,2,652,417,75,11,96,PURCHASE,428,727,0.0
5,1,9,1,1,3,732,417,49,11,96,ORDER,428,781,0.0
5,1,9,1,1,4,787,418,58,10,56,"NUMBER,",428,845,0.0
4,1,9,1,2,0,619,431,189,11,-1,,442,808,0.0
5,1,9,1,2,1,619,431,15,11,95,No,442,634,0.0
5,1,9,1,2,2,640,431,17,11,45,OE,442,657,0.0
5,1,9,1,2,3,663,431,68,11,96,DEMANDE,442,731,0.0
5,1,9,1,2,4,737,432,17,10,89,OU,442,754,0.0
5,1,9,1,2,5,760,431,48,11,96,CLIENT,442,808,0.0
2,1,10,0,0,0,560,413,2,59,-1,,472,562,0.0
3,1,10,1,0,0,560,413,2,59,-1,,472,562,0.0
4,1,10,1,1,0,560,413,2,59,-1,,472,562,0.0
5,1,10,1,1,1,560,413,2,59,95, ,472,562,0.0
2,1,11,0,0,0,62,153,6,337,-1,,490,68,0.0
3,1,11,1,0,0,62,153,6,337,-1,,490,68,0.0
4,1,11,1,1,0,62,153,6,337,-1,,490,68,0.0
5,1,11,1,1,1,62,153,6,337,95, ,490,68,0.0
2,1,12,0,0,0,63,481,651,38,-1,,519,714,0.0
3,1,12,1,0,0,63,481,651,38,-1,,519,714,0.0
4,1,12,1,1,0,63,481,651,38,-1,,519,714,0.0
5,1,12,1,1,1,63,493,1,6,95,|,499,64,0.0
5,1,12,1,1,2,76,491,73,13,92,CARRIER,504,149,0.0
5,1,12,1,1,3,156,498,3,2,88,-,500,159,0.0
5,1,12,1,1,4,164,481,137,23,92,TRANSPORTEUR,504,301,0.0
2,1,13,0,0,0,560,475,272,8,-1,,483,832,0.0
3,1,13,1,0,0,560,475,272,8,-1,,483,832,0.0
4,1,13,1,1,0,560,475,272,8,-1,,483,832,0.0
5,1,13,1,1,1,560,475,2,7,41,1,482,562,0.0
5,1,13,1,1,2,725,482,12,1,96,=,483,737,0.0
5,1,13,1,1,3,790,482,42,1,60,—,483,832,0.0
2,1,14,0,0,0,423,480,340,5,-1,,485,763,0.0
3,1,14,1,0,0,423,480,340,5,-1,,485,763,0.0
4,1,14,1,1,0,423,480,340,5,-1,,485,763,0.0
5,1,14,1,1,1,423,480,340,5,95, ,485,763,0.0
2,1,15,0,0,0,949,524,347,3,-1,,527,1296,0.0
3,1,15,1,0,0,949,524,347,3,-1,,527,1296,0.0
4,1,15,1,1,0,949,524,347,3,-1,,527,1296,0.0
5,1,15,1,1,1,949,524,347,3,95, ,527,1296,0.0
2,1,16,0,0,0,480,597,75,3,-1,,600,555,0.0
3,1,16,1,0,0,480,597,75,3,-1,,600,555,0.0
4,1,16,1,1,0,480,597,75,3,-1,,600,555,0.0
5,1,16,1,1,1,480,597,75,3,95, ,600,555,0.0
2,1,17,0,0,0,1100,525,3,153,-1,,678,1103,0.0
3,1,17,1,0,0,1100,525,3,153,-1,,678,1103,0.0
4,1,17,1,1,0,1100,525,3,153,-1,,678,1103,0.0
5,1,17,1,1,1,1100,525,3,153,95, ,678,1103,0.0
2,1,18,0,0,0,983,675,403,5,-1,,680,1386,0.0
3,1,18,1,0,0,983,675,403,5,-1,,680,1386,0.0
4,1,18,1,1,0,983,675,403,5,-1,,680,1386,0.0
5,1,18,1,1,1,983,675,403,5,95, ,680,1386,0.0
2,1,19,0,0,0,61,672,56,4,-1,,676,117,0.0
3,1,19,1,0,0,61,672,56,4,-1,,676,117,0.0
4,1,19,1,1,0,61,672,56,4,-1,,676,117,0.0
5,1,19,1,1,1,61,672,56,4,95, ,676,117,0.0
2,1,20,0,0,0,1127,744,499,7,-1,,751,1626,0.0
3,1,20,1,0,0,1127,744,499,7,-1,,751,1626,0.0
4,1,20,1,1,0,1127,744,499,7,-1,,751,1626,0.0
5,1,20,1,1,1,1127,744,499,7,95, ,751,1626,0.0
2,1,21,0,0,0,544,745,351,3,-1,,748,895,0.0
3,1,21,1,0,0,544,745,351,3,-1,,748,895,0.0
4,1,21,1,1,0,544,745,351,3,-1,,748,895,0.0
5,1,21,1,1,1,544,745,351,3,95, ,748,895,0.0
2,1,22,0,0,0,62,742,333,5,-1,,747,395,0.0
3,1,22,1,0,0,62,742,333,5,-1,,747,395,0.0
4,1,22,1,1,0,62,742,333,5,-1,,747,395,0.0
5,1,22,1,1,1,62,742,333,5,95, ,747,395,0.0
2,1,23,0,0,0,60,730,6,364,-1,,1094,66,0.0
3,1,23,1,0,0,60,730,6,364,-1,,1094,66,0.0
4,1,23,1,1,0,60,730,6,364,-1,,1094,66,0.0
5,1,23,1,1,1,60,730,6,364,95, ,1094,66,0.0
2,1,24,0,0,0,1279,686,6,458,-1,,1144,1285,0.0
3,1,24,1,0,0,1279,686,6,458,-1,,1144,1285,0.0
4,1,24,1,1,0,1279,686,6,458,-1,,1144,1285,0.0
5,1,24,1,1,1,1279,686,6,458,95, ,1144,1285,0.0
2,1,25,0,0,0,943,1016,7,502,-1,,1518,950,0.0
3,1,25,1,0,0,943,1016,7,502,-1,,1518,950,0.0
4,1,25,1,1,0,943,1016,7,502,-1,,1518,950,0.0
5,1,25,1,1,1,943,1016,7,502,95, ,1518,950,0.0
2,1,26,0,0,0,1500,677,8,878,-1,,1555,1508,0.0
3,1,26,1,0,0,1500,677,8,878,-1,,1555,1508,0.0
4,1,26,1,1,0,1500,677,8,878,-1,,1555,1508,0.0
5,1,26,1,1,1,1500,677,8,878,95, ,1555,1508,0.0
2,1,27,0,0,0,62,515,1568,1176,-1,,1691,1630,0.0
3,1,27,1,0,0,62,515,1568,1176,-1,,1691,1630,0.0
4,1,27,1,1,0,144,515,1486,33,-1,,548,1630,0.0
5,1,27,1,1,1,144,515,49,18,96,GEO,533,193,0.0
5,1,27,1,1,2,210,516,17,16,95,A,532,227,0.0
5,1,27,1,1,3,244,516,65,17,96,HALL,533,309,0.0
5,1,27,1,1,4,578,516,111,18,77,0101535,534,689,0.0
5,1,27,1,1,5,707,512,11,42,28,|,554,718,0.0
5,1,27,1,1,6,735,531,69,13,19,Vehicle,544,804,0.0
5,1,27,1,1,7,811,521,69,23,38,NUMBER,544,880,0.0
5,1,27,1,1,8,913,512,79,42,64,LICENSE,554,992,0.0
5,1,27,1,1,9,1004,532,65,13,95,NUMBER,545,1069,0.0
5,1,27,1,1,10,1131,532,107,14,42,ADDRESS,546,1238,0.0
5,1,27,1,1,11,1217,521,21,34,97,OF,555,1238,0.0
5,1,27,1,1,12,1245,532,169,14,96,METER,546,1414,0.0
5,1,27,1,1,13,1308,521,32,34,95,AND,555,1340,0.0
5,1,27,1,1,14,1348,532,66,14,95,TRADER,546,1414,0.0
5,1,27,1,1,15,1479,524,151,24,37,|,548,1630,0.0
4,1,27,1,2,0,146,545,1484,35,-1,,580,1630,0.0
5,1,27,1,2,1,146,545,61,18,92,8800,563,207,0.0
5,1,27,1,2,2,229,554,12,2,90,-,556,241,0.0
5,1,27,1,2,3,262,545,29,18,92,6E,563,291,0.0
5,1,27,1,2,4,310,546,147,18,91,CROISSANT,564,457,0.0
5,1,27,1,2,5,737,554,20,12,96,No,566,757,0.0
5,1,27,1,2,6,766,553,19,13,77,BU,566,785,0.0
5,1,27,1,2,7,792,553,80,13,90,VEHICULE,566,872,0.0
5,1,27,1,2,8,922,554,168,13,96,NOMBRE,567,1090,0.0
5,1,27,1,2,9,998,546,21,31,90,DE,577,1019,0.0
5,1,27,1,2,10,1029,554,61,13,90,PERMIS,567,1090,0.0
5,1,27,1,2,11,1098,546,12,31,89,|,577,1110,0.0
5,1,27,1,2,12,1117,554,181,14,0,ADRESSE,568,1298,0.0
5,1,27,1,2,13,1215,546,21,31,96,DE,577,1236,0.0
5,1,27,1,2,14,1246,554,50,14,96,METRE,568,1296,0.0
5,1,27,1,2,15,1306,555,19,13,96,ET,568,1325,0.0
5,1,27,1,2,16,1336,555,16,13,81,OE,568,1352,0.0
5,1,27,1,2,17,1359,554,119,14,91,COMMERCANT,568,1478,0.0
5,1,27,1,2,18,1629,569,1,11,90,|,580,1630,0.0
4,1,27,1,3,0,139,571,1491,31,-1,,602,1630,0.0
5,1,27,1,3,1,139,571,87,31,96,ANJOU,602,226,0.0
5,1,27,1,3,2,569,598,28,1,0,__,599,597,0.0
5,1,27,1,3,3,727,577,62,18,96,1138,595,789,0.0
5,1,27,1,3,4,1110,578,78,18,80,11675,596,1188,0.0
5,1,27,1,3,5,1209,583,48,13,96,rue,596,1257,0.0
5,1,27,1,3,6,1277,577,163,19,95,Sherbrooke,596,1440,0.0
5,1,27,1,3,7,1460,580,46,16,95,est,596,1506,0.0
5,1,27,1,3,8,1629,594,1,4,86,|,598,1630,0.0
4,1,27,1,4,0,144,605,1294,25,-1,,630,1438,0.0
5,1,27,1,4,1,144,606,49,18,56,H1iJ,624,193,0.0
5,1,27,1,4,2,212,606,45,18,66,1A1,624,257,0.0
5,1,27,1,4,3,486,605,65,24,22,CERES,629,551,0.0
5,1,27,1,4,4,559,605,111,25,0,"FERTSRTON,",630,670,0.0
5,1,27,1,4,5,727,607,62,18,96,1068,625,789,0.0
5,1,27,1,4,6,1107,608,143,21,95,"Montreal,",629,1250,0.0
5,1,27,1,4,7,1276,609,30,21,85,QC,630,1306,0.0
5,1,27,1,4,8,1325,608,49,18,22,HIB,626,1374,0.0
5,1,27,1,4,9,1394,609,44,18,28,1¢c3,627,1438,0.0
4,1,27,1,5,0,150,634,1480,24,-1,,658,1630,0.0
5,1,27,1,5,1,150,634,69,21,0,(514),655,219,0.0
5,1,27,1,5,2,228,634,128,19,0,352-5550,653,356,0.0
5,1,27,1,5,3,1115,637,69,21,46,(613),658,1184,0.0
5,1,27,1,5,4,1196,637,126,18,46,996-6666,655,1322,0.0
5,1,27,1,5,5,1629,642,1,12,86,|,654,1630,0.0
4,1,27,1,6,0,62,686,1534,37,-1,,723,1596,0.0
5,1,27,1,6,1,62,703,2,16,0,",",719,64,0.0
5,1,27,1,6,2,80,694,138,14,71,PRODUCTIMETER,708,218,0.0
5,1,27,1,6,3,368,699,70,34,96,PRODUCT,733,438,0.0
5,1,27,1,6,4,439,709,256,14,93,DESCRIPTION,723,695,0.0
5,1,27,1,6,5,570,699,10,34,93,-,733,580,0.0
5,1,27,1,6,6,587,709,106,14,96,DESCRIPTION,723,693,0.0
5,1,27,1,6,7,702,710,21,13,96,DU,723,723,0.0
5,1,27,1,6,8,731,710,73,13,96,PRODUIT,723,804,0.0
5,1,27,1,6,9,1162,686,70,33,0,MUTRES,719,1232,0.0
5,1,27,1,6,10,1306,697,104,14,88,CORRECTED,711,1410,0.0
5,1,27,1,6,11,1414,693,14,42,73,|},735,1428,0.0
5,1,27,1,6,12,1439,698,45,13,87,TEMP,711,1484,0.0
5,1,27,1,6,13,1498,693,18,42,38,|,735,1516,0.0
5,1,27,1,6,14,1526,697,70,14,91,DENSITY,711,1596,0.0
4,1,27,1,7,0,62,720,1534,28,-1,,748,1596,0.0
5,1,27,1,7,1,62,720,149,26,36,_PRODUIT/METER,746,211,0.0
5,1,27,1,7,2,459,746,4,1,9,:,747,463,0.0
5,1,27,1,7,3,522,746,11,1,0,-,747,533,0.0
5,1,27,1,7,4,916,746,12,1,0,-,747,928,0.0
5,1,27,1,7,5,1093,747,31,1,13,__|__,748,1124,0.0
5,1,27,1,7,6,1162,725,92,14,13,MESUREES,739,1254,0.0
5,1,27,1,7,7,1331,725,61,14,47,TO1SC,739,1392,0.0
5,1,27,1,7,8,1420,725,78,17,28,CELSIUS},742,1498,0.0
5,1,27,1,7,9,1526,726,70,13,77,DENSITE,739,1596,0.0
4,1,27,1,8,0,146,750,1442,29,-1,,779,1588,0.0
5,1,27,1,8,1,146,757,93,18,95,103265,775,239,0.0
5,1,27,1,8,2,254,753,14,32,95,|,785,268,0.0
5,1,27,1,8,3,276,759,49,17,95,NOT,776,325,0.0
5,1,27,1,8,4,342,759,148,18,96,REGULATED,777,490,0.0
5,1,27,1,8,5,508,760,83,17,96,UNDER,777,591,0.0
5,1,27,1,8,6,609,760,48,17,95,TDG,777,657,0.0
5,1,27,1,8,7,948,750,1,10,34,|,760,949,0.0
5,1,27,1,8,8,976,759,95,19,74,0.9638,778,1071,0.0
5,1,27,1,8,9,1128,754,2,7,96,|,761,1130,0.0
5,1,27,1,8,10,1176,760,79,18,90,44001,778,1255,0.0
5,1,27,1,8,11,1327,760,79,19,92,42408,779,1406,0.0
5,1,27,1,8,12,1427,760,61,19,89,62.2,779,1488,0.0
5,1,27,1,8,13,1510,760,78,19,42,|910.6,779,1588,0.0
4,1,27,1,9,0,62,788,1027,27,-1,,815,1089,0.0
5,1,27,1,9,1,62,793,1,22,48,|,815,63,0.0
5,1,27,1,9,2,142,788,98,18,91,MTR271,806,240,0.0
5,1,27,1,9,3,251,784,14,31,95,|,815,265,0.0
5,1,27,1,9,4,276,790,81,16,96,HEAVY,806,357,0.0
5,1,27,1,9,5,374,789,101,18,93,VACUUM,807,475,0.0
5,1,27,1,9,6,492,790,93,17,77,GASOIL,807,585,0.0
5,1,27,1,9,7,599,789,84,21,77,(HVGO),810,683,0.0
5,1,27,1,9,8,973,792,48,16,92,API,808,1021,0.0
5,1,27,1,9,9,1043,790,46,19,91,54B,809,1089,0.0
4,1,27,1,10,0,454,881,233,76,-1,,957,687,0.0
5,1,27,1,10,1,454,881,127,76,52,Zool,957,581,0.0
5,1,27,1,10,2,582,927,11,4,26,-,931,593,0.0
5,1,27,1,10,3,616,898,71,57,51,24,955,687,0.0
4,1,27,1,11,0,450,1015,5,9,-1,,1024,455,0.0
5,1,27,1,11,1,450,1015,5,9,0,’,1024,455,0.0
4,1,27,1,12,0,416,1078,244,121,-1,,1199,660,0.0
5,1,27,1,12,1,416,1078,121,121,57,cule,1199,537,0.0
5,1,27,1,12,2,545,1122,115,51,44,HS,1173,660,0.0
4,1,27,1,13,0,254,1233,2,12,-1,,1245,256,0.0
5,1,27,1,13,1,254,1233,2,12,53,|,1245,256,0.0
4,1,27,1,14,0,254,1251,1,10,-1,,1261,255,0.0
5,1,27,1,14,1,254,1251,1,10,79,|,1261,255,0.0
4,1,27,1,15,0,1502,1474,2,12,-1,,1486,1504,0.0
5,1,27,1,15,1,1502,1474,2,12,61,i},1486,1504,0.0
4,1,27,1,16,0,308,1488,1195,34,-1,,1522,1503,0.0
5,1,27,1,16,1,308,1489,79,19,96,Total,1508,387,0.0
5,1,27,1,16,2,408,1488,96,20,96,Litres,1508,504,0.0
5,1,27,1,16,3,523,1489,33,23,96,by,1512,556,0.0
5,1,27,1,16,4,575,1489,112,19,96,Product,1508,687,0.0
5,1,27,1,16,5,1502,1517,1,5,53,|,1522,1503,0.0
4,1,27,1,17,0,276,1519,1128,23,-1,,1542,1404,0.0
5,1,27,1,17,1,276,1519,95,19,71,103265,1538,371,0.0
5,1,27,1,17,2,474,1522,81,17,96,HEAVY,1539,555,0.0
5,1,27,1,17,3,573,1521,100,19,92,VACUUM,1540,673,0.0
5,1,27,1,17,4,691,1522,94,18,78,GASOIL,1540,785,0.0
5,1,27,1,17,5,797,1521,84,21,78,(HVGO),1542,881,0.0
5,1,27,1,17,6,1174,1523,79,19,96,44001,1542,1253,0.0
5,1,27,1,17,7,1325,1523,79,19,96,42408,1542,1404,0.0
4,1,27,1,18,0,1502,1612,1,12,-1,,1624,1503,0.0
5,1,27,1,18,1,1502,1612,1,12,80,|,1624,1503,0.0
4,1,27,1,19,0,1502,1635,1,11,-1,,1646,1503,0.0
5,1,27,1,19,1,1502,1635,1,11,83,|,1646,1503,0.0
4,1,27,1,20,0,1502,1666,1,11,-1,,1677,1503,0.0
5,1,27,1,20,1,1502,1666,1,11,82,|,1677,1503,0.0
4,1,27,1,21,0,246,1680,1378,11,-1,,1691,1624,0.0
5,1,27,1,21,1,246,1685,7,1,35,t,1686,253,0.0
5,1,27,1,21,2,411,1685,37,2,39,—==,1687,448,0.0
5,1,27,1,21,3,828,1687,8,1,79,=,1688,836,0.0
5,1,27,1,21,4,927,1686,20,3,4,a,1689,947,0.0
5,1,27,1,21,5,1312,1688,29,1,59,—,1689,1341,0.0
5,1,27,1,21,6,1430,1680,74,10,33,|,1690,1504,0.0
5,1,27,1,21,7,1546,1689,78,2,59,—,1691,1624,0.0
2,1,28,0,0,0,1127,577,8,1113,-1,,1690,1135,0.0
3,1,28,1,0,0,1127,577,8,1113,-1,,1690,1135,0.0
4,1,28,1,1,0,1127,577,8,1113,-1,,1690,1135,0.0
5,1,28,1,1,1,1127,577,8,1113,95, ,1690,1135,0.0
2,1,29,0,0,0,1417,677,7,1013,-1,,1690,1424,0.0
3,1,29,1,0,0,1417,677,7,1013,-1,,1690,1424,0.0
4,1,29,1,1,0,1417,677,7,1013,-1,,1690,1424,0.0
5,1,29,1,1,1,1417,677,7,1013,95, ,1690,1424,0.0
2,1,30,0,0,0,252,686,7,1001,-1,,1687,259,0.0
3,1,30,1,0,0,252,686,7,1001,-1,,1687,259,0.0
4,1,30,1,1,0,252,686,7,1001,-1,,1687,259,0.0
5,1,30,1,1,1,252,686,7,1001,95, ,1687,259,0.0
2,1,31,0,0,0,1279,1304,3,386,-1,,1690,1282,0.0
3,1,31,1,0,0,1279,1304,3,386,-1,,1690,1282,0.0
4,1,31,1,1,0,1279,1304,3,386,-1,,1690,1282,0.0
5,1,31,1,1,1,1279,1304,3,386,95, ,1690,1282,0.0
2,1,32,0,0,0,954,1687,355,3,-1,,1690,1309,0.0
3,1,32,1,0,0,954,1687,355,3,-1,,1690,1309,0.0
4,1,32,1,1,0,954,1687,355,3,-1,,1690,1309,0.0
5,1,32,1,1,1,954,1687,355,3,95, ,1690,1309,0.0
2,1,33,0,0,0,64,1683,325,4,-1,,1687,389,0.0
3,1,33,1,0,0,64,1683,325,4,-1,,1687,389,0.0
4,1,33,1,1,0,64,1683,325,4,-1,,1687,389,0.0
5,1,33,1,1,1,64,1683,325,4,95, ,1687,389,0.0
2,1,34,0,0,0,72,1697,878,40,-1,,1737,950,0.0
3,1,34,1,0,0,72,1697,878,40,-1,,1737,950,0.0
4,1,34,1,1,0,73,1697,862,20,-1,,1717,935,0.0
5,1,34,1,1,1,73,1697,2,13,71,|,1710,75,0.0
5,1,34,1,1,2,82,1697,49,17,73,hereby,1714,131,0.0
5,1,34,1,1,3,137,1697,54,14,95,declare,1711,191,0.0
5,1,34,1,1,4,196,1698,27,13,96,that,1711,223,0.0
5,1,34,1,1,5,228,1698,23,13,96,the,1711,251,0.0
5,1,34,1,1,6,256,1699,61,13,94,contents,1712,317,0.0
5,1,34,1,1,7,323,1699,13,13,96,of,1712,336,0.0
5,1,34,1,1,8,342,1698,24,14,96,this,1712,366,0.0
5,1,34,1,1,9,372,1700,93,16,96,consignment,1716,465,0.0
5,1,34,1,1,10,471,1703,22,9,96,are,1712,493,0.0
5,1,34,1,1,11,499,1699,28,17,95,fully,1716,527,0.0
5,1,34,1,1,12,534,1699,25,13,96,and,1712,559,0.0
5,1,34,1,1,13,566,1700,75,16,95,accurately,1716,641,0.0
5,1,34,1,1,14,647,1699,70,14,94,described,1713,717,0.0
5,1,34,1,1,15,723,1700,44,13,96,above,1713,767,0.0
5,1,34,1,1,16,773,1700,17,16,95,by,1716,790,0.0
5,1,34,1,1,17,795,1700,22,14,96,the,1714,817,0.0
5,1,34,1,1,18,823,1703,47,14,96,proper,1717,870,0.0
5,1,34,1,1,19,876,1700,59,17,95,shipping,1717,935,0.0
4,1,34,1,2,0,72,1717,878,20,-1,,1737,950,0.0
5,1,34,1,2,1,72,1720,44,10,90,"name,",1730,116,0.0
5,1,34,1,2,2,123,1720,23,10,96,are,1730,146,0.0
5,1,34,1,2,3,152,1717,59,17,96,properly,1734,211,0.0
5,1,34,1,2,4,216,1717,67,14,54,classified,1731,283,0.0
5,1,34,1,2,5,289,1718,26,13,94,and,1731,315,0.0
5,1,34,1,2,6,321,1718,74,17,94,"packaged,",1735,395,0.0
5,1,34,1,2,7,402,1718,35,14,96,have,1732,437,0.0
5,1,34,1,2,8,443,1718,77,17,92,dangerous,1735,520,0.0
5,1,34,1,2,9,526,1719,44,17,92,gaods,1736,570,0.0
5,1,34,1,2,10,577,1719,42,17,27,safety,1736,619,0.0
5,1,34,1,2,11,626,1719,43,14,94,marks,1733,669,0.0
5,1,34,1,2,12,675,1719,59,17,96,properly,1736,734,0.0
5,1,34,1,2,13,741,1719,47,14,82,affixed,1733,788,0.0
5,1,34,1,2,14,794,1723,14,10,96,or,1733,808,0.0
5,1,34,1,2,15,813,1719,68,18,94,displayed,1737,881,0.0
5,1,34,1,2,16,888,1723,16,10,96,on,1733,904,0.0
5,1,34,1,2,17,910,1720,40,16,96,"them,",1736,950,0.0
2,1,35,0,0,0,1023,1742,438,5,-1,,1747,1461,0.0
3,1,35,1,0,0,1023,1742,438,5,-1,,1747,1461,0.0
4,1,35,1,1,0,1023,1742,438,5,-1,,1747,1461,0.0
5,1,35,1,1,1,1023,1742,438,5,95, ,1747,1461,0.0
2,1,36,0,0,0,1501,1744,3,48,-1,,1792,1504,0.0
3,1,36,1,0,0,1501,1744,3,48,-1,,1792,1504,0.0
4,1,36,1,1,0,1501,1744,3,48,-1,,1792,1504,0.0
5,1,36,1,1,1,1501,1744,3,48,95, ,1792,1504,0.0
2,1,37,0,0,0,93,1796,436,7,-1,,1803,529,0.0
3,1,37,1,0,0,93,1796,436,7,-1,,1803,529,0.0
4,1,37,1,1,0,93,1796,436,7,-1,,1803,529,0.0
5,1,37,1,1,1,93,1796,436,7,95, ,1803,529,0.0
2,1,38,0,0,0,1293,1744,2,85,-1,,1829,1295,0.0
3,1,38,1,0,0,1293,1744,2,85,-1,,1829,1295,0.0
4,1,38,1,1,0,1293,1744,2,85,-1,,1829,1295,0.0
5,1,38,1,1,1,1293,1744,2,85,95, ,1829,1295,0.0
2,1,39,0,0,0,830,1823,798,9,-1,,1832,1628,0.0
3,1,39,1,0,0,830,1823,798,9,-1,,1832,1628,0.0
4,1,39,1,1,0,830,1823,798,9,-1,,1832,1628,0.0
5,1,39,1,1,1,830,1823,798,9,95, ,1832,1628,0.0
2,1,40,0,0,0,813,1865,820,68,-1,,1933,1633,0.0
3,1,40,1,0,0,813,1865,820,68,-1,,1933,1633,0.0
4,1,40,1,1,0,813,1865,820,68,-1,,1933,1633,0.0
5,1,40,1,1,1,813,1865,820,68,95,  ,1933,1633,0.0
5,1,40,1,1,2,1536,1865,97,21,95,  ,1886,1633,0.0
2,1,41,0,0,0,813,1865,627,21,-1,,1886,1440,0.0
3,1,41,1,0,0,813,1865,627,21,-1,,1886,1440,0.0
4,1,41,1,1,0,813,1865,627,21,-1,,1886,1440,0.0
5,1,41,1,1,1,813,1865,512,21,95,  ,1886,1325,0.0
5,1,41,1,1,2,1386,1885,54,1,95, ,1886,1440,0.0
2,1,42,0,0,0,1621,185,16,1725,-1,,1910,1637,0.0
3,1,42,1,0,0,1621,185,16,1725,-1,,1910,1637,0.0
4,1,42,1,1,0,1621,185,16,1725,-1,,1910,1637,0.0
5,1,42,1,1,1,1621,185,16,1725,95, ,1910,1637,0.0
2,1,43,0,0,0,56,1240,10,660,-1,,1900,66,0.0
3,1,43,1,0,0,56,1240,10,660,-1,,1900,66,0.0
4,1,43,1,1,0,56,1240,10,660,-1,,1900,66,0.0
5,1,43,1,1,1,56,1240,10,660,95, ,1900,66,0.0
2,1,44,0,0,0,60,1737,1566,182,-1,,1919,1626,0.0
3,1,44,1,0,0,60,1737,1566,171,-1,,1908,1626,0.0
4,1,44,1,1,0,60,1737,1566,23,-1,,1760,1626,0.0
5,1,44,1,1,1,60,1741,1,3,75,|,1744,61,0.0
5,1,44,1,1,2,73,1737,26,12,75,and,1749,99,0.0
5,1,44,1,1,3,105,1740,22,10,84,are,1750,127,0.0
5,1,44,1,1,4,134,1740,11,9,95,in,1749,145,0.0
5,1,44,1,1,5,151,1737,15,13,84,all,1750,166,0.0
5,1,44,1,1,6,172,1738,61,15,96,respects,1753,233,0.0
5,1,44,1,1,7,240,1741,11,9,96,in,1750,251,0.0
5,1,44,1,1,8,257,1741,46,13,95,proper,1754,303,0.0
5,1,44,1,1,9,309,1738,65,13,94,condition,1751,374,0.0
5,1,44,1,1,10,380,1738,19,13,93,for,1751,399,0.0
5,1,44,1,1,11,404,1739,65,15,96,transport,1754,469,0.0
5,1,44,1,1,12,474,1738,71,17,87,according,1755,545,0.0
5,1,44,1,1,13,551,1740,12,11,89,to,1751,563,0.0
5,1,44,1,1,14,569,1739,23,13,89,the,1752,592,0.0
5,1,44,1,1,15,597,1739,106,16,6,Transportation,1755,703,0.0
5,1,44,1,1,16,709,1740,13,12,96,of,1752,722,0.0
5,1,44,1,1,17,729,1740,79,15,96,Dangerous,1755,808,0.0
5,1,44,1,1,18,815,1740,46,12,94,Goods,1752,861,0.0
5,1,44,1,1,19,868,1740,85,16,93,Regulations,1756,953,0.0
5,1,44,1,1,20,962,1731,9,31,64,|,1762,971,0.0
5,1,44,1,1,21,992,1744,49,14,12,—rigewy,1758,1041,0.0
5,1,44,1,1,22,1134,1748,44,11,74,START,1759,1178,0.0
5,1,44,1,1,23,1184,1748,60,11,92,LOADING,1759,1244,0.0
5,1,44,1,1,24,1327,1748,43,12,76,FINISH,1760,1370,0.0
5,1,44,1,1,25,1376,1748,60,12,76,LOADING,1760,1436,0.0
5,1,44,1,1,26,1520,1745,32,15,6,Time,1760,1552,0.0
5,1,44,1,1,27,1557,1745,30,15,6,our,1760,1587,0.0
5,1,44,1,1,28,1599,1745,27,1,47,|,1746,1626,0.0
4,1,44,1,2,0,142,1762,1439,20,-1,,1782,1581,0.0
5,1,44,1,2,1,142,1762,115,19,95,Yannick,1781,257,0.0
5,1,44,1,2,2,274,1762,115,20,95,Mercier,1782,389,0.0
5,1,44,1,2,3,992,1762,60,10,49,ARRIVEE,1772,1052,0.0
5,1,44,1,2,4,1104,1762,46,11,1,DESUT,1773,1150,0.0
5,1,44,1,2,5,1155,1762,18,11,85,OU,1773,1173,0.0
5,1,44,1,2,6,1178,1762,98,11,89,CHARGEMENT,1773,1276,0.0
5,1,44,1,2,7,1316,1762,20,11,95,FIN,1773,1336,0.0
5,1,44,1,2,8,1342,1762,18,11,91,DU,1773,1360,0.0
5,1,44,1,2,9,1365,1762,98,11,59,CHARGEMENT,1773,1463,0.0
5,1,44,1,2,10,1526,1763,55,10,93,DEPART,1773,1581,0.0
4,1,44,1,3,0,156,1795,1430,33,-1,,1828,1586,0.0
5,1,44,1,3,1,156,1803,56,17,96,Shipper,1820,212,0.0
5,1,44,1,3,2,220,1790,33,39,96,name,1829,253,0.0
5,1,44,1,3,3,262,1790,53,39,23,(please,1829,315,0.0
5,1,44,1,3,4,322,1804,37,17,77,print),1821,359,0.0
5,1,44,1,3,5,437,1800,3,1,1,:,1801,440,0.0
5,1,44,1,3,6,959,1819,2,8,84,|,1827,961,0.0
5,1,44,1,3,7,974,1796,78,19,59,03:19,1815,1052,0.0
5,1,44,1,3,8,1142,1797,77,18,95,03:25,1815,1219,0.0
5,1,44,1,3,9,1342,1798,78,18,95,03:49,1816,1420,0.0
5,1,44,1,3,10,1502,1795,33,33,61,|03,1828,1535,0.0
5,1,44,1,3,11,1545,1798,41,18,59,249,1816,1586,0.0
4,1,44,1,4,0,60,1825,1510,21,-1,,1846,1570,0.0
5,1,44,1,4,1,60,1826,1,3,0,_,1829,61,0.0
5,1,44,1,4,2,73,1828,61,13,65,ORIVER,1841,134,0.0
5,1,44,1,4,3,140,1828,57,13,89,NAME,1841,197,0.0
5,1,44,1,4,4,191,1821,8,30,89,-,1851,199,0.0
5,1,44,1,4,5,203,1829,37,13,96,NOM,1842,240,0.0
5,1,44,1,4,6,247,1829,21,13,93,DU,1842,268,0.0
5,1,44,1,4,7,274,1829,117,14,87,CONDUCTEUR,1843,391,0.0
5,1,44,1,4,8,436,1825,12,1,0,~,1826,448,0.0
5,1,44,1,4,9,512,1825,11,2,0,~,1827,523,0.0
5,1,44,1,4,10,594,1830,60,13,90,ORIVER,1843,654,0.0
5,1,44,1,4,11,661,1830,47,13,90,NUMB,1843,708,0.0
5,1,44,1,4,12,769,1826,57,18,80,DRIVER,1844,826,0.0
5,1,44,1,4,13,834,1831,73,15,40,SJBNATUBE,1846,907,0.0
5,1,44,1,4,14,936,1838,4,3,89,-,1841,940,0.0
5,1,44,1,4,15,946,1832,96,13,92,SIGNATURE,1845,1042,0.0
5,1,44,1,4,16,1049,1827,145,18,34,DUCO@NDUCTEUR,1845,1194,0.0
5,1,44,1,4,17,1257,1828,7,1,33,|,1829,1264,0.0
5,1,44,1,4,18,1274,1828,60,17,26,TOTAL,1845,1334,0.0
5,1,44,1,4,19,1340,1832,83,14,49,QUANTITY,1846,1423,0.0
5,1,44,1,4,20,1429,1840,4,2,49,-,1842,1433,0.0
5,1,44,1,4,21,1439,1832,61,14,93,QUANT.,1846,1500,0.0
5,1,44,1,4,22,1506,1832,64,14,93,TOTALE,1846,1570,0.0
4,1,44,1,5,0,579,1832,886,30,-1,,1862,1465,0.0
5,1,44,1,5,1,579,1844,20,14,49,No,1858,599,0.0
5,1,44,1,5,2,606,1844,21,14,49,BU,1858,627,0.0
5,1,44,1,5,3,634,1844,117,14,38,"CONDUCTEUR,",1858,751,0.0
5,1,44,1,5,4,791,1849,5,7,0,OY!,1856,796,0.0
5,1,44,1,5,5,837,1832,12,28,45,9),1860,849,0.0
5,1,44,1,5,6,1462,1858,3,4,0,:,1862,1465,0.0
4,1,44,1,6,0,1325,1858,211,19,-1,,1877,1536,0.0
5,1,44,1,6,1,1325,1858,61,19,96,4400,1877,1386,0.0
5,1,44,1,6,2,1440,1860,96,17,96,Litres,1877,1536,0.0
4,1,44,1,7,0,142,1876,1275,43,-1,,1919,1417,0.0
5,1,44,1,7,1,142,1886,131,18,20,GHISLAIN,1904,273,0.0
5,1,44,1,7,2,324,1888,114,17,53,LAPRISE,1905,438,0.0
5,1,44,1,7,3,780,1876,43,43,50,lal,1919,823,0.0
5,1,44,1,7,4,1291,1889,78,18,53,38617,1907,1369,0.0
5,1,44,1,7,5,1394,1895,23,12,53,kg,1907,1417,0.0
2,1,45,0,0,0,751,1826,3,75,-1,,1901,754,0.0
3,1,45,1,0,0,751,1826,3,75,-1,,1901,754,0.0
4,1,45,1,1,0,751,1826,3,75,-1,,1901,754,0.0
5,1,45,1,1,1,751,1826,3,75,95, ,1901,754,0.0
2,1,46,0,0,0,54,1865,706,68,-1,,1933,760,0.0
3,1,46,1,0,0,54,1865,706,68,-1,,1933,760,0.0
4,1,46,1,1,0,54,1865,706,68,-1,,1933,760,0.0
5,1,46,1,1,1,54,1865,706,68,95, ,1933,760,0.0
2,1,47,0,0,0,82,1916,1524,59,-1,,1975,1606,0.0
3,1,47,1,0,0,82,1916,1524,55,-1,,1971,1606,0.0
4,1,47,1,1,0,82,1916,1524,26,-1,,1942,1606,0.0
5,1,47,1,1,1,82,1916,67,12,85,PRODUCT,1928,149,0.0
5,1,47,1,1,2,164,1911,10,28,16,|,1939,174,0.0
5,1,47,1,1,3,175,1917,36,11,16,TANK,1928,211,0.0
5,1,47,1,1,4,216,1917,67,11,69,CAPACITY|,1928,283,0.0
5,1,47,1,1,5,290,1918,49,11,93,WATER,1929,339,0.0
5,1,47,1,1,6,345,1918,84,11,43,DIP/SEFORE,1929,429,0.0
5,1,47,1,1,7,434,1918,31,11,76,DIPS|,1929,465,0.0
5,1,47,1,1,8,484,1918,56,12,94,BEFORE,1930,540,0.0
5,1,47,1,1,9,546,1918,49,12,94,INVENT,1930,595,0.0
5,1,47,1,1,10,605,1911,10,28,81,|,1939,615,0.0
5,1,47,1,1,11,620,1919,45,11,90,AFTER,1930,665,0.0
5,1,47,1,1,12,671,1919,30,11,60,DIPS),1930,701,0.0
5,1,47,1,1,13,713,1919,51,11,83,ENDING,1930,764,0.0
5,1,47,1,1,14,771,1920,49,10,95,INVENT,1930,820,0.0
5,1,47,1,1,15,864,1920,68,11,96,PRODUCT,1931,932,0.0
5,1,47,1,1,16,1072,1920,50,11,92,WATER,1931,1122,0.0
5,1,47,1,1,17,1127,1920,26,22,10,Di?),1942,1153,0.0
5,1,47,1,1,18,1159,1920,55,12,94,BEFORE,1932,1214,0.0
5,1,47,1,1,19,1220,1920,31,12,55,DIPS,1932,1251,0.0
5,1,47,1,1,20,1260,1913,9,33,95,|,1946,1269,0.0
5,1,47,1,1,21,1276,1920,56,12,48,BEFORE,1932,1332,0.0
5,1,47,1,1,22,1337,1921,50,11,32,INVENT,1932,1387,0.0
5,1,47,1,1,23,1392,1913,6,33,96,|,1946,1398,0.0
5,1,47,1,1,24,1403,1921,45,11,87,AFTER,1932,1448,0.0
5,1,47,1,1,25,1454,1921,30,11,69,DIPS),1932,1484,0.0
5,1,47,1,1,26,1498,1921,52,11,94,ENDING,1932,1550,0.0
5,1,47,1,1,27,1556,1922,50,10,96,INVENT,1932,1606,0.0
4,1,47,1,2,0,84,1934,1510,19,-1,,1953,1594,0.0
5,1,47,1,2,1,84,1934,61,10,87,PRODUIT,1944,145,0.0
5,1,47,1,2,2,164,1926,7,28,55,|,1954,171,0.0
5,1,47,1,2,3,178,1934,95,11,48,CONTENANCE,1945,273,0.0
5,1,47,1,2,4,283,1926,10,28,94,|,1954,293,0.0
5,1,47,1,2,5,294,1934,67,12,93,MEASURE,1946,361,0.0
5,1,47,1,2,6,369,1926,5,28,88,|,1954,374,0.0
5,1,47,1,2,7,384,1935,46,11,38,AVANT,1946,430,0.0
5,1,47,1,2,8,435,1935,15,11,38,LE,1946,450,0.0
5,1,47,1,2,9,498,1936,82,10,92,INVENTAIRE,1946,580,0.0
5,1,47,1,2,10,626,1936,66,11,86,APRESLE,1947,692,0.0
5,1,47,1,2,11,699,1928,14,28,41,|,1956,713,0.0
5,1,47,1,2,12,727,1936,81,11,65,INVENTAIRE,1947,808,0.0
5,1,47,1,2,13,867,1936,61,11,85,PRODUIT,1947,928,0.0
5,1,47,1,2,14,944,1929,10,28,77,|,1957,954,0.0
5,1,47,1,2,15,958,1936,96,12,77,CONTENANCE,1948,1054,0.0
5,1,47,1,2,16,1063,1929,10,28,64,|,1957,1073,0.0
5,1,47,1,2,17,1075,1937,67,11,64,MEASURE,1948,1142,0.0
5,1,47,1,2,18,1151,1944,2,9,78,|,1953,1153,0.0
5,1,47,1,2,19,1170,1938,46,10,61,AVANT,1948,1216,0.0
5,1,47,1,2,20,1221,1938,15,10,61,LE,1948,1236,0.0
5,1,47,1,2,21,1290,1938,82,11,88,INVENTAIRE,1949,1372,0.0
5,1,47,1,2,22,1391,1930,10,28,84,|,1958,1401,0.0
5,1,47,1,2,23,1409,1938,66,11,78,APRESLE,1949,1475,0.0
5,1,47,1,2,24,1482,1930,10,28,20,|,1958,1492,0.0
5,1,47,1,2,25,1512,1938,82,11,20, INVENTAIRE,1949,1594,0.0
4,1,47,1,3,0,125,1944,1446,31,-1,,1975,1571,0.0
5,1,47,1,3,1,125,1966,35,1,0,___,1967,160,0.0
5,1,47,1,3,2,169,1944,24,24,0,[OU,1968,193,0.0
5,1,47,1,3,3,197,1950,82,17,47,RESeRviOR,1967,279,0.0
5,1,47,1,3,4,382,1952,74,11,43,JAUGEAGE,1963,456,0.0
5,1,47,1,3,5,503,1952,75,11,59,SAUGEAGE,1963,578,0.0
5,1,47,1,3,6,612,1954,3,17,37,|,1971,615,0.0
5,1,47,1,3,7,620,1952,74,17,33,VAUGEAGE,1969,694,0.0
5,1,47,1,3,8,956,1954,18,10,73,DU,1964,974,0.0
5,1,47,1,3,9,980,1954,79,10,73,RESERVIOR,1964,1059,0.0
5,1,47,1,3,10,1065,1946,11,29,58,|,1975,1076,0.0
5,1,47,1,3,11,1086,1954,38,17,37,_DEAU,1971,1124,0.0
5,1,47,1,3,12,1167,1946,75,29,90,JAUGEAGE,1975,1242,0.0
5,1,47,1,3,13,1295,1954,75,11,91,JAUGEAGE,1965,1370,0.0
5,1,47,1,3,14,1386,1946,15,28,67,|,1974,1401,0.0
5,1,47,1,3,15,1403,1954,75,11,48,JAUGEAGE,1965,1478,0.0
5,1,47,1,3,16,1525,1955,46,16,32,APRES,1971,1571,0.0
2,1,48,0,0,0,1120,1965,469,8,-1,,1973,1589,0.0
3,1,48,1,0,0,1120,1965,469,8,-1,,1973,1589,0.0
4,1,48,1,1,0,1120,1965,469,8,-1,,1973,1589,0.0
5,1,48,1,1,1,1120,1965,469,8,95, ,1973,1589,0.0
2,1,49,0,0,0,296,1965,621,6,-1,,1971,917,0.0
3,1,49,1,0,0,296,1965,621,6,-1,,1971,917,0.0
4,1,49,1,1,0,296,1965,621,6,-1,,1971,917,0.0
5,1,49,1,1,1,296,1965,621,6,95, ,1971,917,0.0
2,1,50,0,0,0,1023,2028,519,7,-1,,2035,1542,0.0
3,1,50,1,0,0,1023,2028,519,7,-1,,2035,1542,0.0
4,1,50,1,1,0,1023,2028,519,7,-1,,2035,1542,0.0
5,1,50,1,1,1,1023,2028,519,7,95, ,2035,1542,0.0
2,1,51,0,0,0,68,2025,327,6,-1,,2031,395,0.0
3,1,51,1,0,0,68,2025,327,6,-1,,2031,395,0.0
4,1,51,1,1,0,68,2025,327,6,-1,,2031,395,0.0
5,1,51,1,1,1,68,2025,327,6,95, ,2031,395,0.0
2,1,52,0,0,0,203,2085,1257,12,-1,,2097,1460,0.0
3,1,52,1,0,0,203,2085,1257,12,-1,,2097,1460,0.0
4,1,52,1,1,0,203,2085,1257,12,-1,,2097,1460,0.0
5,1,52,1,1,1,203,2085,1257,12,95, ,2097,1460,0.0
2,1,53,0,0,0,479,2086,981,11,-1,,2097,1460,0.0
3,1,53,1,0,0,479,2086,981,11,-1,,2097,1460,0.0
4,1,53,1,1,0,479,2086,981,11,-1,,2097,1460,0.0
5,1,53,1,1,1,479,2086,981,11,95, ,2097,1460,0.0
2,1,54,0,0,0,368,1914,3,222,-1,,2136,371,0.0
3,1,54,1,0,0,368,1914,3,222,-1,,2136,371,0.0
4,1,54,1,1,0,368,1914,3,222,-1,,2136,371,0.0
5,1,54,1,1,1,368,1914,3,222,95, ,2136,371,0.0
2,1,55,0,0,0,1395,1859,4,288,-1,,2147,1399,0.0
3,1,55,1,0,0,1395,1859,4,288,-1,,2147,1399,0.0
4,1,55,1,1,0,1395,1859,4,288,-1,,2147,1399,0.0
5,1,55,1,1,1,1395,1859,4,288,95, ,2147,1399,0.0
2,1,56,0,0,0,1393,1889,8,258,-1,,2147,1401,0.0
3,1,56,1,0,0,1393,1889,8,258,-1,,2147,1401,0.0
4,1,56,1,1,0,1393,1889,8,258,-1,,2147,1401,0.0
5,1,56,1,1,1,1393,1889,8,258,95, ,2147,1401,0.0
2,1,57,0,0,0,1066,1913,4,238,-1,,2151,1070,0.0
3,1,57,1,0,0,1066,1913,4,238,-1,,2151,1070,0.0
4,1,57,1,1,0,1066,1913,4,238,-1,,2151,1070,0.0
5,1,57,1,1,1,1066,1913,4,238,95, ,2151,1070,0.0
2,1,58,0,0,0,701,1912,3,239,-1,,2151,704,0.0
3,1,58,1,0,0,701,1912,3,239,-1,,2151,704,0.0
4,1,58,1,1,0,701,1912,3,239,-1,,2151,704,0.0
5,1,58,1,1,1,701,1912,3,239,95, ,2151,704,0.0
2,1,59,0,0,0,1261,1917,3,235,-1,,2152,1264,0.0
3,1,59,1,0,0,1261,1917,3,235,-1,,2152,1264,0.0
4,1,59,1,1,0,1261,1917,3,235,-1,,2152,1264,0.0
5,1,59,1,1,1,1261,1917,3,235,95,,2152,1264,0.0
1,1,0,0,0,0,0,0,1700,2200,-1,,2200,1700,0.0
2,1,1,0,0,0,904,89,612,23,-1,,112,1516,0.0
3,1,1,1,0,0,904,89,612,23,-1,,112,1516,0.0
4,1,1,1,1,0,904,89,612,23,-1,,112,1516,0.0
5,1,1,1,1,1,904,89,116,22,96,VEHICLE,111,1020,0.0
5,1,1,1,1,2,1032,89,120,23,95,LOADING,112,1152,0.0
5,1,1,1,1,3,1165,90,113,22,93,REPORT,112,1278,0.0
5,1,1,1,1,4,1287,102,7,2,92,-,104,1294,0.0
5,1,1,1,1,5,1306,90,54,22,48,BILL,112,1360,0.0
5,1,1,1,1,6,1369,90,36,22,93,OF,112,1405,0.0
5,1,1,1,1,7,1416,90,100,22,91,LADING,112,1516,0.0
2,1,2,0,0,0,1154,142,468,3,-1,,145,1622,0.0
3,1,2,1,0,0,1154,142,468,3,-1,,145,1622,0.0
4,1,2,1,1,0,1154,142,468,3,-1,,145,1622,0.0
5,1,2,1,1,1,1154,142,468,3,95, ,145,1622,0.0
2,1,3,0,0,0,68,234,359,3,-1,,237,427,0.0
3,1,3,1,0,0,68,234,359,3,-1,,237,427,0.0
4,1,3,1,1,0,68,234,359,3,-1,,237,427,0.0
5,1,3,1,1,1,68,234,359,3,95, ,237,427,0.0
2,1,4,0,0,0,815,238,630,2,-1,,240,1445,0.0
3,1,4,1,0,0,815,238,630,2,-1,,240,1445,0.0
4,1,4,1,1,0,815,238,630,2,-1,,240,1445,0.0
5,1,4,1,1,1,815,238,630,2,95, ,240,1445,0.0
2,1,5,0,0,0,56,117,1565,296,-1,,413,1621,0.0
3,1,5,1,0,0,96,117,1525,27,-1,,144,1621,0.0
4,1,5,1,1,0,96,117,1525,27,-1,,144,1621,0.0
5,1,5,1,1,1,96,121,119,21,31,page:,142,215,0.0
5,1,5,1,1,2,240,120,12,18,94,1,138,252,0.0
5,1,5,1,1,3,440,121,77,23,26,530,144,517,0.0
5,1,5,1,1,4,715,142,61,2,20,_____,144,776,0.0
5,1,5,1,1,5,809,117,129,26,96,RAPPORT,143,938,0.0
5,1,5,1,1,6,950,118,34,26,93,DE,144,984,0.0
5,1,5,1,1,7,995,118,626,26,91,CHARGEMENT,144,1621,0.0
5,1,5,1,1,8,1194,103,16,45,89,-,148,1210,0.0
5,1,5,1,1,9,1224,103,125,45,91,VEHICULE,148,1349,0.0
5,1,5,1,1,10,1363,103,20,45,91,-,148,1383,0.0
5,1,5,1,1,11,1397,118,224,26,92,CONNAISSEMENT,144,1621,0.0
3,1,5,2,0,0,129,145,536,25,-1,,170,665,0.0
4,1,5,2,1,0,129,145,536,25,-1,,170,665,0.0
5,1,5,2,1,1,129,148,110,15,95,DOCUMENT,163,239,0.0
5,1,5,2,1,2,246,149,81,15,82,NUMBER,164,327,0.0
5,1,5,2,1,3,356,149,61,18,82,6409,167,417,0.0
5,1,5,2,1,4,529,145,136,25,54,DATE,170,665,0.0
5,1,5,2,1,5,573,141,4,39,33,B,180,577,0.0
5,1,5,2,1,6,583,145,82,25,45,EXPEDITION,170,665,0.0
3,1,5,3,0,0,57,157,1564,83,-1,,240,1621,0.0
4,1,5,3,1,0,57,157,1547,57,-1,,214,1604,0.0
5,1,5,3,1,1,57,157,94,24,0,ge,181,151,0.0
5,1,5,3,1,2,159,167,144,14,0,bUEQCUMENT,181,303,0.0
5,1,5,3,1,3,515,166,138,48,24,mm/dd/yy,214,653,0.0
5,1,5,3,1,4,793,181,29,20,96,24,201,822,0.0
5,1,5,3,1,5,833,180,77,22,96,HOUR,202,910,0.0
5,1,5,3,1,6,921,181,117,21,84,NUMBER,202,1038,0.0
5,1,5,3,1,7,1060,179,206,20,53,_(613)996-6666,199,1266,0.0
5,1,5,3,1,8,1304,193,7,2,58,-,195,1311,0.0
5,1,5,3,1,9,1322,181,120,22,95,NUMERO,203,1442,0.0
5,1,5,3,1,10,1452,182,29,20,95,24,202,1481,0.0
5,1,5,3,1,11,1492,181,112,22,95,HEURES,203,1604,0.0
4,1,5,3,2,0,141,207,1480,33,-1,,240,1621,0.0
5,1,5,3,2,1,141,207,110,19,94,0362440,226,251,1.0
5,1,5,3,2,2,273,208,94,19,69,10/006,227,367,0.0
5,1,5,3,2,3,438,216,45,22,26,"==,",238,483,0.0
5,1,5,3,2,4,522,208,128,20,29,10/07/24,228,650,2.0
5,1,5,3,2,5,747,217,5,22,96,|,239,752,0.0
5,1,5,3,2,6,1042,211,344,29,43,COLLECT-FRAISVIRES,240,1386,0.0
5,1,5,3,2,7,1599,239,22,1,2,a,240,1621,0.0
3,1,5,4,0,0,56,235,1554,149,-1,,384,1610,0.0
4,1,5,4,1,0,56,235,1551,29,-1,,264,1607,0.0
5,1,5,4,1,1,56,235,3,2,92,|,237,59,0.0
5,1,5,4,1,2,70,239,397,15,84,CONSIGNEE/CUSTOMER,254,467,0.0
5,1,5,4,1,3,270,228,10,35,86,-,263,280,0.0
5,1,5,4,1,4,288,239,179,15,51,DESTINATAIRE/CLIENT,254,467,0.0
5,1,5,4,1,5,681,230,67,37,6,[OCATION,267,748,0.0
5,1,5,4,1,6,757,230,56,37,86,NUMBER,267,813,0.0
5,1,5,4,1,7,834,252,1,11,53,|,263,835,0.0
5,1,5,4,1,8,856,241,222,14,90,GONSIGNOR,255,1078,0.0
5,1,5,4,1,9,960,230,10,37,92,-,267,970,0.0
5,1,5,4,1,10,979,241,99,14,93,EXPEDITEUR,255,1078,0.0
5,1,5,4,1,11,1444,238,163,26,29,haa,264,1607,0.0
5,1,5,4,1,12,1527,234,33,36,0,ice,270,1560,0.0
5,1,5,4,1,13,1563,238,44,26,0,st,264,1607,0.0
4,1,5,4,2,0,140,271,1443,19,-1,,290,1583,0.0
5,1,5,4,2,1,140,271,80,17,92,PETRO,288,220,0.0
5,1,5,4,2,2,238,271,99,17,96,CANADA,288,337,0.0
5,1,5,4,2,3,354,271,163,18,96,LUBRICANTS,289,517,0.0
5,1,5,4,2,4,538,271,46,18,96,INC,289,584,0.0
5,1,5,4,2,5,673,271,160,19,92,0005064508,290,833,0.0
5,1,5,4,2,6,854,272,97,18,92,|SUNCOR,290,951,0.0
5,1,5,4,2,7,970,272,98,18,96,ENERGY,290,1068,0.0
5,1,5,4,2,8,1085,272,133,18,96,MONTREAL,290,1218,0.0
5,1,5,4,2,9,1472,271,111,19,95,0082041,290,1583,0.0
4,1,5,4,3,0,140,300,1470,22,-1,,322,1610,0.0
5,1,5,4,3,1,140,301,61,18,91,PCLI,319,201,0.0
5,1,5,4,3,2,224,309,11,3,91,-,312,235,0.0
5,1,5,4,3,3,255,301,96,21,95,QUEBEC,322,351,0.0
5,1,5,4,3,4,372,301,44,19,96,302,320,416,0.0
5,1,5,4,3,5,672,301,160,19,90,0009406423,320,832,0.0
5,1,5,4,3,6,854,302,78,18,62,|11675,320,932,0.0
5,1,5,4,3,7,953,307,48,14,96,rue,321,1001,0.0
5,1,5,4,3,8,1020,301,164,20,96,Sherbrooke,321,1184,0.0
5,1,5,4,3,9,1204,304,46,17,96,est,321,1250,0.0
5,1,5,4,3,10,1488,300,17,2,0,OS,302,1505,0.0
4,1,5,4,4,0,140,331,1342,25,-1,,356,1482,0.0
5,1,5,4,4,1,140,331,45,19,96,385,350,185,0.0
5,1,5,4,4,2,206,333,147,17,96,SOUTHDOWN,350,353,0.0
5,1,5,4,4,3,370,333,65,18,96,ROAD,351,435,0.0
5,1,5,4,4,4,851,333,143,21,95,"Montreal,",354,994,0.0
5,1,5,4,4,5,1020,335,30,21,90,QC,356,1050,0.0
5,1,5,4,4,6,1069,334,49,18,79,H1B,352,1118,0.0
5,1,5,4,4,7,1138,333,44,19,32,1c3,352,1182,0.0
5,1,5,4,4,8,1276,334,68,21,61,(613),355,1344,0.0
5,1,5,4,4,9,1357,334,125,18,69,996-6666,352,1482,0.0
4,1,5,4,5,0,138,363,377,21,-1,,384,515,0.0
5,1,5,4,5,1,138,363,191,21,96,"MISSISSAUGA,",384,329,0.0
5,1,5,4,5,2,354,363,32,18,91,ON,381,386,0.0
5,1,5,4,5,3,404,363,48,19,88,L5J,382,452,0.0
5,1,5,4,5,4,471,363,44,19,83,2Y3,382,515,0.0
3,1,5,5,0,0,852,393,248,20,-1,,413,1100,0.0
4,1,5,5,1,0,852,393,248,20,-1,,413,1100,0.0
5,1,5,5,1,1,852,393,115,19,96,Yannick,412,967,0.0
5,1,5,5,1,2,984,393,116,20,95,Mercier,413,1100,0.0
2,1,6,0,0,0,845,237,3,172,-1,,409,848,0.0
3,1,6,1,0,0,845,237,3,172,-1,,409,848,0.0
4,1,6,1,1,0,845,237,3,172,-1,,409,848,0.0
5,1,6,1,1,1,845,237,3,172,95, ,409,848,0.0
2,1,7,0,0,0,232,479,615,5,-1,,484,847,0.0
3,1,7,1,0,0,232,479,615,5,-1,,484,847,0.0
4,1,7,1,1,0,232,479,615,5,-1,,484,847,0.0
5,1,7,1,1,1,232,479,615,5,95, ,484,847,0.0
2,1,8,0,0,0,786,522,494,3,-1,,525,1280,0.0
3,1,8,1,0,0,786,522,494,3,-1,,525,1280,0.0
4,1,8,1,1,0,786,522,494,3,-1,,525,1280,0.0
5,1,8,1,1,1,786,522,494,3,95, ,525,1280,0.0
2,1,9,0,0,0,56,344,1,309,-1,,653,57,0.0
3,1,9,1,0,0,56,344,1,309,-1,,653,57,0.0
4,1,9,1,1,0,56,344,1,309,-1,,653,57,0.0
5,1,9,1,1,1,56,344,1,309,95, ,653,57,0.0
2,1,10,0,0,0,706,482,2,194,-1,,676,708,0.0
3,1,10,1,0,0,706,482,2,194,-1,,676,708,0.0
4,1,10,1,1,0,706,482,2,194,-1,,676,708,0.0
5,1,10,1,1,1,706,482,2,194,95, ,676,708,0.0
2,1,11,0,0,0,672,674,362,3,-1,,677,1034,0.0
3,1,11,1,0,0,672,674,362,3,-1,,677,1034,0.0
4,1,11,1,1,0,672,674,362,3,-1,,677,1034,0.0
5,1,11,1,1,1,672,674,362,3,95, ,677,1034,0.0
2,1,12,0,0,0,1429,676,56,2,-1,,678,1485,0.0
3,1,12,1,0,0,1429,676,56,2,-1,,678,1485,0.0
4,1,12,1,1,0,1429,676,56,2,-1,,678,1485,0.0
5,1,12,1,1,1,1429,676,56,2,95, ,678,1485,0.0
2,1,13,0,0,0,56,413,1565,320,-1,,733,1621,0.0
3,1,13,1,0,0,56,413,1565,310,-1,,723,1621,0.0
4,1,13,1,1,0,272,413,575,17,-1,,430,847,0.0
5,1,13,1,1,1,272,415,61,12,89,RELEASE,427,333,0.0
5,1,13,1,1,2,338,409,52,27,77,(C-of-A),436,390,0.0
5,1,13,1,1,3,396,413,54,15,96,NUMBER,428,450,0.0
5,1,13,1,1,4,562,417,78,11,96,CUSTOMER,428,640,0.0
5,1,13,1,1,5,645,417,76,11,96,PURCHASE,428,721,0.0
5,1,13,1,1,6,725,417,49,11,94,ORDER,428,774,0.0
5,1,13,1,1,7,780,417,59,11,94,NUMBER,428,839,0.0
5,1,13,1,1,8,845,413,2,3,95,|,416,847,0.0
4,1,13,1,2,0,612,431,190,11,-1,,442,802,0.0
5,1,13,1,2,1,612,431,16,11,78,No,442,628,0.0
5,1,13,1,2,2,633,431,18,11,65,OF,442,651,0.0
5,1,13,1,2,3,657,431,67,11,96,DEMANDE,442,724,0.0
5,1,13,1,2,4,730,431,18,11,77,DU,442,748,0.0
5,1,13,1,2,5,753,431,49,11,96,CLIENT,442,802,0.0
4,1,13,1,3,0,69,480,368,23,-1,,503,437,0.0
5,1,13,1,3,1,69,490,73,13,91,CARRIER,503,142,0.0
5,1,13,1,3,2,148,497,5,2,91,-,499,153,0.0
5,1,13,1,3,3,158,480,136,23,89,TRANSPORTEUR,503,294,0.0
5,1,13,1,3,4,376,481,12,1,0,a,482,388,0.0
4,1,13,1,4,0,138,514,1371,29,-1,,543,1509,0.0
5,1,13,1,4,1,138,514,48,17,96,GEO,531,186,0.0
5,1,13,1,4,2,204,515,17,16,94,A,531,221,0.0
5,1,13,1,4,3,237,515,65,16,94,HALL,531,302,0.0
5,1,13,1,4,4,571,514,111,18,66,9201535,532,682,0.0
5,1,13,1,4,5,700,510,14,42,44,|,552,714,0.0
5,1,13,1,4,6,728,523,145,20,0,VehicleNUWAER,543,873,0.0
5,1,13,1,4,7,916,530,70,13,64,LICENSE,543,986,0.0
5,1,13,1,4,8,992,530,70,13,96,NUMBER,543,1062,0.0
5,1,13,1,4,9,1125,530,79,13,94,ADDRESS,543,1204,0.0
5,1,13,1,4,10,1210,530,22,13,96,OF,543,1232,0.0
5,1,13,1,4,11,1242,519,49,34,96,METER,553,1291,0.0
5,1,13,1,4,12,1302,523,32,20,93,AND,543,1334,0.0
5,1,13,1,4,13,1340,523,71,20,95,TRADER,543,1411,0.0
5,1,13,1,4,14,1504,524,5,1,0,-,525,1509,0.0
4,1,13,1,5,0,140,542,1332,23,-1,,565,1472,0.0
5,1,13,1,5,1,140,542,61,19,92,8800,561,201,0.0
5,1,13,1,5,2,223,552,11,2,86,-,554,234,0.0
5,1,13,1,5,3,256,543,29,18,88,6E,561,285,0.0
5,1,13,1,5,4,304,544,147,18,88,CROISSANT,562,451,0.0
5,1,13,1,5,5,731,552,19,12,96,No,564,750,0.0
5,1,13,1,5,6,757,552,21,12,92,DU,564,778,0.0
5,1,13,1,5,7,785,552,81,13,89,VEHICULE,565,866,0.0
5,1,13,1,5,8,916,552,71,13,96,NOMBRE,565,987,0.0
5,1,13,1,5,9,994,552,21,13,90,DE,565,1015,0.0
5,1,13,1,5,10,1022,552,62,13,90,PERMIS,565,1084,0.0
5,1,13,1,5,11,1090,544,11,31,91,|,575,1101,0.0
5,1,13,1,5,12,1111,552,91,13,75,L'ADRESSE,565,1202,0.0
5,1,13,1,5,13,1208,552,22,13,96,DE,565,1230,0.0
5,1,13,1,5,14,1236,552,56,13,96,METRE,565,1292,0.0
5,1,13,1,5,15,1299,552,20,13,95,ET,565,1319,0.0
5,1,13,1,5,16,1325,552,21,13,91,DE,565,1346,0.0
5,1,13,1,5,17,1352,552,120,13,91,COMMERCANT,565,1472,0.0
4,1,13,1,6,0,133,569,1367,33,-1,,602,1500,0.0
5,1,13,1,6,1,133,569,86,33,95,ANJOU,602,219,0.0
5,1,13,1,6,2,587,597,11,1,37,_,598,598,0.0
5,1,13,1,6,3,721,574,62,19,96,1134,593,783,0.0
5,1,13,1,6,4,1104,575,78,18,96,11675,593,1182,0.0
5,1,13,1,6,5,1203,580,47,14,95,rue,594,1250,0.0
5,1,13,1,6,6,1271,575,163,19,96,Sherbrooke,594,1434,0.0
5,1,13,1,6,7,1454,578,46,16,96,est,594,1500,0.0
4,1,13,1,7,0,138,602,1294,33,-1,,635,1432,0.0
5,1,13,1,7,1,138,604,48,18,34,HlJ,622,186,0.0
5,1,13,1,7,2,206,604,45,18,68,1Al,622,251,0.0
5,1,13,1,7,3,470,632,1,3,86,|,635,471,0.0
5,1,13,1,7,4,483,602,31,26,0,Cee,628,514,0.0
5,1,13,1,7,5,527,603,18,25,49,OU,628,545,0.0
5,1,13,1,7,6,554,602,109,26,5,raanseonteun,628,663,0.0
5,1,13,1,7,7,721,605,61,19,96,1069,624,782,0.0
5,1,13,1,7,8,1101,606,143,21,96,"Montreal,",627,1244,0.0
5,1,13,1,7,9,1270,607,30,21,90,QC,628,1300,0.0
5,1,13,1,7,10,1319,606,48,18,90,H1B,624,1367,0.0
5,1,13,1,7,11,1387,606,45,19,25,1C3,625,1432,0.0
4,1,13,1,8,0,144,634,1171,24,-1,,658,1315,0.0
5,1,13,1,8,1,144,634,206,21,91,(514)352-5550,655,350,0.0
5,1,13,1,8,2,1109,637,68,21,75,(613),658,1177,0.0
5,1,13,1,8,3,1190,637,125,19,75,996-6666,656,1315,0.0
4,1,13,1,9,0,56,664,1565,18,-1,,682,1621,0.0
5,1,13,1,9,1,56,664,1,11,65,|,675,57,0.0
5,1,13,1,9,2,144,674,65,1,4,——,675,209,0.0
5,1,13,1,9,3,628,675,5,1,48,=,676,633,0.0
5,1,13,1,9,4,1045,675,10,1,67,=,676,1055,0.0
5,1,13,1,9,5,1172,676,105,6,22,"——,",682,1277,0.0
5,1,13,1,9,6,1376,677,38,1,0,a,678,1414,0.0
5,1,13,1,9,7,1491,676,130,2,5,———,678,1621,0.0
4,1,13,1,10,0,1155,686,93,14,-1,,700,1248,0.0
5,1,13,1,10,1,1155,686,93,14,96,MEASURED,700,1248,0.0
4,1,13,1,11,0,69,684,1521,33,-1,,717,1590,0.0
5,1,13,1,11,1,69,684,13,33,33,Pl,717,82,0.0
5,1,13,1,11,2,153,695,58,12,62,iMETER,707,211,0.0
5,1,13,1,11,3,1312,697,92,13,44,ORRECTED,710,1404,0.0
5,1,13,1,11,4,1412,687,12,33,95,|,720,1424,0.0
5,1,13,1,11,5,1432,698,46,12,95,TEMP,710,1478,0.0
5,1,13,1,11,6,1489,687,12,33,92,|,720,1501,0.0
5,1,13,1,11,7,1520,698,70,13,92,DENSITY,711,1590,0.0
4,1,13,1,12,0,80,694,1230,39,-1,,733,1310,0.0
5,1,13,1,12,1,80,694,120,14,37,ROOUCTIMETE,708,200,0.0
5,1,13,1,12,2,362,709,77,13,96,PRODUCT,722,439,0.0
5,1,13,1,12,3,448,701,107,31,93,DESCRIPTION,732,555,0.0
5,1,13,1,12,4,564,710,6,12,92,-,722,570,0.0
5,1,13,1,12,5,582,701,106,31,96,DESCRIPTION,732,688,0.0
5,1,13,1,12,6,696,710,21,13,91,DU,723,717,0.0
5,1,13,1,12,7,727,701,71,31,95,PRODUIT,732,798,0.0
5,1,13,1,12,8,1169,701,57,32,94,LITRES,733,1226,0.0
5,1,13,1,12,9,1300,697,10,14,6,°,711,1310,0.0
2,1,14,0,0,0,69,718,1520,31,-1,,749,1589,0.0
3,1,14,1,0,0,69,718,1520,31,-1,,749,1589,0.0
4,1,14,1,1,0,69,718,1520,31,-1,,749,1589,0.0
5,1,14,1,1,1,69,718,135,25,92,PROCUIT/METER,743,204,0.0
5,1,14,1,1,2,1155,724,92,13,52,MESUREES,737,1247,0.0
5,1,14,1,1,3,1324,724,62,13,83,TO15C,737,1386,0.0
5,1,14,1,1,4,1413,740,3,9,84,|,749,1416,0.0
5,1,14,1,1,5,1425,724,67,13,84,CELSIUS,737,1492,0.0
5,1,14,1,1,6,1520,724,69,14,91,DENSITE,738,1589,0.0
2,1,15,0,0,0,136,745,1445,64,-1,,809,1581,0.0
3,1,15,1,0,0,136,745,1445,64,-1,,809,1581,0.0
4,1,15,1,1,0,139,745,1442,32,-1,,777,1581,0.0
5,1,15,1,1,1,139,747,111,28,82,103265,775,250,0.0
5,1,15,1,1,2,247,743,14,42,82,|,785,261,0.0
5,1,15,1,1,3,269,757,49,18,95,NOT,775,318,0.0
5,1,15,1,1,4,336,758,147,17,96,REGULATED,775,483,0.0
5,1,15,1,1,5,502,745,81,30,97,UNDER,775,583,0.0
5,1,15,1,1,6,603,758,48,18,95,TDG,776,651,0.0
5,1,15,1,1,7,970,746,94,31,84,0.9636,777,1064,0.0
5,1,15,1,1,8,1170,758,78,19,96,43999,777,1248,0.0
5,1,15,1,1,9,1320,759,78,18,93,42397,777,1398,0.0
5,1,15,1,1,10,1414,750,68,27,65,|62.4,777,1482,0.0
5,1,15,1,1,11,1503,759,78,18,79,|910.6,777,1581,0.0
4,1,15,1,2,0,136,787,947,22,-1,,809,1083,0.0
5,1,15,1,2,1,136,787,97,19,89,MTR271,806,233,0.0
5,1,15,1,2,2,247,783,15,33,93,|,816,262,0.0
5,1,15,1,2,3,270,789,81,16,95,HEAVY,805,351,0.0
5,1,15,1,2,4,368,788,101,18,93,VACUUM,806,469,0.0
5,1,15,1,2,5,486,789,92,17,47,GASOIL,806,578,0.0
5,1,15,1,2,6,592,788,85,21,47,(HVGO),809,677,0.0
5,1,15,1,2,7,967,790,47,17,89,API,807,1014,0.0
5,1,15,1,2,8,1036,789,47,18,87,54B,807,1083,0.0
2,1,16,0,0,0,493,821,292,91,-1,,912,785,0.0
3,1,16,1,0,0,493,821,292,91,-1,,912,785,0.0
4,1,16,1,1,0,493,821,292,91,-1,,912,785,0.0
5,1,16,1,1,1,493,867,76,45,47,ar,912,569,0.0
5,1,16,1,1,2,588,821,197,87,7,lielAH,908,785,0.0
2,1,17,0,0,0,244,980,717,131,-1,,1111,961,0.0
3,1,17,1,0,0,244,980,717,131,-1,,1111,961,0.0
4,1,17,1,1,0,244,980,717,131,-1,,1111,961,0.0
5,1,17,1,1,1,244,990,83,65,55,er,1055,327,0.0
5,1,17,1,1,2,378,991,42,56,25,If,1047,420,0.0
5,1,17,1,1,3,486,980,68,58,41,09,1038,554,0.0
5,1,17,1,1,4,644,1047,90,47,52,be,1094,734,0.0
5,1,17,1,1,5,764,987,197,124,35,angel,1111,961,0.0
2,1,18,0,0,0,351,1178,235,58,-1,,1236,586,0.0
3,1,18,1,0,0,351,1178,235,58,-1,,1236,586,0.0
4,1,18,1,1,0,351,1178,235,58,-1,,1236,586,0.0
5,1,18,1,1,1,351,1178,235,58,0,18S,1236,586,0.0
2,1,19,0,0,0,85,743,53,1,-1,,744,138,0.0
3,1,19,1,0,0,85,743,53,1,-1,,744,138,0.0
4,1,19,1,1,0,85,743,53,1,-1,,744,138,0.0
5,1,19,1,1,1,85,743,53,1,95, ,744,138,0.0
2,1,20,0,0,0,1002,745,622,3,-1,,748,1624,0.0
3,1,20,1,0,0,1002,745,622,3,-1,,748,1624,0.0
4,1,20,1,1,0,1002,745,622,3,-1,,748,1624,0.0
5,1,20,1,1,1,1002,745,622,3,95, ,748,1624,0.0
2,1,21,0,0,0,54,803,3,377,-1,,1180,57,0.0
3,1,21,1,0,0,54,803,3,377,-1,,1180,57,0.0
4,1,21,1,1,0,54,803,3,377,-1,,1180,57,0.0
5,1,21,1,1,1,54,803,3,377,95, ,1180,57,0.0
2,1,22,0,0,0,1274,683,3,748,-1,,1431,1277,0.0
3,1,22,1,0,0,1274,683,3,748,-1,,1431,1277,0.0
4,1,22,1,1,0,1274,683,3,748,-1,,1431,1277,0.0
5,1,22,1,1,1,1274,683,3,748,95, ,1431,1277,0.0
2,1,23,0,0,0,270,1487,1127,55,-1,,1542,1397,0.0
3,1,23,1,0,0,270,1487,1127,55,-1,,1542,1397,0.0
4,1,23,1,1,0,301,1487,379,24,-1,,1511,680,0.0
5,1,23,1,1,1,301,1488,79,18,96,Total,1506,380,0.0
5,1,23,1,1,2,401,1487,96,20,96,Litres,1507,497,0.0
5,1,23,1,1,3,517,1489,32,22,96,by,1511,549,0.0
5,1,23,1,1,4,568,1489,112,19,96,Product,1508,680,0.0
4,1,23,1,2,0,270,1518,1127,24,-1,,1542,1397,0.0
5,1,23,1,2,1,270,1518,94,18,96,103265,1536,364,0.0
5,1,23,1,2,2,467,1521,82,17,96,HEAVY,1538,549,0.0
5,1,23,1,2,3,566,1521,100,17,93,VACUUM,1538,666,0.0
5,1,23,1,2,4,684,1521,191,21,71,GASOIL(HVGO),1542,875,0.0
5,1,23,1,2,5,1169,1521,78,19,96,43999,1540,1247,0.0
5,1,23,1,2,6,1319,1521,78,19,96,42397,1540,1397,3.0
2,1,24,0,0,0,247,674,4,993,-1,,1667,251,0.0
3,1,24,1,0,0,247,674,4,993,-1,,1667,251,0.0
4,1,24,1,1,0,247,674,4,993,-1,,1667,251,0.0
5,1,24,1,1,1,247,674,4,993,95, ,1667,251,0.0
2,1,25,0,0,0,1120,675,5,1013,-1,,1688,1125,0.0
3,1,25,1,0,0,1120,675,5,1013,-1,,1688,1125,0.0
4,1,25,1,1,0,1120,675,5,1013,-1,,1688,1125,0.0
5,1,25,1,1,1,1120,675,5,1013,95, ,1688,1125,0.0
2,1,26,0,0,0,1412,676,5,1013,-1,,1689,1417,0.0
3,1,26,1,0,0,1412,676,5,1013,-1,,1689,1417,0.0
4,1,26,1,1,0,1412,676,5,1013,-1,,1689,1417,0.0
5,1,26,1,1,1,1412,676,5,1013,95, ,1689,1417,0.0
2,1,27,0,0,0,58,1682,390,3,-1,,1685,448,0.0
3,1,27,1,0,0,58,1682,390,3,-1,,1685,448,0.0
4,1,27,1,1,0,58,1682,390,3,-1,,1685,448,0.0
5,1,27,1,1,1,58,1682,390,3,95, ,1685,448,0.0
2,1,28,0,0,0,640,1685,85,2,-1,,1687,725,0.0
3,1,28,1,0,0,640,1685,85,2,-1,,1687,725,0.0
4,1,28,1,1,0,640,1685,85,2,-1,,1687,725,0.0
5,1,28,1,1,1,640,1685,85,2,95, ,1687,725,0.0
2,1,29,0,0,0,67,1695,864,21,-1,,1716,931,0.0
3,1,29,1,0,0,67,1695,864,21,-1,,1716,931,0.0
4,1,29,1,1,0,67,1695,864,21,-1,,1716,931,0.0
5,1,29,1,1,1,67,1695,58,17,55,(hereby,1712,125,0.0
5,1,29,1,1,2,131,1696,53,14,75,declare,1710,184,0.0
5,1,29,1,1,3,190,1697,26,13,90,thal,1710,216,0.0
5,1,29,1,1,4,223,1697,21,13,96,the,1710,244,0.0
5,1,29,1,1,5,250,1698,61,12,96,contents,1710,311,0.0
5,1,29,1,1,6,317,1697,13,13,93,of,1710,330,0.0
5,1,29,1,1,7,336,1697,24,13,38,Ihis,1710,360,0.0
5,1,29,1,1,8,366,1697,92,17,96,consignment,1714,458,0.0
5,1,29,1,1,9,465,1701,23,10,96,are,1711,488,0.0
5,1,29,1,1,10,493,1698,29,16,96,fully,1714,522,0.0
5,1,29,1,1,11,528,1698,25,13,96,and,1711,553,0.0
5,1,29,1,1,12,560,1698,74,16,95,accurately,1714,634,0.0
5,1,29,1,1,13,640,1698,71,14,94,described,1712,711,0.0
5,1,29,1,1,14,717,1699,44,13,96,above,1712,761,0.0
5,1,29,1,1,15,767,1699,17,16,96,by,1715,784,0.0
5,1,29,1,1,16,789,1699,22,13,84,the,1712,811,0.0
5,1,29,1,1,17,817,1702,48,13,96,proper,1715,865,0.0
5,1,29,1,1,18,870,1699,61,17,96,shipping,1716,931,0.0
2,1,30,0,0,0,942,1687,318,1,-1,,1688,1260,0.0
3,1,30,1,0,0,942,1687,318,1,-1,,1688,1260,0.0
4,1,30,1,1,0,942,1687,318,1,-1,,1688,1260,0.0
5,1,30,1,1,1,942,1687,318,1,95, ,1688,1260,0.0
2,1,31,0,0,0,1460,1688,162,1,-1,,1689,1622,0.0
3,1,31,1,0,0,1460,1688,162,1,-1,,1689,1622,0.0
4,1,31,1,1,0,1460,1688,162,1,-1,,1689,1622,0.0
5,1,31,1,1,1,1460,1688,162,1,95, ,1689,1622,0.0
2,1,32,0,0,0,953,1743,669,2,-1,,1745,1622,0.0
3,1,32,1,0,0,953,1743,669,2,-1,,1745,1622,0.0
4,1,32,1,1,0,953,1743,669,2,-1,,1745,1622,0.0
5,1,32,1,1,1,953,1743,669,2,95, ,1745,1622,0.0
2,1,33,0,0,0,1078,1744,2,51,-1,,1795,1080,0.0
3,1,33,1,0,0,1078,1744,2,51,-1,,1795,1080,0.0
4,1,33,1,1,0,1078,1744,2,51,-1,,1795,1080,0.0
5,1,33,1,1,1,1078,1744,2,51,95, ,1795,1080,0.0
2,1,34,0,0,0,1495,676,5,1153,-1,,1829,1500,0.0
3,1,34,1,0,0,1495,676,5,1153,-1,,1829,1500,0.0
4,1,34,1,1,0,1495,676,5,1153,-1,,1829,1500,0.0
5,1,34,1,1,1,1495,676,5,1153,95, ,1829,1500,0.0
2,1,35,0,0,0,953,1699,2,129,-1,,1828,955,0.0
3,1,35,1,0,0,953,1699,2,129,-1,,1828,955,0.0
4,1,35,1,1,0,953,1699,2,129,-1,,1828,955,0.0
5,1,35,1,1,1,953,1699,2,129,95, ,1828,955,0.0
2,1,36,0,0,0,854,1826,768,3,-1,,1829,1622,0.0
3,1,36,1,0,0,854,1826,768,3,-1,,1829,1622,0.0
4,1,36,1,1,0,854,1826,768,3,-1,,1829,1622,0.0
5,1,36,1,1,1,854,1826,768,3,95, ,1829,1622,0.0
2,1,37,0,0,0,48,1827,1579,330,-1,,2157,1627,0.0
3,1,37,1,0,0,48,1827,1579,330,-1,,2157,1627,0.0
4,1,37,1,1,0,48,1827,1579,330,-1,,2157,1627,0.0
5,1,37,1,1,1,48,1827,1579,330,95,   ,2157,1627,0.0
5,1,37,1,1,2,384,1827,660,25,95, ,1852,1044,0.0
5,1,37,1,1,3,1178,1827,449,30,95,  ,1857,1627,0.0
2,1,38,0,0,0,66,1715,1514,199,-1,,1914,1580,0.0
3,1,38,1,0,0,66,1715,1514,193,-1,,1908,1580,0.0
4,1,38,1,1,0,67,1715,878,21,-1,,1736,945,0.0
5,1,38,1,1,1,67,1719,43,10,82,name.,1729,110,0.0
5,1,38,1,1,2,117,1719,23,10,96,are,1729,140,0.0
5,1,38,1,1,3,146,1715,58,18,95,properly,1733,204,0.0
5,1,38,1,1,4,210,1716,67,14,91,classified,1730,277,0.0
5,1,38,1,1,5,283,1717,26,13,95,and,1730,309,0.0
5,1,38,1,1,6,315,1717,75,17,94,"packaged,",1734,390,0.0
5,1,38,1,1,7,397,1717,34,14,96,have,1731,431,0.0
5,1,38,1,1,8,437,1717,77,17,96,dangerous,1734,514,0.0
5,1,38,1,1,9,520,1717,44,18,94,goods,1735,564,0.0
5,1,38,1,1,10,570,1717,43,18,96,safely,1735,613,0.0
5,1,38,1,1,11,619,1717,43,14,73,marks,1731,662,0.0
5,1,38,1,1,12,669,1718,59,17,96,properly,1735,728,0.0
5,1,38,1,1,13,734,1718,47,14,71,affixed,1732,781,0.0
5,1,38,1,1,14,787,1721,14,11,96,or,1732,801,0.0
5,1,38,1,1,15,807,1718,69,18,92,displayed,1736,876,0.0
5,1,38,1,1,16,882,1722,17,10,92,on,1732,899,0.0
5,1,38,1,1,17,906,1719,39,13,96,them.,1732,945,0.0
4,1,38,1,2,0,67,1736,1513,23,-1,,1759,1580,0.0
5,1,38,1,2,1,67,1736,25,13,96,and,1749,92,0.0
5,1,38,1,2,2,99,1739,23,10,90,are,1749,122,0.0
5,1,38,1,2,3,128,1736,10,13,95,in,1749,138,0.0
5,1,38,1,2,4,145,1736,15,13,95,all,1749,160,0.0
5,1,38,1,2,5,166,1738,62,14,96,respects,1752,228,0.0
5,1,38,1,2,6,234,1736,10,13,96,in,1749,244,0.0
5,1,38,1,2,7,251,1740,47,13,94,proper,1753,298,0.0
5,1,38,1,2,8,303,1736,65,14,91,condition,1750,368,0.0
5,1,38,1,2,9,375,1737,17,13,90,for,1750,392,0.0
5,1,38,1,2,10,398,1738,64,15,46,transporl,1753,462,0.0
5,1,38,1,2,11,468,1738,70,16,96,according,1754,538,0.0
5,1,38,1,2,12,545,1738,12,13,81,to,1751,557,0.0
5,1,38,1,2,13,564,1738,21,13,89,the,1751,585,0.0
5,1,38,1,2,14,591,1738,106,16,58,Transportation,1754,697,0.0
5,1,38,1,2,15,703,1738,13,13,89,of,1751,716,0.0
5,1,38,1,2,16,723,1738,79,17,95,Dangerous,1755,802,0.0
5,1,38,1,2,17,808,1738,48,14,93,Goods,1752,856,0.0
5,1,38,1,2,18,862,1738,87,17,62,Regulations|,1755,949,0.0
5,1,38,1,2,19,986,1747,50,11,0,—zayeqn,1758,1036,0.0
5,1,38,1,2,20,1128,1747,45,11,59,START,1758,1173,0.0
5,1,38,1,2,21,1178,1747,61,11,89,LOADING,1758,1239,0.0
5,1,38,1,2,22,1321,1744,110,15,19,FINSHCOADING,1759,1431,0.0
5,1,38,1,2,23,1514,1748,33,11,9,TiME,1759,1547,0.0
5,1,38,1,2,24,1551,1748,29,11,83,OUT,1759,1580,0.0
4,1,38,1,3,0,135,1761,1440,21,-1,,1782,1575,0.0
5,1,38,1,3,1,135,1762,80,19,93,Yanni,1781,215,0.0
5,1,38,1,3,2,220,1762,30,19,92,ck,1781,250,0.0
5,1,38,1,3,3,267,1762,115,20,95,Mercier,1782,382,0.0
5,1,38,1,3,4,986,1761,61,11,66,ARRIVEE,1772,1047,0.0
5,1,38,1,3,5,1098,1761,46,11,78,DEBUT,1772,1144,0.0
5,1,38,1,3,6,1149,1762,18,10,90,OU,1772,1167,0.0
5,1,38,1,3,7,1172,1761,99,12,83,CHARGEMENT,1773,1271,0.0
5,1,38,1,3,8,1310,1762,20,10,95,FIN,1772,1330,0.0
5,1,38,1,3,9,1336,1762,19,11,79,DU,1773,1355,0.0
5,1,38,1,3,10,1360,1762,97,11,87,CHARGEMENT,1773,1457,0.0
5,1,38,1,3,11,1520,1762,55,11,91,DEPART,1773,1575,0.0
4,1,38,1,4,0,66,1796,1513,31,-1,,1827,1579,0.0
5,1,38,1,4,1,66,1798,55,2,36,7,1800,121,0.0
5,1,38,1,4,2,150,1803,55,17,40,Bhipper,1820,205,0.0
5,1,38,1,4,3,214,1807,34,10,96,name,1817,248,0.0
5,1,38,1,4,4,258,1804,52,16,92,(please,1820,310,0.0
5,1,38,1,4,5,316,1804,36,21,71,print),1825,352,0.0
5,1,38,1,4,6,470,1800,42,26,22,—,1826,512,0.0
5,1,38,1,4,7,969,1796,78,19,95,03:39,1815,1047,0.0
5,1,38,1,4,8,1077,1796,4,31,92,|,1827,1081,0.0
5,1,38,1,4,9,1136,1796,78,19,95,03:59,1815,1214,0.0
5,1,38,1,4,10,1336,1797,77,18,95,04:22,1815,1413,0.0
5,1,38,1,4,11,1503,1798,76,18,95,04:22,1816,1579,0.0
4,1,38,1,5,0,67,1825,1497,23,-1,,1848,1564,0.0
5,1,38,1,5,1,67,1828,61,13,92,DRIVER,1841,128,0.0
5,1,38,1,5,2,134,1829,46,13,89,NAME,1842,180,0.0
5,1,38,1,5,3,186,1836,4,2,89,-,1838,190,0.0
5,1,38,1,5,4,197,1828,37,14,96,NOM,1842,234,0.0
5,1,38,1,5,5,241,1829,21,13,93,DU,1842,262,0.0
5,1,38,1,5,6,268,1829,116,14,92,CONDUCTEUR,1843,384,0.0
5,1,38,1,5,7,533,1825,11,2,45,a,1827,544,0.0
5,1,38,1,5,8,762,1831,60,13,66,DRIVER,1844,822,0.0
5,1,38,1,5,9,829,1827,96,17,92,SIGNATURE,1844,925,0.0
5,1,38,1,5,10,931,1838,4,2,72,-,1840,935,0.0
5,1,38,1,5,11,944,1823,24,31,82,SiG,1854,968,0.0
5,1,38,1,5,12,970,1832,61,12,52,NATURE,1844,1031,0.0
5,1,38,1,5,13,1044,1835,18,8,30,Dt),1843,1062,0.0
5,1,38,1,5,14,1072,1832,72,13,89,CONDUC,1845,1144,0.0
5,1,38,1,5,15,1245,1827,6,21,39,|,1848,1251,0.0
5,1,38,1,5,16,1276,1828,53,18,39,TOTAL,1846,1329,0.0
5,1,38,1,5,17,1334,1828,83,18,93,QUANTITY,1846,1417,0.0
5,1,38,1,5,18,1424,1840,3,2,90,-,1842,1427,0.0
5,1,38,1,5,19,1434,1832,60,14,88,"QUANT,",1846,1494,0.0
5,1,38,1,5,20,1500,1832,64,14,93,TOTALE,1846,1564,0.0
4,1,38,1,6,0,906,1840,625,49,-1,,1889,1531,0.0
5,1,38,1,6,1,906,1878,8,11,0,y,1889,914,0.0
5,1,38,1,6,2,1003,1840,36,47,46,Ye,1887,1039,0.0
5,1,38,1,6,3,1245,1853,2,24,88,|,1877,1247,0.0
5,1,38,1,6,4,1319,1858,78,19,87,43999,1877,1397,0.0
5,1,38,1,6,5,1434,1858,97,19,94,Litres,1877,1531,0.0
4,1,38,1,7,0,131,1880,1269,34,-1,,1914,1400,0.0
5,1,38,1,7,1,131,1882,86,32,96,ALAIN,1914,217,0.0
5,1,38,1,7,2,268,1888,81,17,89,HOULE,1905,349,0.0
5,1,38,1,7,3,602,1888,127,18,96,00047842,1906,729,0.0
5,1,38,1,7,4,1245,1880,2,24,46,|,1904,1247,0.0
5,1,38,1,7,5,1286,1889,77,19,31,38607,1908,1363,0.0
5,1,38,1,7,6,1384,1890,16,18,31,_k,1908,1400,0.0
2,1,39,0,0,0,1620,142,6,1768,-1,,1910,1626,0.0
3,1,39,1,0,0,1620,142,6,1768,-1,,1910,1626,0.0
4,1,39,1,1,0,1620,142,6,1768,-1,,1910,1626,0.0
5,1,39,1,1,1,1620,142,6,1768,95, ,1910,1626,0.0
2,1,40,0,0,0,75,1917,1525,55,-1,,1972,1600,0.0
3,1,40,1,0,0,75,1917,1525,55,-1,,1972,1600,0.0
4,1,40,1,1,0,75,1917,1525,16,-1,,1933,1600,0.0
5,1,40,1,1,1,75,1917,67,11,92,PRODUCT,1928,142,0.0
5,1,40,1,1,2,157,1911,10,28,0,|,1939,167,0.0
5,1,40,1,1,3,168,1918,36,10,0,TANK,1928,204,0.0
5,1,40,1,1,4,209,1918,69,11,33,CAPACITY|,1929,278,0.0
5,1,40,1,1,5,284,1918,49,11,33,WATER,1929,333,0.0
5,1,40,1,1,6,339,1918,84,12,60,DIP/BEFORE,1930,423,0.0
5,1,40,1,1,7,428,1918,31,12,68,DIPS|,1930,459,0.0
5,1,40,1,1,8,478,1918,56,12,0,BEFORE,1930,534,0.0
5,1,40,1,1,9,539,1919,50,11,0,|NVENT,1930,589,0.0
5,1,40,1,1,10,600,1911,8,28,95,|,1939,608,0.0
5,1,40,1,1,11,613,1920,45,10,96,AFTER,1930,658,0.0
5,1,40,1,1,12,664,1920,30,10,32,DIPS),1930,694,0.0
5,1,40,1,1,13,706,1920,52,11,93,ENDING,1931,758,0.0
5,1,40,1,1,14,764,1920,49,11,93,INVENT,1931,813,0.0
5,1,40,1,1,15,859,1920,68,11,87,PRODUCT,1931,927,0.0
5,1,40,1,1,16,939,1913,7,28,59,|,1941,946,0.0
5,1,40,1,1,17,950,1920,36,11,59,TANK,1931,986,0.0
5,1,40,1,1,18,991,1920,68,11,48,CAPACITY|,1931,1059,0.0
5,1,40,1,1,19,1066,1920,50,12,93,WATER,1932,1116,0.0
5,1,40,1,1,20,1122,1921,21,11,37,DiP|,1932,1143,0.0
5,1,40,1,1,21,1154,1920,55,12,96,BEFORE,1932,1209,0.0
5,1,40,1,1,22,1214,1920,31,12,95,DIPS,1932,1245,0.0
5,1,40,1,1,23,1256,1913,8,28,94,|,1941,1264,0.0
5,1,40,1,1,24,1270,1921,56,11,89,BEFORE,1932,1326,0.0
5,1,40,1,1,25,1332,1921,49,11,95,INVENT,1932,1381,0.0
5,1,40,1,1,26,1390,1918,2,5,96,|,1923,1392,0.0
5,1,40,1,1,27,1398,1921,44,11,93,AFTER,1932,1442,0.0
5,1,40,1,1,28,1448,1921,30,11,64,DIPS,1932,1478,0.0
5,1,40,1,1,29,1492,1922,53,11,76,ENDING,1933,1545,0.0
5,1,40,1,1,30,1550,1922,50,11,87,INVENT,1933,1600,0.0
4,1,40,1,2,0,78,1934,1510,15,-1,,1949,1588,0.0
5,1,40,1,2,1,78,1934,61,11,86,PRODUIT,1945,139,0.0
5,1,40,1,2,2,158,1927,10,28,90,|,1955,168,0.0
5,1,40,1,2,3,172,1934,95,12,73,GONTENANGE,1946,267,0.0
5,1,40,1,2,4,277,1927,10,28,91,|,1955,287,0.0
5,1,40,1,2,5,288,1934,66,12,91,MEASURE,1946,354,0.0
5,1,40,1,2,6,361,1927,7,28,91,|,1955,368,0.0
5,1,40,1,2,7,378,1935,46,11,76,AVANT,1946,424,0.0
5,1,40,1,2,8,429,1936,15,10,76,LE,1946,444,0.0
5,1,40,1,2,9,492,1936,82,11,92,INVENTAIRE,1947,574,0.0
5,1,40,1,2,10,619,1936,67,11,91,APRESLE,1947,686,0.0
5,1,40,1,2,11,694,1928,12,28,53,|,1956,706,0.0
5,1,40,1,2,12,720,1936,81,11,77,INVENTAIRE,1947,801,0.0
5,1,40,1,2,13,862,1937,60,11,66,PRODUIT,1948,922,0.0
5,1,40,1,2,14,939,1929,10,28,64,|,1957,949,0.0
5,1,40,1,2,15,953,1937,96,11,64,CONTENANCE,1948,1049,0.0
5,1,40,1,2,16,1058,1929,10,28,56,|,1957,1068,0.0
5,1,40,1,2,17,1070,1938,67,10,51,MEASURE,1948,1137,0.0
5,1,40,1,2,18,1142,1929,8,28,51,|,1957,1150,0.0
5,1,40,1,2,19,1164,1938,46,10,6,AVANT,1948,1210,0.0
5,1,40,1,2,20,1215,1938,16,11,6,LE,1949,1231,0.0
5,1,40,1,2,21,1284,1938,83,11,91,INVENTAIRE,1949,1367,0.0
5,1,40,1,2,22,1385,1930,10,28,90,|,1958,1395,0.0
5,1,40,1,2,23,1404,1938,66,11,58,APRESLE,1949,1470,0.0
5,1,40,1,2,24,1476,1930,7,28,33,|,1958,1483,0.0
5,1,40,1,2,25,1506,1938,82,11,23, INVENTAIRE,1949,1588,0.0
4,1,40,1,3,0,169,1951,1396,21,-1,,1972,1565,0.0
5,1,40,1,3,1,169,1951,103,11,21,DURESERVIOR,1962,272,0.0
5,1,40,1,3,2,279,1944,10,28,70,|,1972,289,0.0
5,1,40,1,3,3,299,1952,37,11,70,DEAU,1963,336,0.0
5,1,40,1,3,4,351,1944,15,28,69,|,1972,366,0.0
5,1,40,1,3,5,375,1952,75,11,81,JAUGEAGE,1963,450,0.0
5,1,40,1,3,6,497,1952,75,11,82,JAUGEAGE,1963,572,0.0
5,1,40,1,3,7,613,1952,75,12,88,JAUGEAGE,1964,688,0.0
5,1,40,1,3,8,736,1953,46,11,58,APRES,1964,782,0.0
5,1,40,1,3,9,938,1954,117,17,62,_|DURESERVIOR,1971,1055,0.0
5,1,40,1,3,10,1059,1946,11,29,45,|,1975,1070,0.0
5,1,40,1,3,11,1082,1954,36,11,49,DEAU,1965,1118,0.0
5,1,40,1,3,12,1161,1954,76,11,69,JAUSEAGE,1965,1237,0.0
5,1,40,1,3,13,1289,1954,75,12,74,JAUGEAGE,1966,1364,0.0
5,1,40,1,3,14,1372,1947,20,29,53,_|,1976,1392,0.0
5,1,40,1,3,15,1394,1954,78,17,91,JAUGEAGE,1971,1472,0.0
5,1,40,1,3,16,1520,1955,45,17,81,APRES,1972,1565,0.0
2,1,41,0,0,0,150,1966,1141,5,-1,,1971,1291,0.0
3,1,41,1,0,0,150,1966,1141,5,-1,,1971,1291,0.0
4,1,41,1,1,0,150,1966,1141,5,-1,,1971,1291,0.0
5,1,41,1,1,1,150,1966,1141,5,95, ,1971,1291,0.0
2,1,42,0,0,0,161,2027,210,3,-1,,2030,371,0.0
3,1,42,1,0,0,161,2027,210,3,-1,,2030,371,0.0
4,1,42,1,1,0,161,2027,210,3,-1,,2030,371,0.0
5,1,42,1,1,1,161,2027,210,3,95, ,2030,371,0.0
2,1,43,0,0,0,603,2028,1008,5,-1,,2033,1611,0.0
3,1,43,1,0,0,603,2028,1008,5,-1,,2033,1611,0.0
4,1,43,1,1,0,603,2028,1008,5,-1,,2033,1611,0.0
5,1,43,1,1,1,603,2028,1008,5,95, ,2033,1611,0.0
2,1,44,0,0,0,163,1911,3,130,-1,,2041,166,0.0
3,1,44,1,0,0,163,1911,3,130,-1,,2041,166,0.0
4,1,44,1,1,0,163,1911,3,130,-1,,2041,166,0.0
5,1,44,1,1,1,163,1911,3,130,95, ,2041,166,0.0
2,1,45,0,0,0,76,2087,384,4,-1,,2091,460,0.0
3,1,45,1,0,0,76,2087,384,4,-1,,2091,460,0.0
4,1,45,1,1,0,76,2087,384,4,-1,,2091,460,0.0
5,1,45,1,1,1,76,2087,384,4,95, ,2091,460,0.0
2,1,46,0,0,0,603,2089,1016,5,-1,,2094,1619,0.0
3,1,46,1,0,0,603,2089,1016,5,-1,,2094,1619,0.0
4,1,46,1,1,0,603,2089,1016,5,-1,,2094,1619,0.0
5,1,46,1,1,1,603,2089,1016,5,95, ,2094,1619,0.0
2,1,47,0,0,0,279,1911,4,204,-1,,2115,283,0.0
3,1,47,1,0,0,279,1911,4,204,-1,,2115,283,0.0
4,1,47,1,1,0,279,1911,4,204,-1,,2115,283,0.0
5,1,47,1,1,1,279,1911,4,204,95, ,2115,283,0.0
2,1,48,0,0,0,606,1912,3,207,-1,,2119,609,0.0
3,1,48,1,0,0,606,1912,3,207,-1,,2119,609,0.0
4,1,48,1,1,0,606,1912,3,207,-1,,2119,609,0.0
5,1,48,1,1,1,606,1912,3,207,95, ,2119,609,0.0
2,1,49,0,0,0,1144,1914,4,215,-1,,2129,1148,0.0
3,1,49,1,0,0,1144,1914,4,215,-1,,2129,1148,0.0
4,1,49,1,1,0,1144,1914,4,215,-1,,2129,1148,0.0
5,1,49,1,1,1,1144,1914,4,215,95, ,2129,1148,0.0
2,1,50,0,0,0,362,1912,4,235,-1,,2147,366,0.0
3,1,50,1,0,0,362,1912,4,235,-1,,2147,366,0.0
4,1,50,1,1,0,362,1912,4,235,-1,,2147,366,0.0
5,1,50,1,1,1,362,1912,4,235,95, ,2147,366,0.0
2,1,51,0,0,0,944,1913,3,238,-1,,2151,947,0.0
3,1,51,1,0,0,944,1913,3,238,-1,,2151,947,0.0
4,1,51,1,1,0,944,1913,3,238,-1,,2151,947,0.0
5,1,51,1,1,1,944,1913,3,238,95, ,2151,947,0.0
2,1,52,0,0,0,1060,1914,5,238,-1,,2152,1065,0.0
3,1,52,1,0,0,1060,1914,5,238,-1,,2152,1065,0.0
4,1,52,1,1,0,1060,1914,5,238,-1,,2152,1065,0.0
5,1,52,1,1,1,1060,1914,5,238,95, ,2152,1065,0.0
2,1,53,0,0,0,1256,1914,3,238,-1,,2152,1259,0.0
3,1,53,1,0,0,1256,1914,3,238,-1,,2152,1259,0.0
4,1,53,1,1,0,1256,1914,3,238,-1,,2152,1259,0.0
5,1,53,1,1,1,1256,1914,3,238,95, ,2152,1259,0.0
2,1,54,0,0,0,694,1917,5,234,-1,,2151,699,0.0
3,1,54,1,0,0,694,1917,5,234,-1,,2151,699,0.0
4,1,54,1,1,0,694,1917,5,234,-1,,2151,699,0.0
5,1,54,1,1,1,694,1917,5,234,95,,2151,699,0.0
1,1,0,0,0,0,0,0,1700,2200,-1,,2200,1700,0.0
2,1,1,0,0,0,904,89,613,23,-1,,112,1517,0.0
3,1,1,1,0,0,904,89,613,23,-1,,112,1517,0.0
4,1,1,1,1,0,904,89,613,23,-1,,112,1517,0.0
5,1,1,1,1,1,904,89,117,22,95,VEHICLE,111,1021,0.0
5,1,1,1,1,2,1032,89,121,22,96,LOADING,111,1153,0.0
5,1,1,1,1,3,1166,90,113,22,93,REPORT,112,1279,0.0
5,1,1,1,1,4,1276,85,14,38,93,-,123,1290,0.0
5,1,1,1,1,5,1306,90,55,22,96,BILL,112,1361,0.0
5,1,1,1,1,6,1370,90,37,22,93,OF,112,1407,0.0
5,1,1,1,1,7,1418,90,99,22,92,LADING,112,1517,0.0
2,1,2,0,0,0,789,141,373,5,-1,,146,1162,0.0
3,1,2,1,0,0,789,141,373,5,-1,,146,1162,0.0
4,1,2,1,1,0,789,141,373,5,-1,,146,1162,0.0
5,1,2,1,1,1,789,141,373,5,95, ,146,1162,0.0
2,1,3,0,0,0,553,419,3,63,-1,,482,556,0.0
3,1,3,1,0,0,553,419,3,63,-1,,482,556,0.0
4,1,3,1,1,0,553,419,3,63,-1,,482,556,0.0
5,1,3,1,1,1,553,419,3,63,95, ,482,556,0.0
2,1,4,0,0,0,662,481,42,1,-1,,482,704,0.0
3,1,4,1,0,0,662,481,42,1,-1,,482,704,0.0
4,1,4,1,1,0,662,481,42,1,-1,,482,704,0.0
5,1,4,1,1,1,662,481,42,1,95, ,482,704,0.0
2,1,5,0,0,0,715,520,447,5,-1,,525,1162,0.0
3,1,5,1,0,0,715,520,447,5,-1,,525,1162,0.0
4,1,5,1,1,0,715,520,447,5,-1,,525,1162,0.0
5,1,5,1,1,1,715,520,447,5,95, ,525,1162,0.0
2,1,6,0,0,0,604,631,242,49,-1,,680,846,0.0
3,1,6,1,0,0,604,631,242,49,-1,,680,846,0.0
4,1,6,1,1,0,604,631,242,49,-1,,680,846,0.0
5,1,6,1,1,1,604,631,242,49,95, ,680,846,0.0
2,1,7,0,0,0,1451,677,172,3,-1,,680,1623,0.0
3,1,7,1,0,0,1451,677,172,3,-1,,680,1623,0.0
4,1,7,1,1,0,1451,677,172,3,-1,,680,1623,0.0
5,1,7,1,1,1,1451,677,172,3,95, ,680,1623,0.0
2,1,8,0,0,0,69,672,422,4,-1,,676,491,0.0
3,1,8,1,0,0,69,672,422,4,-1,,676,491,0.0
4,1,8,1,1,0,69,672,422,4,-1,,676,491,0.0
5,1,8,1,1,1,69,672,422,4,95, ,676,491,0.0
2,1,9,0,0,0,992,675,631,6,-1,,681,1623,0.0
3,1,9,1,0,0,992,675,631,6,-1,,681,1623,0.0
4,1,9,1,1,0,992,675,631,6,-1,,681,1623,0.0
5,1,9,1,1,1,992,675,631,6,95, ,681,1623,0.0
2,1,10,0,0,0,160,739,1463,10,-1,,749,1623,0.0
3,1,10,1,0,0,160,739,1463,10,-1,,749,1623,0.0
4,1,10,1,1,0,160,739,1463,10,-1,,749,1623,0.0
5,1,10,1,1,1,160,739,1463,10,95, ,749,1623,0.0
2,1,11,0,0,0,54,333,4,495,-1,,828,58,0.0
3,1,11,1,0,0,54,333,4,495,-1,,828,58,0.0
4,1,11,1,1,0,54,333,4,495,-1,,828,58,0.0
5,1,11,1,1,1,54,333,4,495,95, ,828,58,0.0
2,1,12,0,0,0,1272,1133,3,395,-1,,1528,1275,0.0
3,1,12,1,0,0,1272,1133,3,395,-1,,1528,1275,0.0
4,1,12,1,1,0,1272,1133,3,395,-1,,1528,1275,0.0
5,1,12,1,1,1,1272,1133,3,395,95, ,1528,1275,0.0
2,1,13,0,0,0,243,680,10,987,-1,,1667,253,0.0
3,1,13,1,0,0,243,680,10,987,-1,,1667,253,0.0
4,1,13,1,1,0,243,680,10,987,-1,,1667,253,0.0
5,1,13,1,1,1,243,680,10,987,95, ,1667,253,0.0
2,1,14,0,0,0,1117,676,8,1014,-1,,1690,1125,0.0
3,1,14,1,0,0,1117,676,8,1014,-1,,1690,1125,0.0
4,1,14,1,1,0,1117,676,8,1014,-1,,1690,1125,0.0
5,1,14,1,1,1,1117,676,8,1014,95, ,1690,1125,0.0
2,1,15,0,0,0,1410,677,8,1014,-1,,1691,1418,0.0
3,1,15,1,0,0,1410,677,8,1014,-1,,1691,1418,0.0
4,1,15,1,1,0,1410,677,8,1014,-1,,1691,1418,0.0
5,1,15,1,1,1,1410,677,8,1014,95, ,1691,1418,0.0
2,1,16,0,0,0,936,1307,5,382,-1,,1689,941,0.0
3,1,16,1,0,0,936,1307,5,382,-1,,1689,941,0.0
4,1,16,1,1,0,936,1307,5,382,-1,,1689,941,0.0
5,1,16,1,1,1,936,1307,5,382,95, ,1689,941,0.0
2,1,17,0,0,0,52,1683,321,4,-1,,1687,373,0.0
3,1,17,1,0,0,52,1683,321,4,-1,,1687,373,0.0
4,1,17,1,1,0,52,1683,321,4,-1,,1687,373,0.0
5,1,17,1,1,1,52,1683,321,4,95, ,1687,373,0.0
2,1,18,0,0,0,526,1685,585,6,-1,,1691,1111,0.0
3,1,18,1,0,0,526,1685,585,6,-1,,1691,1111,0.0
4,1,18,1,1,0,526,1685,585,6,-1,,1691,1111,0.0
5,1,18,1,1,1,526,1685,585,6,95, ,1691,1111,0.0
2,1,19,0,0,0,997,1743,357,5,-1,,1748,1354,0.0
3,1,19,1,0,0,997,1743,357,5,-1,,1748,1354,0.0
4,1,19,1,1,0,997,1743,357,5,-1,,1748,1354,0.0
5,1,19,1,1,1,997,1743,357,5,95, ,1748,1354,0.0
2,1,20,0,0,0,1492,677,9,1152,-1,,1829,1501,0.0
3,1,20,1,0,0,1492,677,9,1152,-1,,1829,1501,0.0
4,1,20,1,1,0,1492,677,9,1152,-1,,1829,1501,0.0
5,1,20,1,1,1,1492,677,9,1152,95, ,1829,1501,0.0
2,1,21,0,0,0,1282,1745,6,82,-1,,1827,1288,0.0
3,1,21,1,0,0,1282,1745,6,82,-1,,1827,1288,0.0
4,1,21,1,1,0,1282,1745,6,82,-1,,1827,1288,0.0
5,1,21,1,1,1,1282,1745,6,82,95, ,1827,1288,0.0
2,1,22,0,0,0,52,1822,428,4,-1,,1826,480,0.0
3,1,22,1,0,0,52,1822,428,4,-1,,1826,480,0.0
4,1,22,1,1,0,52,1822,428,4,-1,,1826,480,0.0
5,1,22,1,1,1,52,1822,428,4,95, ,1826,480,0.0
2,1,23,0,0,0,1006,1825,605,6,-1,,1831,1611,0.0
3,1,23,1,0,0,1006,1825,605,6,-1,,1831,1611,0.0
4,1,23,1,1,0,1006,1825,605,6,-1,,1831,1611,0.0
5,1,23,1,1,1,1006,1825,605,6,95, ,1831,1611,0.0
2,1,24,0,0,0,821,1877,805,65,-1,,1942,1626,0.0
3,1,24,1,0,0,821,1877,805,65,-1,,1942,1626,0.0
4,1,24,1,1,0,821,1877,805,65,-1,,1942,1626,0.0
5,1,24,1,1,1,821,1877,805,65,95,    ,1942,1626,0.0
2,1,25,0,0,0,1049,1877,383,10,-1,,1887,1432,0.0
3,1,25,1,0,0,1049,1877,383,10,-1,,1887,1432,0.0
4,1,25,1,1,0,1049,1877,383,10,-1,,1887,1432,0.0
5,1,25,1,1,1,1049,1877,107,10,95, ,1887,1156,0.0
5,1,25,1,1,2,1207,1877,225,10,95,   ,1887,1432,0.0
2,1,26,0,0,0,52,117,1571,1797,-1,,1914,1623,0.0
3,1,26,1,0,0,52,117,1571,1791,-1,,1908,1623,0.0
4,1,26,1,1,0,107,117,1516,28,-1,,145,1623,0.0
5,1,26,1,1,1,107,140,24,1,88,_,141,131,0.0
5,1,26,1,1,2,141,120,87,22,92,Page:,142,228,0.0
5,1,26,1,1,3,240,119,12,18,95,1,137,252,0.0
5,1,26,1,1,4,367,142,6,1,0,:,143,373,0.0
5,1,26,1,1,5,473,120,154,23,51,"530,",143,627,0.0
5,1,26,1,1,6,757,143,11,1,22,___,144,768,0.0
5,1,26,1,1,7,808,117,131,22,22,RAPPORT,139,939,0.0
5,1,26,1,1,8,950,117,35,21,92,DE,138,985,0.0
5,1,26,1,1,9,996,117,196,23,90,CHARGEMENT,140,1192,0.0
5,1,26,1,1,10,1202,130,6,2,90,-,132,1208,0.0
5,1,26,1,1,11,1218,118,405,27,90,VEHICULE,145,1623,0.0
5,1,26,1,1,12,1368,113,15,36,91,-,149,1383,0.0
5,1,26,1,1,13,1398,118,225,27,88,CONNAISSEMENT,145,1623,0.0
4,1,26,1,2,0,57,140,607,42,-1,,182,664,0.0
5,1,26,1,2,1,57,140,43,37,35,[,177,100,0.0
5,1,26,1,2,2,132,136,105,50,54,ROGUMENT,186,237,0.0
5,1,26,1,2,3,248,149,79,33,76,NUMBER,182,327,0.0
5,1,26,1,2,4,356,150,60,18,64,6439,168,416,0.0
5,1,26,1,2,5,529,146,37,24,49,one,170,566,0.0
5,1,26,1,2,6,572,146,16,24,0,DE,170,588,0.0
5,1,26,1,2,7,590,146,74,24,0,MrcatTiOn,170,664,0.0
4,1,26,1,3,0,519,175,1085,37,-1,,212,1604,0.0
5,1,26,1,3,1,519,175,133,37,95,mm/dd/yy,212,652,0.0
5,1,26,1,3,2,793,183,28,20,96,24,203,821,0.0
5,1,26,1,3,3,833,182,78,21,96,HOUR,203,911,0.0
5,1,26,1,3,4,922,182,117,22,71,NUMBER,204,1039,0.0
5,1,26,1,3,5,1038,176,7,37,23,_,213,1045,0.0
5,1,26,1,3,6,1060,181,207,28,23,(613)996-6666,209,1267,0.0
5,1,26,1,3,7,1305,183,138,22,80,-NUMERO,205,1443,0.0
5,1,26,1,3,8,1452,184,29,20,96,24,204,1481,0.0
5,1,26,1,3,9,1492,183,112,22,96,HEURES,205,1604,0.0
4,1,26,1,4,0,141,209,1226,31,-1,,240,1367,0.0
5,1,26,1,4,1,141,209,109,18,94,0362453,227,250,1.0
5,1,26,1,4,2,273,209,93,20,94,10/006,229,366,0.0
5,1,26,1,4,3,471,216,3,24,56,|,240,474,0.0
5,1,26,1,4,4,522,210,128,19,56,10/07/24,229,650,2.0
5,1,26,1,4,5,748,217,3,23,96,|,240,751,0.0
5,1,26,1,4,6,1043,213,232,22,92,COLLECT,235,1275,0.0
5,1,26,1,4,7,1175,209,15,34,91,-,243,1190,0.0
5,1,26,1,4,8,1203,213,72,22,86,FRAIS,235,1275,0.0
5,1,26,1,4,9,1286,213,81,22,90,VIRES,235,1367,0.0
4,1,26,1,5,0,56,236,1565,33,-1,,269,1621,0.0
5,1,26,1,5,1,56,236,3,3,68,|,239,59,0.0
5,1,26,1,5,2,66,236,200,19,91,CONSIGNEE/CUSTOMER,255,266,0.0
5,1,26,1,5,3,273,249,4,2,92,-,251,277,0.0
5,1,26,1,5,4,284,238,182,17,91,DESTINATAIRE/CLIENT,255,466,0.0
5,1,26,1,5,5,681,235,35,34,0,SOO,269,716,0.0
5,1,26,1,5,6,733,239,96,26,0,abLiggevent,265,829,0.0
5,1,26,1,5,7,844,235,9,34,91,|,269,853,0.0
5,1,26,1,5,8,856,240,223,17,65,CONSIGNOR,257,1079,0.0
5,1,26,1,5,9,960,235,9,34,89,-,269,969,0.0
5,1,26,1,5,10,977,240,102,17,92,EXPEDITEUR,257,1079,0.0
5,1,26,1,5,11,1140,240,11,1,0,—,241,1151,0.0
5,1,26,1,5,12,1444,258,1,11,89,|,269,1445,0.0
5,1,26,1,5,13,1461,241,15,25,31,NO,266,1476,0.0
5,1,26,1,5,14,1478,241,143,25,9,DETABUSSEMENT,266,1621,0.0
4,1,26,1,6,0,140,271,1443,21,-1,,292,1583,0.0
5,1,26,1,6,1,140,271,80,18,91,PETRO,289,220,0.0
5,1,26,1,6,2,238,271,98,18,96,CANADA,289,336,0.0
5,1,26,1,6,3,354,272,163,18,96,LUBRICANTS,290,517,0.0
5,1,26,1,6,4,538,273,46,17,96,INC,290,584,0.0
5,1,26,1,6,5,672,271,160,19,92,0005064508,290,832,0.0
5,1,26,1,6,6,854,273,97,18,91,|SUNCOR,291,951,0.0
5,1,26,1,6,7,970,273,99,19,95,ENERGY,292,1069,0.0
5,1,26,1,6,8,1086,274,133,18,95,MONTREAL,292,1219,0.0
5,1,26,1,6,9,1472,273,111,19,95,0082041,292,1583,0.0
4,1,26,1,7,0,140,300,1111,23,-1,,323,1251,0.0
5,1,26,1,7,1,140,301,61,19,89,PCLI,320,201,0.0
5,1,26,1,7,2,223,310,11,2,89,-,312,234,0.0
5,1,26,1,7,3,255,302,96,21,96,QUEBEC,323,351,0.0
5,1,26,1,7,4,372,301,44,19,96,302,320,416,0.0
5,1,26,1,7,5,671,300,161,21,91,0009406423,321,832,0.0
5,1,26,1,7,6,855,303,78,19,89,|11675,322,933,0.0
5,1,26,1,7,7,954,308,47,14,96,rue,322,1001,0.0
5,1,26,1,7,8,1021,303,164,19,96,Sherbrooke,322,1185,0.0
5,1,26,1,7,9,1204,305,47,17,96,est,322,1251,0.0
4,1,26,1,8,0,140,331,1343,23,-1,,354,1483,0.0
5,1,26,1,8,1,140,331,44,17,96,385,348,184,0.0
5,1,26,1,8,2,206,331,146,18,95,SOUTHDOWN,349,352,0.0
5,1,26,1,8,3,370,332,64,17,96,ROAD,349,434,0.0
5,1,26,1,8,4,852,333,143,21,95,"Montreal,",354,995,0.0
5,1,26,1,8,5,1020,334,31,20,90,QC,354,1051,0.0
5,1,26,1,8,6,1070,333,48,17,88,H1B,350,1118,0.0
5,1,26,1,8,7,1138,333,45,19,44,1¢3,352,1183,0.0
5,1,26,1,8,8,1277,333,68,21,92,(613),354,1345,0.0
5,1,26,1,8,9,1360,333,123,19,92,996-6666,352,1483,0.0
4,1,26,1,9,0,137,361,378,21,-1,,382,515,0.0
5,1,26,1,9,1,137,361,191,21,95,"MISSISSAUGA,",382,328,0.0
5,1,26,1,9,2,354,362,31,18,92,ON,380,385,0.0
5,1,26,1,9,3,403,361,49,19,81,L5J,380,452,0.0
5,1,26,1,9,4,471,361,44,19,39,2y¥3,380,515,0.0
4,1,26,1,10,0,264,393,837,21,-1,,414,1101,0.0
5,1,26,1,10,1,264,411,141,2,9,a,413,405,0.0
5,1,26,1,10,2,545,412,267,2,0,oC,414,812,0.0
5,1,26,1,10,3,852,393,117,19,0,Yannick,412,969,0.0
5,1,26,1,10,4,985,393,116,19,96,Mercier,412,1101,0.0
4,1,26,1,11,0,271,414,567,14,-1,,428,838,0.0
5,1,26,1,11,1,271,414,61,12,93,RELEASE,426,332,0.0
5,1,26,1,11,2,338,415,48,13,91,(C-of-A),428,386,0.0
5,1,26,1,11,3,391,415,59,11,93,NUMBER,426,450,0.0
5,1,26,1,11,4,561,415,78,12,92,CUSTOMER,427,639,0.0
5,1,26,1,11,5,645,415,75,12,96,PURCHASE,427,720,0.0
5,1,26,1,11,6,725,415,49,12,93,ORDER,427,774,0.0
5,1,26,1,11,7,780,416,58,12,36,NUMSER,428,838,0.0
4,1,26,1,12,0,611,429,190,12,-1,,441,801,0.0
5,1,26,1,12,1,611,429,16,11,95,No,440,627,0.0
5,1,26,1,12,2,633,429,17,11,95,DE,440,650,0.0
5,1,26,1,12,3,656,429,68,11,96,DEMANDE,440,724,0.0
5,1,26,1,12,4,729,430,18,10,92,OU,440,747,0.0
5,1,26,1,12,5,753,429,48,12,92,CLIENT,441,801,0.0
4,1,26,1,13,0,59,478,693,26,-1,,504,752,0.0
5,1,26,1,13,1,59,478,5,1,31,|,479,64,0.0
5,1,26,1,13,2,69,478,73,23,93,CARRIER,501,142,0.0
5,1,26,1,13,3,148,495,5,3,90,-,498,153,0.0
5,1,26,1,13,4,158,479,136,23,89,TRANSPORTEUR,502,294,0.0
4,1,26,1,14,0,138,512,1483,32,-1,,544,1621,0.0
5,1,26,1,14,1,138,512,48,19,94,GEO,531,186,0.0
5,1,26,1,14,2,203,514,17,16,94,A,530,220,0.0
5,1,26,1,14,3,237,514,64,16,96,HALL,530,301,0.0
5,1,26,1,14,4,571,514,111,18,82,9101535,532,682,0.0
5,1,26,1,14,5,706,515,4,18,46,|,533,710,0.0
5,1,26,1,14,6,727,521,147,22,8,VenicLENUMBER,543,874,0.0
5,1,26,1,14,7,916,523,147,21,29, LIGENSENUMBER,544,1063,0.0
5,1,26,1,14,8,1093,524,4,9,67,|,533,1097,0.0
5,1,26,1,14,9,1125,530,79,14,67,ADDRESS,544,1204,0.0
5,1,26,1,14,10,1210,530,22,14,95,OF,544,1232,0.0
5,1,26,1,14,11,1238,523,57,21,95,METER,544,1295,0.0
5,1,26,1,14,12,1301,531,34,13,91,AND,544,1335,0.0
5,1,26,1,14,13,1340,524,68,20,52,TRADER,544,1408,0.0
5,1,26,1,14,14,1506,524,115,2,31,|,526,1621,0.0
4,1,26,1,15,0,140,542,1333,25,-1,,567,1473,0.0
5,1,26,1,15,1,140,542,60,19,90,8800,561,200,0.0
5,1,26,1,15,2,222,552,12,2,90,-,554,234,0.0
5,1,26,1,15,3,256,542,28,19,82,6E,561,284,0.0
5,1,26,1,15,4,303,544,147,18,90,CROISSANT,562,450,0.0
5,1,26,1,15,5,730,552,20,13,96,No,565,750,0.0
5,1,26,1,15,6,756,552,22,13,92,DU,565,778,0.0
5,1,26,1,15,7,784,552,83,13,92,VEHICULE,565,867,0.0
5,1,26,1,15,8,916,552,71,13,96,NOMBRE,565,987,0.0
5,1,26,1,15,9,994,553,21,13,92,DE,566,1015,0.0
5,1,26,1,15,10,1022,552,63,14,91,PERMIS,566,1085,0.0
5,1,26,1,15,11,1093,544,9,32,78,|,576,1102,0.0
5,1,26,1,15,12,1112,553,90,13,38,L'AORESSE,566,1202,0.0
5,1,26,1,15,13,1208,553,22,13,96,DE,566,1230,0.0
5,1,26,1,15,14,1236,554,57,12,96,METRE,566,1293,0.0
5,1,26,1,15,15,1300,554,19,12,96,ET,566,1319,0.0
5,1,26,1,15,16,1326,554,21,12,92,DE,566,1347,0.0
5,1,26,1,15,17,1352,554,121,13,78,COMMERCANT,567,1473,0.0
4,1,26,1,16,0,137,569,1362,33,-1,,602,1499,0.0
5,1,26,1,16,1,137,569,82,33,96,ANJOU,602,219,0.0
5,1,26,1,16,2,470,597,128,1,0,a,598,598,0.0
5,1,26,1,16,3,720,575,61,18,92,1129,593,781,0.0
5,1,26,1,16,4,1104,576,78,18,96,11675,594,1182,0.0
5,1,26,1,16,5,1203,582,48,13,96,rue,595,1251,0.0
5,1,26,1,16,6,1271,576,163,19,96,Sherbrooke,595,1434,0.0
5,1,26,1,16,7,1454,579,45,16,96,est,595,1499,0.0
4,1,26,1,17,0,137,598,1294,35,-1,,633,1431,0.0
5,1,26,1,17,1,137,603,49,19,85,Hid,622,186,0.0
5,1,26,1,17,2,205,604,45,18,9,1AlL,622,250,0.0
5,1,26,1,17,3,480,598,56,35,20,CORPS,633,536,0.0
5,1,26,1,17,4,551,598,111,35,0,"FERTIECATION,",633,662,0.0
5,1,26,1,17,5,720,606,61,18,96,1059,624,781,0.0
5,1,26,1,17,6,1101,606,143,22,95,"Montreal,",628,1244,0.0
5,1,26,1,17,7,1270,608,30,21,92,QC,629,1300,0.0
5,1,26,1,17,8,1319,607,48,19,87,H1B,626,1367,0.0
5,1,26,1,17,9,1388,607,43,19,68,1C3,626,1431,0.0
4,1,26,1,18,0,144,634,1171,24,-1,,658,1315,0.0
5,1,26,1,18,1,144,634,68,21,0,(514),655,212,0.0
5,1,26,1,18,2,222,634,127,20,0,352-5550,654,349,0.0
5,1,26,1,18,3,1108,638,69,20,91,(613),658,1177,0.0
5,1,26,1,18,4,1192,638,123,18,91,996-6666,656,1315,0.0
4,1,26,1,19,0,61,673,1188,27,-1,,700,1249,0.0
5,1,26,1,19,1,61,673,3,1,34,f,674,64,0.0
5,1,26,1,19,2,152,673,51,1,32,a,674,203,0.0
5,1,26,1,19,3,502,674,31,1,12,_,675,533,0.0
5,1,26,1,19,4,1036,677,17,1,0,—,678,1053,0.0
5,1,26,1,19,5,1156,687,93,13,96,MEASURED,700,1249,0.0
4,1,26,1,20,0,68,693,1522,26,-1,,719,1590,0.0
5,1,26,1,20,1,68,693,142,14,92,PRODUCT/METER,707,210,0.0
5,1,26,1,20,2,1216,705,10,14,38,S,719,1226,0.0
5,1,26,1,20,3,1300,698,104,13,90,CORRECTED,711,1404,0.0
5,1,26,1,20,4,1414,688,9,33,90,|,721,1423,0.0
5,1,26,1,20,5,1432,698,46,13,95,TEMP,711,1478,0.0
5,1,26,1,20,6,1491,688,12,33,94,|,721,1503,0.0
5,1,26,1,20,7,1520,698,70,14,94,DENSITY,712,1590,0.0
4,1,26,1,21,0,62,706,1527,40,-1,,746,1589,0.0
5,1,26,1,21,1,62,717,141,29,46,_PRODUITMETER,746,203,0.0
5,1,26,1,21,2,361,708,80,14,43,PROQUCT,722,441,0.0
5,1,26,1,21,3,447,709,122,13,22,DESCRIPTION!,722,569,0.0
5,1,26,1,21,4,576,709,111,13,94,DESCRIPTION,722,687,0.0
5,1,26,1,21,5,694,710,22,12,94,DU,722,716,0.0
5,1,26,1,21,6,723,710,73,12,53,PRODUIT,722,796,0.0
5,1,26,1,21,7,1155,706,92,31,84,MESUREES,737,1247,0.0
5,1,26,1,21,8,1274,733,3,13,73,|,746,1277,0.0
5,1,26,1,21,9,1324,724,62,13,0,TOSS,737,1386,0.0
5,1,26,1,21,10,1422,724,69,13,40,CELSIUS},737,1491,0.0
5,1,26,1,21,11,1520,725,69,13,86,DENSITE,738,1589,0.0
4,1,26,1,22,0,139,746,1442,31,-1,,777,1581,0.0
5,1,26,1,22,1,139,754,93,19,93,103265,773,232,0.0
5,1,26,1,22,2,248,750,15,34,93,|,784,263,0.0
5,1,26,1,22,3,269,756,49,17,96,NOT,773,318,0.0
5,1,26,1,22,4,336,756,147,18,96,REGULATED,774,483,0.0
5,1,26,1,22,5,501,757,82,18,96,UNDER,775,583,0.0
5,1,26,1,22,6,601,757,49,18,96,TDG,775,650,0.0
5,1,26,1,22,7,941,746,1,15,0,',761,942,0.0
5,1,26,1,22,8,970,757,94,19,84,0.9637,776,1064,0.0
5,1,26,1,22,9,1170,758,78,19,96,43999,777,1248,0.0
5,1,26,1,22,10,1320,758,77,19,93,42402,777,1397,0.0
5,1,26,1,22,11,1420,759,60,18,68,|62.3,777,1480,0.0
5,1,26,1,22,12,1503,759,78,18,87,|910.6,777,1581,0.0
4,1,26,1,23,0,136,785,947,22,-1,,807,1083,0.0
5,1,26,1,23,1,136,785,97,19,89,MTR271,804,233,0.0
5,1,26,1,23,2,244,781,18,33,94,|,814,262,0.0
5,1,26,1,23,3,269,787,81,17,96,HEAVY,804,350,0.0
5,1,26,1,23,4,368,787,100,18,93,VACUUM,805,468,0.0
5,1,26,1,23,5,485,787,97,18,90,GASOIL,805,582,0.0
5,1,26,1,23,6,591,787,85,20,90,(HVGO),807,676,0.0
5,1,26,1,23,7,967,790,47,16,89,API,806,1014,0.0
5,1,26,1,23,8,1036,788,47,19,89,54B,807,1083,0.0
4,1,26,1,24,0,330,876,268,35,-1,,911,598,0.0
5,1,26,1,24,1,330,876,49,28,56,bol,904,379,0.0
5,1,26,1,24,2,441,882,45,28,28,PL,910,486,0.0
5,1,26,1,24,3,520,881,78,30,37,eos,911,598,0.0
4,1,26,1,25,0,301,938,640,100,-1,,1038,941,0.0
5,1,26,1,25,1,301,938,89,28,39,st,966,390,0.0
5,1,26,1,25,2,436,942,68,25,46,V2.,967,504,0.0
5,1,26,1,25,3,522,940,70,31,75,aN,971,592,0.0
5,1,26,1,25,4,939,959,2,79,95,|,1038,941,0.0
4,1,26,1,26,0,295,1001,646,79,-1,,1080,941,0.0
5,1,26,1,26,1,295,1001,179,41,0,Noexew,1042,474,0.0
5,1,26,1,26,2,504,1015,10,26,0, ),1041,514,0.0
5,1,26,1,26,3,550,1020,71,24,11,"a,",1044,621,0.0
5,1,26,1,26,4,624,1026,121,35,55,pent,1061,745,0.0
5,1,26,1,26,5,940,1040,1,40,94,|,1080,941,0.0
4,1,26,1,27,0,590,1095,205,38,-1,,1133,795,0.0
5,1,26,1,27,1,590,1095,205,38,8,t.12.2a4,1133,795,0.0
4,1,26,1,28,0,53,1154,1,11,-1,,1165,54,0.0
5,1,26,1,28,1,53,1154,1,11,84,|,1165,54,0.0
4,1,26,1,29,0,53,1186,789,12,-1,,1198,842,0.0
5,1,26,1,29,1,53,1186,1,12,96,|,1198,54,0.0
5,1,26,1,29,2,822,1189,20,7,89,~,1196,842,0.0
4,1,26,1,30,0,53,1217,846,60,-1,,1277,899,0.0
5,1,26,1,30,1,53,1218,1,11,96,|,1229,54,0.0
5,1,26,1,30,2,628,1217,113,30,0,=S=>——<,1247,741,0.0
5,1,26,1,30,3,747,1217,79,60,46,“7,1277,826,0.0
5,1,26,1,30,4,853,1226,46,9,85,—,1235,899,0.0
4,1,26,1,31,0,300,1486,380,24,-1,,1510,680,0.0
5,1,26,1,31,1,300,1487,80,18,96,Total,1505,380,0.0
5,1,26,1,31,2,400,1486,97,20,95,Litres,1506,497,0.0
5,1,26,1,31,3,516,1488,33,22,96,by,1510,549,0.0
5,1,26,1,31,4,568,1488,112,19,96,Product,1507,680,0.0
4,1,26,1,32,0,269,1517,1126,23,-1,,1540,1395,0.0
5,1,26,1,32,1,269,1517,94,19,96,103265,1536,363,0.0
5,1,26,1,32,2,466,1520,82,17,96,HEAVY,1537,548,0.0
5,1,26,1,32,3,565,1520,101,18,93,VACUUM,1538,666,0.0
5,1,26,1,32,4,682,1520,192,20,67,GASOIL(HVGO),1540,874,0.0
5,1,26,1,32,5,1168,1521,77,19,96,43999,1540,1245,0.0
5,1,26,1,32,6,1272,1532,1,5,87,|,1537,1273,0.0
5,1,26,1,32,7,1318,1522,77,18,87,42402,1540,1395,3.0
4,1,26,1,33,0,245,1566,2,10,-1,,1576,247,0.0
5,1,26,1,33,1,245,1566,2,10,88,|,1576,247,0.0
4,1,26,1,34,0,1272,1617,141,18,-1,,1635,1413,0.0
5,1,26,1,34,1,1272,1625,1,10,75,|,1635,1273,0.0
5,1,26,1,34,2,1411,1617,2,7,77,|,1624,1413,0.0
4,1,26,1,35,0,52,1666,1345,25,-1,,1691,1397,0.0
5,1,26,1,35,1,52,1673,1,11,53,|,1684,53,0.0
5,1,26,1,35,2,245,1680,3,6,70,|,1686,248,0.0
5,1,26,1,35,3,377,1685,4,1,55,:,1686,381,0.0
5,1,26,1,35,4,497,1686,20,2,92,=,1688,517,0.0
5,1,26,1,35,5,1114,1688,76,2,48,—,1690,1190,0.0
5,1,26,1,35,6,1270,1666,127,25,0,a,1691,1397,0.0
4,1,26,1,36,0,66,1698,863,20,-1,,1718,929,0.0
5,1,26,1,36,1,66,1698,2,12,69,|,1710,68,0.0
5,1,26,1,36,2,74,1698,50,17,75,hereby,1715,124,0.0
5,1,26,1,36,3,130,1698,53,14,77,declare,1712,183,0.0
5,1,26,1,36,4,189,1699,26,13,91,thal,1712,215,0.0
5,1,26,1,36,5,221,1699,22,13,96,the,1712,243,0.0
5,1,26,1,36,6,248,1700,61,12,95,contents,1712,309,0.0
5,1,26,1,36,7,316,1699,13,13,90,of,1712,329,0.0
5,1,26,1,36,8,334,1699,25,14,93,this,1713,359,0.0
5,1,26,1,36,9,364,1700,93,16,96,consignment,1716,457,0.0
5,1,26,1,36,10,464,1704,22,9,96,are,1713,486,0.0
5,1,26,1,36,11,492,1700,28,17,95,fully,1717,520,0.0
5,1,26,1,36,12,526,1700,26,13,95,and,1713,552,0.0
5,1,26,1,36,13,558,1700,75,17,16,accurately,1717,633,0.0
5,1,26,1,36,14,638,1701,71,13,71,described,1714,709,0.0
5,1,26,1,36,15,716,1701,43,13,96,above,1714,759,0.0
5,1,26,1,36,16,766,1702,16,16,95,by,1718,782,0.0
5,1,26,1,36,17,788,1702,21,12,95,the,1714,809,0.0
5,1,26,1,36,18,816,1705,47,13,76,proper,1718,863,0.0
5,1,26,1,36,19,868,1702,61,16,96,shipping,1718,929,0.0
4,1,26,1,37,0,66,1718,877,20,-1,,1738,943,0.0
5,1,26,1,37,1,66,1721,43,13,89,"name,",1734,109,0.0
5,1,26,1,37,2,116,1722,23,10,96,are,1732,139,0.0
5,1,26,1,37,3,144,1718,59,17,96,properly,1735,203,0.0
5,1,26,1,37,4,209,1718,67,14,93,classified,1732,276,0.0
5,1,26,1,37,5,282,1719,26,13,96,and,1732,308,0.0
5,1,26,1,37,6,314,1719,75,17,96,"packaged,",1736,389,0.0
5,1,26,1,37,7,395,1720,35,13,93,have,1733,430,0.0
5,1,26,1,37,8,436,1720,77,17,53,dangeraus,1737,513,0.0
5,1,26,1,37,9,518,1720,45,17,93,goods,1737,563,0.0
5,1,26,1,37,10,568,1720,44,17,43,sately,1737,612,0.0
5,1,26,1,37,11,618,1720,43,14,95,marks,1734,661,0.0
5,1,26,1,37,12,668,1721,59,16,94,properly,1737,727,0.0
5,1,26,1,37,13,732,1721,48,13,96,affixed,1734,780,0.0
5,1,26,1,37,14,786,1724,14,10,96,or,1734,800,0.0
5,1,26,1,37,15,806,1721,69,17,96,displayed,1738,875,0.0
5,1,26,1,37,16,880,1724,17,11,95,on,1735,897,0.0
5,1,26,1,37,17,904,1721,39,16,80,"them,",1737,943,0.0
4,1,26,1,38,0,65,1738,1553,23,-1,,1761,1618,0.0
5,1,26,1,38,1,65,1738,26,13,90,and,1751,91,0.0
5,1,26,1,38,2,98,1742,23,9,74,are,1751,121,0.0
5,1,26,1,38,3,126,1738,11,13,74,in,1751,137,0.0
5,1,26,1,38,4,144,1738,15,13,96,all,1751,159,0.0
5,1,26,1,38,5,165,1740,61,14,95,respects,1754,226,0.0
5,1,26,1,38,6,232,1739,11,12,96,in,1751,243,0.0
5,1,26,1,38,7,250,1742,47,13,88,proper,1755,297,0.0
5,1,26,1,38,8,302,1739,65,13,54,condillon,1752,367,0.0
5,1,26,1,38,9,373,1739,18,13,70,far,1752,391,0.0
5,1,26,1,38,10,396,1740,65,16,86,transporl,1756,461,0.0
5,1,26,1,38,11,467,1740,70,16,84,according,1756,537,0.0
5,1,26,1,38,12,544,1741,12,12,90,to,1753,556,0.0
5,1,26,1,38,13,562,1740,22,13,96,the,1753,584,0.0
5,1,26,1,38,14,589,1740,106,16,96,Transportation,1756,695,0.0
5,1,26,1,38,15,702,1740,13,13,96,of,1753,715,0.0
5,1,26,1,38,16,721,1740,79,17,88,Dangerous,1757,800,0.0
5,1,26,1,38,17,806,1740,48,14,94,Goods,1754,854,0.0
5,1,26,1,38,18,860,1741,87,16,90,Regulations,1757,947,0.0
5,1,26,1,38,19,960,1744,3,2,43,|,1746,963,0.0
5,1,26,1,38,20,984,1749,33,11,0,sige,1760,1017,0.0
5,1,26,1,38,21,1022,1749,12,11,0,mw,1760,1034,0.0
5,1,26,1,38,22,1111,1745,60,16,25,START,1761,1171,0.0
5,1,26,1,38,23,1176,1749,61,12,92,LOADING,1761,1237,0.0
5,1,26,1,38,24,1319,1750,44,11,68,FINISH,1761,1363,0.0
5,1,26,1,38,25,1370,1746,59,15,68,LOADING,1761,1429,0.0
5,1,26,1,38,26,1512,1747,106,14,0,TMEOUT,1761,1618,0.0
5,1,26,1,38,27,1601,1733,20,33,45,|,1766,1621,0.0
4,1,26,1,39,0,134,1763,1440,20,-1,,1783,1574,0.0
5,1,26,1,39,1,134,1763,80,19,96,Yanni,1782,214,0.0
5,1,26,1,39,2,218,1764,31,18,96,ck,1782,249,0.0
5,1,26,1,39,3,266,1764,115,19,95,Mercier,1783,381,0.0
5,1,26,1,39,4,984,1763,61,11,90,ARRIVEE,1774,1045,0.0
5,1,26,1,39,5,1096,1763,47,11,95,DEBUT,1774,1143,0.0
5,1,26,1,39,6,1148,1763,17,11,92,DU,1774,1165,0.0
5,1,26,1,39,7,1171,1763,98,11,91,CHARGEMENT,1774,1269,0.0
5,1,26,1,39,8,1308,1764,21,10,96,FIN,1774,1329,0.0
5,1,26,1,39,9,1334,1764,19,10,90,DU,1774,1353,0.0
5,1,26,1,39,10,1358,1764,98,11,70,CHARGEMENT,1775,1456,0.0
5,1,26,1,39,11,1519,1764,55,11,95,DEPART,1775,1574,0.0
4,1,26,1,40,0,128,1797,1450,23,-1,,1820,1578,0.0
5,1,26,1,40,1,128,1799,10,1,25,~~,1800,138,0.0
5,1,26,1,40,2,148,1799,203,21,90,Shipper,1820,351,0.0
5,1,26,1,40,3,211,1793,35,31,96,name,1824,246,0.0
5,1,26,1,40,4,253,1799,52,21,90,(please,1820,305,0.0
5,1,26,1,40,5,312,1793,42,31,91,print),1824,354,0.0
5,1,26,1,40,6,427,1800,95,1,0,a,1801,522,0.0
5,1,26,1,40,7,967,1797,78,18,95,04:36,1815,1045,0.0
5,1,26,1,40,8,1134,1798,77,17,94,04:43,1815,1211,0.0
5,1,26,1,40,9,1334,1798,78,18,94,05:07,1816,1412,0.0
5,1,26,1,40,10,1501,1798,77,18,95,05:07,1816,1578,0.0
4,1,26,1,41,0,66,1824,1497,29,-1,,1853,1563,0.0
5,1,26,1,41,1,66,1828,61,12,89,DRIVER,1840,127,0.0
5,1,26,1,41,2,133,1828,46,13,93,NAME,1841,179,0.0
5,1,26,1,41,3,185,1834,4,3,92,-,1837,189,0.0
5,1,26,1,41,4,196,1828,37,13,96,NOM,1841,233,0.0
5,1,26,1,41,5,239,1828,22,13,89,DU,1841,261,0.0
5,1,26,1,41,6,267,1828,116,14,0,"CONDUCTEUR,",1842,383,0.0
5,1,26,1,41,7,482,1824,9,1,0,~,1825,491,0.0
5,1,26,1,41,8,552,1825,14,28,22,"""|",1853,566,0.0
5,1,26,1,41,9,586,1830,61,13,60,DRIVER,1843,647,0.0
5,1,26,1,41,10,652,1825,74,18,30,NUMBER,1843,726,0.0
5,1,26,1,41,11,737,1821,12,36,55,|,1857,749,0.0
5,1,26,1,41,12,751,1825,70,18,88,DRIVER,1843,821,0.0
5,1,26,1,41,13,828,1826,95,18,80,SIGNATURE,1844,923,0.0
5,1,26,1,41,14,929,1838,4,2,91,-,1840,933,0.0
5,1,26,1,41,15,940,1827,95,17,96,SIGNATURE,1844,1035,0.0
5,1,26,1,41,16,1042,1831,22,13,92,DU,1844,1064,0.0
5,1,26,1,41,17,1070,1831,117,14,84,CONDUCTEUR,1845,1187,0.0
5,1,26,1,41,18,1274,1832,53,13,96,TOTAL,1845,1327,0.0
5,1,26,1,41,19,1333,1827,84,19,92,QUANTITY,1846,1417,0.0
5,1,26,1,41,20,1422,1839,4,2,91,-,1841,1426,0.0
5,1,26,1,41,21,1432,1827,61,19,91,QUANT.,1846,1493,0.0
5,1,26,1,41,22,1499,1828,64,17,91,TOTALE,1845,1563,0.0
4,1,26,1,42,0,572,1844,885,17,-1,,1861,1457,0.0
5,1,26,1,42,1,572,1844,19,13,95,No,1857,591,0.0
5,1,26,1,42,2,598,1844,21,13,80,DU,1857,619,0.0
5,1,26,1,42,3,626,1844,117,13,38,CONDUCTEUR),1857,743,0.0
5,1,26,1,42,4,1148,1844,8,14,51,‘,1858,1156,0.0
5,1,26,1,42,5,1455,1857,2,4,46,:,1861,1457,0.0
4,1,26,1,43,0,771,1830,758,75,-1,,1905,1529,0.0
5,1,26,1,43,1,771,1830,50,75,66,+,1905,821,0.0
5,1,26,1,43,2,1022,1868,17,17,4,c,1885,1039,0.0
5,1,26,1,43,3,1318,1858,77,19,86,43999,1877,1395,0.0
5,1,26,1,43,4,1432,1860,97,17,86,Litres,1877,1529,0.0
4,1,26,1,44,0,135,1881,1274,33,-1,,1914,1409,0.0
5,1,26,1,44,1,135,1881,130,33,33,FRANCOIS,1914,265,0.0
5,1,26,1,44,2,312,1881,87,33,76,MAJOR.,1914,399,0.0
5,1,26,1,44,3,1284,1889,79,19,53,38611,1908,1363,0.0
5,1,26,1,44,4,1387,1895,22,13,53,kg,1908,1409,0.0
2,1,27,0,0,0,1617,144,12,1759,-1,,1903,1629,0.0
3,1,27,1,0,0,1617,144,12,1759,-1,,1903,1629,0.0
4,1,27,1,1,0,1617,144,12,1759,-1,,1903,1629,0.0
5,1,27,1,1,1,1617,144,12,1759,95, ,1903,1629,0.0
2,1,28,0,0,0,51,1378,7,513,-1,,1891,58,0.0
3,1,28,1,0,0,51,1378,7,513,-1,,1891,58,0.0
4,1,28,1,1,0,51,1378,7,513,-1,,1891,58,0.0
5,1,28,1,1,1,51,1378,7,513,95, ,1891,58,0.0
2,1,29,0,0,0,1244,1828,2,74,-1,,1902,1246,0.0
3,1,29,1,0,0,1244,1828,2,74,-1,,1902,1246,0.0
4,1,29,1,1,0,1244,1828,2,74,-1,,1902,1246,0.0
5,1,29,1,1,1,1244,1828,2,74,95, ,1902,1246,0.0
2,1,30,0,0,0,47,1877,917,65,-1,,1942,964,0.0
3,1,30,1,0,0,47,1877,917,65,-1,,1942,964,0.0
4,1,30,1,1,0,47,1877,917,65,-1,,1942,964,0.0
5,1,30,1,1,1,47,1877,724,65,95, ,1942,771,0.0
5,1,30,1,1,2,821,1877,143,24,95, ,1901,964,0.0
2,1,31,0,0,0,74,1916,1525,55,-1,,1971,1599,0.0
3,1,31,1,0,0,74,1916,1525,55,-1,,1971,1599,0.0
4,1,31,1,1,0,74,1916,1525,18,-1,,1934,1599,0.0
5,1,31,1,1,1,74,1917,67,11,92,PRODUCT,1928,141,0.0
5,1,31,1,1,2,154,1910,12,28,64,|,1938,166,0.0
5,1,31,1,1,3,168,1918,35,10,81,TANK,1928,203,0.0
5,1,31,1,1,4,208,1918,69,11,88,CAPACITY|,1929,277,0.0
5,1,31,1,1,5,284,1918,49,11,89,WATER,1929,333,0.0
5,1,31,1,1,6,338,1918,21,11,6,DI?,1929,359,0.0
5,1,31,1,1,7,367,1918,56,11,87,BEFORE,1929,423,0.0
5,1,31,1,1,8,427,1918,32,12,18,O1PS),1930,459,0.0
5,1,31,1,1,9,478,1918,55,12,95,BEFORE,1930,533,0.0
5,1,31,1,1,10,538,1919,50,11,95,INVENT,1930,588,0.0
5,1,31,1,1,11,858,1920,67,11,87,PRODUCT,1931,925,0.0
5,1,31,1,1,12,938,1912,8,29,0,|,1941,946,0.0
5,1,31,1,1,13,948,1920,37,11,0,TANK,1931,985,0.0
5,1,31,1,1,14,990,1920,69,11,0,CAPACITY],1931,1059,0.0
5,1,31,1,1,15,1066,1921,49,11,89,WATER,1932,1115,0.0
5,1,31,1,1,16,1120,1921,21,11,86,DIP|,1932,1141,0.0
5,1,31,1,1,17,1152,1921,56,11,96,BEFORE,1932,1208,0.0
5,1,31,1,1,18,1214,1921,31,11,90,DIPS,1932,1245,0.0
5,1,31,1,1,19,1255,1912,8,29,91,|,1941,1263,0.0
5,1,31,1,1,20,1269,1921,56,11,85,@EFORE,1932,1325,0.0
5,1,31,1,1,21,1330,1922,50,10,96,INVENT,1932,1380,0.0
5,1,31,1,1,22,1383,1912,8,29,96,|,1941,1391,0.0
5,1,31,1,1,23,1396,1922,45,10,94,AFTER,1932,1441,0.0
5,1,31,1,1,24,1446,1916,33,18,19,DIPS,1934,1479,0.0
5,1,31,1,1,25,1492,1922,51,11,86,ENDING,1933,1543,0.0
5,1,31,1,1,26,1548,1922,51,11,90,INVENT,1933,1599,0.0
4,1,31,1,2,0,77,1928,1510,29,-1,,1957,1587,0.0
5,1,31,1,2,1,77,1934,61,11,87,PROOUIT,1945,138,0.0
5,1,31,1,2,2,157,1927,10,28,91,|,1955,167,0.0
5,1,31,1,2,3,170,1934,96,12,91,CONTENANCE,1946,266,0.0
5,1,31,1,2,4,276,1927,10,28,81,|,1955,286,0.0
5,1,31,1,2,5,286,1935,67,12,81,MEASURE,1947,353,0.0
5,1,31,1,2,6,362,1927,8,28,83,|,1955,370,0.0
5,1,31,1,2,7,378,1936,45,10,71,AVANT,1946,423,0.0
5,1,31,1,2,8,428,1936,15,11,71,LE,1947,443,0.0
5,1,31,1,2,9,491,1928,82,28,86,INVENTAIRE,1956,573,0.0
5,1,31,1,2,10,718,1929,87,28,18,INVENTAIRE.,1957,805,0.0
5,1,31,1,2,11,860,1937,61,11,93,PRODUIT,1948,921,0.0
5,1,31,1,2,12,937,1930,10,28,75,|,1958,947,0.0
5,1,31,1,2,13,952,1937,96,12,75,CONTENANCE,1949,1048,0.0
5,1,31,1,2,14,1059,1930,7,28,26,|,1958,1066,0.0
5,1,31,1,2,15,1068,1938,68,11,26,MEASURE,1949,1136,0.0
5,1,31,1,2,16,1143,1930,7,28,73,|,1958,1150,0.0
5,1,31,1,2,17,1163,1938,46,11,59,AVANT,1949,1209,0.0
5,1,31,1,2,18,1214,1938,15,11,59,LE,1949,1229,0.0
5,1,31,1,2,19,1283,1938,82,12,65,INVENTAIRE,1950,1365,0.0
5,1,31,1,2,20,1384,1931,10,28,58,|,1959,1394,0.0
5,1,31,1,2,21,1402,1938,67,12,91,APRESLE,1950,1469,0.0
5,1,31,1,2,22,1477,1931,15,28,66,|,1959,1492,0.0
5,1,31,1,2,23,1506,1939,81,11,83,INVENTAIRE,1950,1587,0.0
4,1,31,1,3,0,168,1952,1397,19,-1,,1971,1565,0.0
5,1,31,1,3,1,168,1952,103,16,70,DURESERVIOR,1968,271,0.0
5,1,31,1,3,2,278,1944,8,28,70,|,1972,286,0.0
5,1,31,1,3,3,298,1952,37,11,86,DEAU,1963,335,0.0
5,1,31,1,3,4,350,1944,15,28,73,|,1972,365,0.0
5,1,31,1,3,5,374,1952,75,12,46,JAUGEAGE,1964,449,0.0
5,1,31,1,3,6,496,1953,75,11,90,JAUGEAGE,1964,571,0.0
5,1,31,1,3,7,612,1954,75,11,78,JAUGEAGE,1965,687,0.0
5,1,31,1,3,8,735,1954,46,17,91,APRES,1971,781,0.0
5,1,31,1,3,9,949,1954,104,17,84,DURESERVIOR,1971,1053,0.0
5,1,31,1,3,10,1059,1947,8,28,71,|,1975,1067,0.0
5,1,31,1,3,11,1080,1955,37,11,71,DEAU,1966,1117,0.0
5,1,31,1,3,12,1160,1955,75,11,92,JAUGEAGE,1966,1235,0.0
5,1,31,1,3,13,1288,1955,75,11,51,YAUGEAGE,1966,1363,0.0
5,1,31,1,3,14,1379,1948,15,28,53,|,1976,1394,0.0
5,1,31,1,3,15,1396,1955,75,12,27,JAUGEAGE,1967,1471,0.0
5,1,31,1,3,16,1477,1965,3,6,27,|,1971,1480,0.0
5,1,31,1,3,17,1518,1956,47,11,30,APRES.,1967,1565,0.0
2,1,32,0,0,0,1151,1969,466,5,-1,,1974,1617,0.0
3,1,32,1,0,0,1151,1969,466,5,-1,,1974,1617,0.0
4,1,32,1,1,0,1151,1969,466,5,-1,,1974,1617,0.0
5,1,32,1,1,1,1151,1969,466,5,95, ,1974,1617,0.0
2,1,33,0,0,0,74,1966,470,4,-1,,1970,544,0.0
3,1,33,1,0,0,74,1966,470,4,-1,,1970,544,0.0
4,1,33,1,1,0,74,1966,470,4,-1,,1970,544,0.0
5,1,33,1,1,1,74,1966,470,4,95, ,1970,544,0.0
2,1,34,0,0,0,1259,2031,354,3,-1,,2034,1613,0.0
3,1,34,1,0,0,1259,2031,354,3,-1,,2034,1613,0.0
4,1,34,1,1,0,1259,2031,354,3,-1,,2034,1613,0.0
5,1,34,1,1,1,1259,2031,354,3,95, ,2034,1613,0.0
2,1,35,0,0,0,142,2028,140,1,-1,,2029,282,0.0
3,1,35,1,0,0,142,2028,140,1,-1,,2029,282,0.0
4,1,35,1,1,0,142,2028,140,1,-1,,2029,282,0.0
5,1,35,1,1,1,142,2028,140,1,95, ,2029,282,0.0
2,1,36,0,0,0,901,2090,421,5,-1,,2095,1322,0.0
3,1,36,1,0,0,901,2090,421,5,-1,,2095,1322,0.0
4,1,36,1,1,0,901,2090,421,5,-1,,2095,1322,0.0
5,1,36,1,1,1,901,2090,421,5,95, ,2095,1322,0.0
2,1,37,0,0,0,178,2089,601,4,-1,,2093,779,0.0
3,1,37,1,0,0,178,2089,601,4,-1,,2093,779,0.0
4,1,37,1,1,0,178,2089,601,4,-1,,2093,779,0.0
5,1,37,1,1,1,178,2089,601,4,95, ,2093,779,0.0
2,1,38,0,0,0,1387,1889,6,262,-1,,2151,1393,0.0
3,1,38,1,0,0,1387,1889,6,262,-1,,2151,1393,0.0
4,1,38,1,1,0,1387,1889,6,262,-1,,2151,1393,0.0
5,1,38,1,1,1,1387,1889,6,262,95, ,2151,1393,0.0
2,1,39,0,0,0,162,1911,3,238,-1,,2149,165,0.0
3,1,39,1,0,0,162,1911,3,238,-1,,2149,165,0.0
4,1,39,1,1,0,162,1911,3,238,-1,,2149,165,0.0
5,1,39,1,1,1,162,1911,3,238,95, ,2149,165,0.0
2,1,40,0,0,0,278,1911,3,238,-1,,2149,281,0.0
3,1,40,1,0,0,278,1911,3,238,-1,,2149,281,0.0
4,1,40,1,1,0,278,1911,3,238,-1,,2149,281,0.0
5,1,40,1,1,1,278,1911,3,238,95, ,2149,281,0.0
2,1,41,0,0,0,460,1912,4,238,-1,,2150,464,0.0
3,1,41,1,0,0,460,1912,4,238,-1,,2150,464,0.0
4,1,41,1,1,0,460,1912,4,238,-1,,2150,464,0.0
5,1,41,1,1,1,460,1912,4,238,95, ,2150,464,0.0
2,1,42,0,0,0,942,1913,4,239,-1,,2152,946,0.0
3,1,42,1,0,0,942,1913,4,239,-1,,2152,946,0.0
4,1,42,1,1,0,942,1913,4,239,-1,,2152,946,0.0
5,1,42,1,1,1,942,1913,4,239,95,,2152,946,0.0
