level,page_num,block_num,par_num,line_num,word_num,left,top,width,height,conf,text,bottom,right,label
1,1,0,0,0,0,0,0,1236,1658,-1,,1658,1236,0.0
2,1,1,0,0,0,596,1,1,50,-1,,51,597,0.0
3,1,1,1,0,0,596,1,1,50,-1,,51,597,0.0
4,1,1,1,1,0,596,1,1,50,-1,,51,597,0.0
5,1,1,1,1,1,596,1,1,50,95, ,51,597,0.0
2,1,2,0,0,0,1,50,658,3,-1,,53,659,0.0
3,1,2,1,0,0,1,50,658,3,-1,,53,659,0.0
4,1,2,1,1,0,1,50,658,3,-1,,53,659,0.0
5,1,2,1,1,1,1,50,658,3,95, ,53,659,0.0
2,1,3,0,0,0,12,4,648,91,-1,,95,660,0.0
3,1,3,1,0,0,12,4,648,91,-1,,95,660,0.0
4,1,3,1,1,0,55,4,399,16,-1,,20,454,0.0
5,1,3,1,1,1,55,5,103,15,90,REISSUED,20,158,0.0
5,1,3,1,1,2,216,7,6,7,27,{a,14,222,0.0
5,1,3,1,1,3,236,4,71,13,68,Employee's,17,307,0.0
5,1,3,1,1,4,311,4,36,10,96,social,14,347,0.0
5,1,3,1,1,5,352,4,48,13,95,security,17,400,0.0
5,1,3,1,1,6,406,4,48,10,95,number,14,454,0.0
4,1,3,1,2,0,44,28,616,29,-1,,57,660,0.0
5,1,3,1,2,1,44,28,126,29,96,STATEMENT,57,170,0.0
5,1,3,1,2,2,312,28,150,15,89,077-49-4905,43,462,0.0
5,1,3,1,2,3,612,29,28,10,86,OMB,39,640,0.0
5,1,3,1,2,4,646,29,14,10,96,No.,39,660,0.0
4,1,3,1,3,0,12,56,194,13,-1,,69,206,0.0
5,1,3,1,3,1,12,56,7,10,81,b,66,19,0.0
5,1,3,1,3,2,29,56,54,13,48,Employer,69,83,0.0
5,1,3,1,3,3,88,56,70,10,96,identification,66,158,0.0
5,1,3,1,3,4,164,56,42,10,96,number,66,206,0.0
4,1,3,1,4,0,66,80,137,15,-1,,95,203,0.0
5,1,3,1,4,1,66,80,137,15,88,37-2766773,95,203,0.0
2,1,4,0,0,0,1,102,658,3,-1,,105,659,0.0
3,1,4,1,0,0,1,102,658,3,-1,,105,659,0.0
4,1,4,1,1,0,1,102,658,3,-1,,105,659,0.0
5,1,4,1,1,1,1,102,658,3,95, ,105,659,0.0
2,1,5,0,0,0,13,108,252,13,-1,,121,265,0.0
3,1,5,1,0,0,13,108,252,13,-1,,121,265,0.0
4,1,5,1,1,0,13,108,252,13,-1,,121,265,0.0
5,1,5,1,1,1,29,108,62,13,78,Employers,121,91,0.0
5,1,5,1,1,2,97,111,30,7,91,"name,",118,127,0.0
5,1,5,1,1,3,137,108,44,10,95,"address,",118,181,0.0
5,1,5,1,1,4,191,108,19,10,96,and,118,210,0.0
5,1,5,1,1,5,215,108,18,10,96,ZIP,118,233,0.0
5,1,5,1,1,6,239,108,26,10,96,code,118,265,0.0
2,1,6,0,0,0,64,133,279,15,-1,,148,343,0.0
3,1,6,1,0,0,64,133,279,15,-1,,148,343,0.0
4,1,6,1,1,0,64,133,279,15,-1,,148,343,0.0
5,1,6,1,1,1,64,133,224,15,92,Richardson-Brown,148,288,0.0
5,1,6,1,1,2,303,134,40,14,96,PLC,148,343,0.0
2,1,7,0,0,0,781,3,112,37,-1,,40,893,0.0
3,1,7,1,0,0,781,3,112,37,-1,,40,893,0.0
4,1,7,1,1,0,782,3,111,14,-1,,17,893,0.0
5,1,7,1,1,1,782,3,35,14,96,"Safe,",17,817,0.0
5,1,7,1,1,2,822,3,71,14,96,"Accurate,",17,893,0.0
4,1,7,1,2,0,781,28,82,12,-1,,40,863,0.0
5,1,7,1,2,1,781,28,44,12,96,FAST!,40,825,0.0
5,1,7,1,2,2,835,28,28,12,96,Use,40,863,0.0
2,1,8,0,0,0,681,56,214,39,-1,,95,895,0.0
3,1,8,1,0,0,681,56,214,39,-1,,95,895,0.0
4,1,8,1,1,0,681,56,214,13,-1,,69,895,0.0
5,1,8,1,1,1,681,56,4,10,25,T,66,685,0.0
5,1,8,1,1,2,704,56,40,13,28,"Wages,",69,744,0.0
5,1,8,1,1,3,753,57,24,12,93,"tips,",69,777,0.0
5,1,8,1,1,4,783,56,28,10,95,other,66,811,0.0
5,1,8,1,1,5,819,57,76,12,77,compensation,69,895,0.0
4,1,8,1,2,0,725,80,109,15,-1,,95,834,0.0
5,1,8,1,2,1,725,80,109,15,0,ยง5151...93,95,834,0.0
2,1,9,0,0,0,671,29,57,10,-1,,39,728,0.0
3,1,9,1,0,0,671,29,57,10,-1,,39,728,0.0
4,1,9,1,1,0,671,29,57,10,-1,,39,728,0.0
5,1,9,1,1,1,671,29,57,10,79,1645-0008,39,728,0.0
2,1,10,0,0,0,900,4,293,50,-1,,54,1193,0.0
3,1,10,1,0,0,904,4,289,40,-1,,44,1193,0.0
4,1,10,1,1,0,1047,4,146,12,-1,,16,1193,0.0
5,1,10,1,1,1,1047,4,31,12,95,Visit,16,1078,0.0
5,1,10,1,1,2,1082,4,20,12,95,the,16,1102,0.0
5,1,10,1,1,3,1108,4,23,12,96,IRS,16,1131,0.0
5,1,10,1,1,4,1136,4,57,12,96,Website,16,1193,0.0
4,1,10,1,2,0,900,6,280,48,-1,,54,1180,0.0
5,1,10,1,2,1,900,6,56,48,12,e~,54,956,0.0
5,1,10,1,2,2,972,6,72,48,78,tile),54,1044,0.0
5,1,10,1,2,3,1048,30,12,11,93,at,41,1060,0.0
5,1,10,1,2,4,1064,29,116,15,34,www.irs.goviefile.,44,1180,0.0
2,1,11,0,0,0,970,56,185,10,-1,,66,1155,0.0
3,1,11,1,0,0,970,56,185,10,-1,,66,1155,0.0
4,1,11,1,1,0,970,56,185,10,-1,,66,1155,0.0
5,1,11,1,1,1,970,56,7,10,56,2,66,977,0.0
5,1,11,1,1,2,995,56,41,10,87,Federal,66,1036,0.0
5,1,11,1,1,3,1042,56,113,10,91,income,66,1155,0.0
5,1,11,1,1,4,1087,47,17,28,96,tax,75,1104,0.0
5,1,11,1,1,5,1110,56,45,10,95,withheld,66,1155,0.0
2,1,12,0,0,0,660,153,576,5,-1,,158,1236,0.0
3,1,12,1,0,0,660,153,576,5,-1,,158,1236,0.0
4,1,12,1,1,0,660,153,576,5,-1,,158,1236,0.0
5,1,12,1,1,1,660,153,576,5,95, ,158,1236,0.0
2,1,13,0,0,0,660,204,576,5,-1,,209,1236,0.0
3,1,13,1,0,0,660,204,576,5,-1,,209,1236,0.0
4,1,13,1,1,0,660,204,576,5,-1,,209,1236,0.0
5,1,13,1,1,1,660,204,576,5,95, ,209,1236,0.0
2,1,14,0,0,0,1,256,658,3,-1,,259,659,0.0
3,1,14,1,0,0,1,256,658,3,-1,,259,659,0.0
4,1,14,1,1,0,1,256,658,3,-1,,259,659,0.0
5,1,14,1,1,1,1,256,658,3,95, ,259,659,0.0
2,1,15,0,0,0,1,308,658,3,-1,,311,659,0.0
3,1,15,1,0,0,1,308,658,3,-1,,311,659,0.0
4,1,15,1,1,0,1,308,658,3,-1,,311,659,0.0
5,1,15,1,1,1,1,308,658,3,95, ,311,659,0.0
2,1,16,0,0,0,11,167,457,159,-1,,326,468,0.0
3,1,16,1,0,0,65,167,250,15,-1,,182,315,0.0
4,1,16,1,1,0,65,167,250,15,-1,,182,315,0.0
5,1,16,1,1,1,65,167,54,15,96,2936,182,119,0.0
5,1,16,1,1,2,135,167,83,15,96,Howard,182,218,0.0
5,1,16,1,1,3,232,167,83,15,96,Radial,182,315,0.0
3,1,16,2,0,0,11,201,457,71,-1,,272,468,0.0
4,1,16,2,1,0,64,201,404,20,-1,,221,468,0.0
5,1,16,2,1,1,64,201,55,15,95,West,216,119,0.0
5,1,16,2,1,2,134,201,98,20,95,Raymond,221,232,0.0
5,1,16,2,1,3,260,202,29,14,96,NV,216,289,0.0
5,1,16,2,1,4,332,201,136,15,95,44735-6958,216,468,0.0
4,1,16,2,2,0,11,262,105,10,-1,,272,116,0.0
5,1,16,2,2,1,11,262,7,10,0,d_,272,18,0.0
5,1,16,2,2,2,29,262,39,10,96,Control,272,68,0.0
5,1,16,2,2,3,74,262,42,10,96,number,272,116,0.0
3,1,16,3,0,0,12,286,327,40,-1,,326,339,0.0
4,1,16,3,1,0,66,286,94,15,-1,,301,160,0.0
5,1,16,3,1,1,66,286,94,15,96,4741345,301,160,0.0
4,1,16,3,2,0,12,313,327,13,-1,,326,339,0.0
5,1,16,3,2,1,29,313,65,13,81,Employee's,326,94,0.0
5,1,16,3,2,2,99,313,20,10,94,first,323,119,0.0
5,1,16,3,2,3,125,316,30,7,94,name,323,155,0.0
5,1,16,3,2,4,161,313,19,10,96,and,323,180,0.0
5,1,16,3,2,5,186,313,28,10,95,initial,323,214,0.0
5,1,16,3,2,6,280,313,23,10,95,Last,323,303,0.0
5,1,16,3,2,7,309,316,30,7,94,name,323,339,0.0
2,1,17,0,0,0,63,358,241,22,-1,,380,304,0.0
3,1,17,1,0,0,63,358,241,22,-1,,380,304,0.0
4,1,17,1,1,0,63,358,241,22,-1,,380,304,0.0
5,1,17,1,1,1,63,358,80,22,95,April,380,143,0.0
5,1,17,1,1,2,193,358,111,22,96,Hensley,380,304,0.0
2,1,18,0,0,0,66,396,492,56,-1,,452,558,0.0
3,1,18,1,0,0,66,396,492,56,-1,,452,558,0.0
4,1,18,1,1,0,66,396,460,17,-1,,413,526,0.0
5,1,18,1,1,1,66,396,76,17,96,31403,413,142,1.0
5,1,18,1,1,2,160,396,80,17,96,David,413,240,1.0
5,1,18,1,1,3,257,396,109,17,95,Circles,413,366,1.0
5,1,18,1,1,4,386,396,77,17,95,Suite,413,463,1.0
5,1,18,1,1,5,482,396,44,17,96,863,413,526,1.0
4,1,18,1,2,0,402,435,156,17,-1,,452,558,0.0
5,1,18,1,2,1,402,435,156,17,94,45881-3334,452,558,0.0
2,1,19,0,0,0,64,435,272,17,-1,,452,336,0.0
3,1,19,1,0,0,64,435,272,17,-1,,452,336,0.0
4,1,19,1,1,0,64,435,272,17,-1,,452,336,0.0
5,1,19,1,1,1,64,436,63,16,92,West,452,127,1.0
5,1,19,1,1,2,144,435,127,17,91,Erinfort,452,271,1.0
5,1,19,1,1,3,304,436,32,16,95,WY,452,336,1.0
2,1,20,0,0,0,11,545,213,13,-1,,558,224,0.0
3,1,20,1,0,0,11,545,213,13,-1,,558,224,0.0
4,1,20,1,1,0,11,545,213,13,-1,,558,224,0.0
5,1,20,1,1,1,11,545,83,13,48,f_Employee's,558,94,0.0
5,1,20,1,1,2,100,545,44,10,91,address,555,144,0.0
5,1,20,1,1,3,150,545,19,10,95,and,555,169,0.0
5,1,20,1,1,4,174,545,18,10,96,ZIP,555,192,0.0
5,1,20,1,1,5,197,545,27,10,91,code,555,224,0.0
2,1,21,0,0,0,660,364,576,5,-1,,369,1236,0.0
3,1,21,1,0,0,660,364,576,5,-1,,369,1236,0.0
4,1,21,1,1,0,660,364,576,5,-1,,369,1236,0.0
5,1,21,1,1,1,660,364,576,5,95, ,369,1236,0.0
2,1,22,0,0,0,689,393,204,3,-1,,396,893,0.0
3,1,22,1,0,0,689,393,204,3,-1,,396,893,0.0
4,1,22,1,1,0,689,393,204,3,-1,,396,893,0.0
5,1,22,1,1,1,689,393,204,3,95, ,396,893,0.0
2,1,23,0,0,0,689,394,1,28,-1,,422,690,0.0
3,1,23,1,0,0,689,394,1,28,-1,,422,690,0.0
4,1,23,1,1,0,689,394,1,28,-1,,422,690,0.0
5,1,23,1,1,1,689,394,1,28,95, ,422,690,0.0
2,1,24,0,0,0,718,394,1,28,-1,,422,719,0.0
3,1,24,1,0,0,718,394,1,28,-1,,422,719,0.0
4,1,24,1,1,0,718,394,1,28,-1,,422,719,0.0
5,1,24,1,1,1,718,394,1,28,95, ,422,719,0.0
2,1,25,0,0,0,776,394,1,28,-1,,422,777,0.0
3,1,25,1,0,0,776,394,1,28,-1,,422,777,0.0
4,1,25,1,1,0,776,394,1,28,-1,,422,777,0.0
5,1,25,1,1,1,776,394,1,28,95, ,422,777,0.0
2,1,26,0,0,0,805,394,1,28,-1,,422,806,0.0
3,1,26,1,0,0,805,394,1,28,-1,,422,806,0.0
4,1,26,1,1,0,805,394,1,28,-1,,422,806,0.0
5,1,26,1,1,1,805,394,1,28,95, ,422,806,0.0
2,1,27,0,0,0,863,394,1,28,-1,,422,864,0.0
3,1,27,1,0,0,863,394,1,28,-1,,422,864,0.0
4,1,27,1,1,0,863,394,1,28,-1,,422,864,0.0
5,1,27,1,1,1,863,394,1,28,95, ,422,864,0.0
2,1,28,0,0,0,892,394,1,28,-1,,422,893,0.0
3,1,28,1,0,0,892,394,1,28,-1,,422,893,0.0
4,1,28,1,1,0,892,394,1,28,-1,,422,893,0.0
5,1,28,1,1,1,892,394,1,28,95, ,422,893,0.0
2,1,29,0,0,0,660,419,576,7,-1,,426,1236,0.0
3,1,29,1,0,0,660,419,576,7,-1,,426,1236,0.0
4,1,29,1,1,0,660,419,576,7,-1,,426,1236,0.0
5,1,29,1,1,1,660,419,576,7,95, ,426,1236,0.0
2,1,30,0,0,0,689,419,547,7,-1,,426,1236,0.0
3,1,30,1,0,0,689,419,547,7,-1,,426,1236,0.0
4,1,30,1,1,0,689,419,547,7,-1,,426,1236,0.0
5,1,30,1,1,1,689,419,547,7,95, ,426,1236,0.0
2,1,31,0,0,0,689,419,547,7,-1,,426,1236,0.0
3,1,31,1,0,0,689,419,547,7,-1,,426,1236,0.0
4,1,31,1,1,0,689,419,547,7,-1,,426,1236,0.0
5,1,31,1,1,1,689,419,547,7,95, ,426,1236,0.0
2,1,32,0,0,0,689,419,547,7,-1,,426,1236,0.0
3,1,32,1,0,0,689,419,547,7,-1,,426,1236,0.0
4,1,32,1,1,0,689,419,547,7,-1,,426,1236,0.0
5,1,32,1,1,1,689,419,547,7,95, ,426,1236,0.0
2,1,33,0,0,0,950,479,286,3,-1,,482,1236,0.0
3,1,33,1,0,0,950,479,286,3,-1,,482,1236,0.0
4,1,33,1,1,0,950,479,286,3,-1,,482,1236,0.0
5,1,33,1,1,1,950,479,286,3,95, ,482,1236,0.0
2,1,34,0,0,0,674,80,501,450,-1,,530,1175,0.0
3,1,34,1,0,0,674,80,501,450,-1,,530,1175,0.0
4,1,34,1,1,0,986,80,108,15,-1,,95,1094,0.0
5,1,34,1,1,1,986,80,108,15,90,16606.17,95,1094,0.0
4,1,34,1,2,0,681,108,471,13,-1,,121,1152,0.0
5,1,34,1,2,1,681,108,6,10,69,3,118,687,0.0
5,1,34,1,2,2,705,108,34,10,89,Social,118,739,0.0
5,1,34,1,2,3,747,100,43,25,93,security,125,790,0.0
5,1,34,1,2,4,797,111,33,10,96,wages,121,830,0.0
5,1,34,1,2,5,970,108,7,10,66,4,118,977,0.0
5,1,34,1,2,6,995,108,34,10,71,Social,118,1029,0.0
5,1,34,1,2,7,1035,108,117,13,96,security,121,1152,0.0
5,1,34,1,2,8,1084,100,18,25,96,tax,125,1102,0.0
5,1,34,1,2,9,1107,108,45,13,96,withheld,121,1152,0.0
4,1,34,1,3,0,725,133,355,15,-1,,148,1080,0.0
5,1,34,1,3,1,725,133,108,15,89,67588.01,148,833,0.0
5,1,34,1,3,2,986,133,94,15,96,5170.48,148,1080,0.0
4,1,34,1,4,0,681,159,438,13,-1,,172,1119,0.0
5,1,34,1,4,1,681,159,6,10,70,5,169,687,0.0
5,1,34,1,4,2,705,159,51,10,75,Medicare,169,756,0.0
5,1,34,1,4,3,761,162,36,10,96,wages,172,797,0.0
5,1,34,1,4,4,803,159,19,10,90,and,169,822,0.0
5,1,34,1,4,5,827,160,20,12,90,tips,172,847,0.0
5,1,34,1,4,6,970,159,6,10,60,6,169,976,0.0
5,1,34,1,4,7,995,159,51,10,74,Medicare,169,1046,0.0
5,1,34,1,4,8,1051,160,18,9,96,tax,169,1069,0.0
5,1,34,1,4,9,1073,159,46,10,95,withheld,169,1119,0.0
4,1,34,1,5,0,725,184,419,15,-1,,199,1144,0.0
5,1,34,1,5,1,725,184,109,15,91,50518.06,199,834,0.0
5,1,34,1,5,2,1050,184,94,15,94,1465.02,199,1144,0.0
4,1,34,1,6,0,681,210,391,13,-1,,223,1072,0.0
5,1,34,1,6,1,681,210,5,10,70,7,220,686,0.0
5,1,34,1,6,2,705,210,34,10,90,Social,220,739,0.0
5,1,34,1,6,3,745,202,43,25,96,security,227,788,0.0
5,1,34,1,6,4,793,211,21,12,96,tips,223,814,0.0
5,1,34,1,6,5,971,210,5,10,87,8,220,976,0.0
5,1,34,1,6,6,994,210,53,10,77,Allocated,220,1047,0.0
5,1,34,1,6,7,1052,211,20,12,95,tips,223,1072,0.0
4,1,34,1,7,0,725,235,434,15,-1,,250,1159,0.0
5,1,34,1,7,1,725,235,108,15,90,67588.01,250,833,0.0
5,1,34,1,7,2,1050,235,109,15,90,50518.06,250,1159,0.0
4,1,34,1,8,0,680,262,453,13,-1,,275,1133,0.0
5,1,34,1,8,1,680,262,7,10,64,9,272,687,0.0
5,1,34,1,8,2,704,262,48,10,73,Advance,272,752,0.0
5,1,34,1,8,3,758,262,19,10,92,EIC,272,777,0.0
5,1,34,1,8,4,783,263,48,12,96,payment,275,831,0.0
5,1,34,1,8,5,964,262,13,10,80,10,272,977,0.0
5,1,34,1,8,6,995,262,60,13,75,Dependent,275,1055,0.0
5,1,34,1,8,7,1061,265,23,7,96,care,272,1084,0.0
5,1,34,1,8,8,1090,262,43,10,93,benefits,272,1133,0.0
4,1,34,1,9,0,1049,286,39,15,-1,,301,1088,0.0
5,1,34,1,9,1,1049,286,39,15,96,238,301,1088,0.0
4,1,34,1,10,0,674,313,501,13,-1,,326,1175,0.0
5,1,34,1,10,1,674,313,11,10,50,11,323,685,0.0
5,1,34,1,10,2,705,313,68,13,77,Nonqualified,326,773,0.0
5,1,34,1,10,3,779,313,29,13,94,plans,326,808,0.0
5,1,34,1,10,4,966,313,20,10,57,12a,323,986,0.0
5,1,34,1,10,5,1009,313,22,10,40,See,323,1031,0.0
5,1,34,1,10,6,1037,313,71,10,95,instructions,323,1108,0.0
5,1,34,1,10,7,1112,313,17,10,95,for,323,1129,0.0
5,1,34,1,10,8,1134,313,22,10,95,box,323,1156,0.0
5,1,34,1,10,9,1162,313,13,10,96,12,323,1175,0.0
4,1,34,1,11,0,724,344,378,15,-1,,359,1102,0.0
5,1,34,1,11,1,724,344,39,15,96,210,359,763,0.0
5,1,34,1,11,2,1006,345,13,14,87,G,359,1019,0.0
5,1,34,1,11,3,1050,344,52,15,83,|8500,359,1102,0.0
4,1,34,1,12,0,674,365,313,22,-1,,387,987,0.0
5,1,34,1,12,1,674,370,13,10,83,13,380,687,0.0
5,1,34,1,12,2,693,371,43,10,81,Statutory,381,736,0.0
5,1,34,1,12,3,776,365,54,22,92,Retirement,387,830,0.0
5,1,34,1,12,4,866,366,58,21,43,Third-party.,387,924,0.0
5,1,34,1,12,5,966,370,21,10,85,12b,380,987,0.0
4,1,34,1,13,0,693,385,213,9,-1,,394,906,0.0
5,1,34,1,13,1,693,385,45,9,68,emlgyee,394,738,0.0
5,1,34,1,13,2,780,385,18,9,54,plan,394,798,0.0
5,1,34,1,13,3,867,385,18,8,62,sick,393,885,0.0
5,1,34,1,13,4,895,387,11,7,62,pay,394,906,0.0
4,1,34,1,14,0,786,398,303,15,-1,,413,1089,0.0
5,1,34,1,14,1,786,402,10,11,95,x,413,796,0.0
5,1,34,1,14,2,873,402,10,11,94,x,413,883,0.0
5,1,34,1,14,3,1049,398,40,15,96,489,413,1089,0.0
4,1,34,1,15,0,674,427,312,13,-1,,440,986,0.0
5,1,34,1,15,1,674,427,13,10,49,44,437,687,0.0
5,1,34,1,15,2,705,427,31,10,81,Other,437,736,0.0
5,1,34,1,15,3,741,427,23,13,86,(see,440,764,0.0
5,1,34,1,15,4,770,427,50,10,96,enclosed,437,820,0.0
5,1,34,1,15,5,826,427,35,10,96,Notice,437,861,0.0
5,1,34,1,15,6,866,428,10,9,96,to,437,876,0.0
5,1,34,1,15,7,882,427,61,13,94,Employee),440,943,0.0
5,1,34,1,15,8,949,419,11,25,46,|,444,960,0.0
5,1,34,1,15,9,966,427,20,10,38,12c,437,986,0.0
4,1,34,1,16,0,1005,458,84,15,-1,,473,1089,0.0
5,1,34,1,16,1,1005,459,13,14,78,D,473,1018,0.0
5,1,34,1,16,2,1050,458,39,15,62,(999,473,1089,0.0
4,1,34,1,17,0,966,484,20,10,-1,,494,986,0.0
5,1,34,1,17,1,966,484,20,10,88,12d,494,986,0.0
4,1,34,1,18,0,1006,515,82,15,-1,,530,1088,0.0
5,1,34,1,18,1,1006,516,13,14,88,G,530,1019,0.0
5,1,34,1,18,2,1050,515,38,15,80,|381,530,1088,0.0
2,1,35,0,0,0,1042,326,3,212,-1,,538,1045,0.0
3,1,35,1,0,0,1042,326,3,212,-1,,538,1045,0.0
4,1,35,1,1,0,1042,326,3,212,-1,,538,1045,0.0
5,1,35,1,1,1,1042,326,3,212,95, ,538,1045,0.0
2,1,36,0,0,0,950,536,286,3,-1,,539,1236,0.0
3,1,36,1,0,0,950,536,286,3,-1,,539,1236,0.0
4,1,36,1,1,0,950,536,286,3,-1,,539,1236,0.0
5,1,36,1,1,1,950,536,286,3,95, ,539,1236,0.0
2,1,37,0,0,0,659,105,3,454,-1,,559,662,0.0
3,1,37,1,0,0,659,105,3,454,-1,,559,662,0.0
4,1,37,1,1,0,659,105,3,454,-1,,559,662,0.0
5,1,37,1,1,1,659,105,3,454,95, ,559,662,0.0
2,1,38,0,0,0,949,105,3,454,-1,,559,952,0.0
3,1,38,1,0,0,949,105,3,454,-1,,559,952,0.0
4,1,38,1,1,0,949,105,3,454,-1,,559,952,0.0
5,1,38,1,1,1,949,105,3,454,95, ,559,952,0.0
2,1,39,0,0,0,1,555,1235,7,-1,,562,1236,0.0
3,1,39,1,0,0,1,555,1235,7,-1,,562,1236,0.0
4,1,39,1,1,0,1,555,1235,7,-1,,562,1236,0.0
5,1,39,1,1,1,1,555,1235,7,95, ,562,1236,0.0
2,1,40,0,0,0,6,562,263,40,-1,,602,269,0.0
3,1,40,1,0,0,6,562,263,40,-1,,602,269,0.0
4,1,40,1,1,0,6,562,241,13,-1,,575,247,0.0
5,1,40,1,1,1,6,562,13,10,90,15,572,19,0.0
5,1,40,1,1,2,29,562,29,10,67,State!,572,58,0.0
5,1,40,1,1,3,88,562,62,13,55,Employer's,575,150,0.0
5,1,40,1,1,4,156,563,27,9,84,state,572,183,0.0
5,1,40,1,1,5,189,562,10,10,84,ID,572,199,0.0
5,1,40,1,1,6,205,562,42,10,96,number,572,247,0.0
4,1,40,1,2,0,16,587,253,15,-1,,602,269,0.0
5,1,40,1,2,1,16,588,27,14,72,DC,602,43,0.0
5,1,40,1,2,2,132,587,137,15,86,786-41-049,602,269,0.0
2,1,41,0,0,0,349,562,146,13,-1,,575,495,0.0
3,1,41,1,0,0,349,562,146,13,-1,,575,495,0.0
4,1,41,1,1,0,349,562,146,13,-1,,575,495,0.0
5,1,41,1,1,1,349,562,12,10,52,16,572,361,0.0
5,1,41,1,1,2,370,562,29,10,91,State,572,399,0.0
5,1,41,1,1,3,404,565,36,10,83,"wages,",575,440,0.0
5,1,41,1,1,4,449,563,20,12,94,"tips,",575,469,0.0
5,1,41,1,1,5,479,563,16,9,66,ete,572,495,0.0
2,1,42,0,0,0,346,587,110,15,-1,,602,456,0.0
3,1,42,1,0,0,346,587,110,15,-1,,602,456,0.0
4,1,42,1,1,0,346,587,110,15,-1,,602,456,0.0
5,1,42,1,1,1,346,587,110,15,91,28287.19,602,456,0.0
2,1,43,0,0,0,3,608,1108,3,-1,,611,1111,0.0
3,1,43,1,0,0,3,608,1108,3,-1,,611,1111,0.0
4,1,43,1,1,0,3,608,1108,3,-1,,611,1111,0.0
5,1,43,1,1,1,3,608,1108,3,95, ,611,1111,0.0
2,1,44,0,0,0,59,558,1,103,-1,,661,60,0.0
3,1,44,1,0,0,59,558,1,103,-1,,661,60,0.0
4,1,44,1,1,0,59,558,1,103,-1,,661,60,0.0
5,1,44,1,1,1,59,558,1,103,95, ,661,60,0.0
2,1,45,0,0,0,340,558,1,103,-1,,661,341,0.0
3,1,45,1,0,0,340,558,1,103,-1,,661,341,0.0
4,1,45,1,1,0,340,558,1,103,-1,,661,341,0.0
5,1,45,1,1,1,340,558,1,103,95, ,661,341,0.0
2,1,46,0,0,0,532,558,1,103,-1,,661,533,0.0
3,1,46,1,0,0,532,558,1,103,-1,,661,533,0.0
4,1,46,1,1,0,532,558,1,103,-1,,661,533,0.0
5,1,46,1,1,1,532,558,1,103,95, ,661,533,0.0
2,1,47,0,0,0,541,562,119,10,-1,,572,660,0.0
3,1,47,1,0,0,541,562,119,10,-1,,572,660,0.0
4,1,47,1,1,0,541,562,119,10,-1,,572,660,0.0
5,1,47,1,1,1,541,562,11,10,54,17,572,552,0.0
5,1,47,1,1,2,562,562,29,10,95,State,572,591,0.0
5,1,47,1,1,3,597,565,40,7,94,income,572,637,0.0
5,1,47,1,1,4,642,563,18,9,96,tax,572,660,0.0
2,1,48,0,0,0,539,587,94,15,-1,,602,633,0.0
3,1,48,1,0,0,539,587,94,15,-1,,602,633,0.0
4,1,48,1,1,0,539,587,94,15,-1,,602,633,0.0
5,1,48,1,1,1,539,587,94,15,96,1608.75,602,633,0.0
2,1,49,0,0,0,726,562,147,13,-1,,575,873,0.0
3,1,49,1,0,0,726,562,147,13,-1,,575,873,0.0
4,1,49,1,1,0,726,562,147,13,-1,,575,873,0.0
5,1,49,1,1,1,726,562,12,10,75,78,572,738,0.0
5,1,49,1,1,2,748,562,29,10,93,Local,572,777,0.0
5,1,49,1,1,3,782,565,36,10,75,wages.,575,818,0.0
5,1,49,1,1,4,827,563,20,12,94,"tips,",575,847,0.0
5,1,49,1,1,5,857,563,16,9,76,ete,572,873,0.0
2,1,50,0,0,0,724,587,109,15,-1,,602,833,0.0
3,1,50,1,0,0,724,587,109,15,-1,,602,833,0.0
4,1,50,1,1,0,724,587,109,15,-1,,602,833,0.0
5,1,50,1,1,1,724,587,109,15,91,44590.58,602,833,0.0
2,1,51,0,0,0,717,394,3,267,-1,,661,720,0.0
3,1,51,1,0,0,717,394,3,267,-1,,661,720,0.0
4,1,51,1,1,0,717,394,3,267,-1,,661,720,0.0
5,1,51,1,1,1,717,394,3,267,95, ,661,720,0.0
2,1,52,0,0,0,921,558,1,103,-1,,661,922,0.0
3,1,52,1,0,0,921,558,1,103,-1,,661,922,0.0
4,1,52,1,1,0,921,558,1,103,-1,,661,922,0.0
5,1,52,1,1,1,921,558,1,103,95, ,661,922,0.0
2,1,53,0,0,0,930,562,119,10,-1,,572,1049,0.0
3,1,53,1,0,0,930,562,119,10,-1,,572,1049,0.0
4,1,53,1,1,0,930,562,119,10,-1,,572,1049,0.0
5,1,53,1,1,1,930,562,11,10,75,19,572,941,0.0
5,1,53,1,1,2,951,562,29,10,88,Local,572,980,0.0
5,1,53,1,1,3,986,565,40,7,88,income,572,1026,0.0
5,1,53,1,1,4,1031,563,18,9,96,tax,572,1049,0.0
2,1,54,0,0,0,928,587,94,15,-1,,602,1022,0.0
3,1,54,1,0,0,928,587,94,15,-1,,602,1022,0.0
4,1,54,1,1,0,928,587,94,15,-1,,602,1022,0.0
5,1,54,1,1,1,928,587,94,15,96,6842.08,602,1022,0.0
2,1,55,0,0,0,1114,562,102,13,-1,,575,1216,0.0
3,1,55,1,0,0,1114,562,102,13,-1,,575,1216,0.0
4,1,55,1,1,0,1114,562,102,13,-1,,575,1216,0.0
5,1,55,1,1,1,1114,562,13,10,71,20,572,1127,0.0
5,1,55,1,1,2,1137,562,44,13,88,Locality,575,1181,0.0
5,1,55,1,1,3,1186,565,30,7,96,name,572,1216,0.0
2,1,56,0,0,0,1111,591,120,11,-1,,602,1231,0.0
3,1,56,1,0,0,1111,591,120,11,-1,,602,1231,0.0
4,1,56,1,1,0,1111,591,120,11,-1,,602,1231,0.0
5,1,56,1,1,1,1111,591,55,11,74,Rocha,602,1166,0.0
5,1,56,1,1,2,1177,591,54,11,96,Wells,602,1231,0.0
2,1,57,0,0,0,1234,1,2,660,-1,,661,1236,0.0
3,1,57,1,0,0,1234,1,2,660,-1,,661,1236,0.0
4,1,57,1,1,0,1234,1,2,660,-1,,661,1236,0.0
5,1,57,1,1,1,1234,1,2,660,95, ,661,1236,0.0
2,1,58,0,0,0,1107,558,1,103,-1,,661,1108,0.0
3,1,58,1,0,0,1107,558,1,103,-1,,661,1108,0.0
4,1,58,1,1,0,1107,558,1,103,-1,,661,1108,0.0
5,1,58,1,1,1,1107,558,1,103,95, ,661,1108,0.0
2,1,59,0,0,0,1,657,1235,7,-1,,664,1236,0.0
3,1,59,1,0,0,1,657,1235,7,-1,,664,1236,0.0
4,1,59,1,1,0,1,657,1235,7,-1,,664,1236,0.0
5,1,59,1,1,1,1,657,1235,7,95, ,664,1236,0.0
2,1,60,0,0,0,4,638,1227,90,-1,,728,1231,0.0
3,1,60,1,0,0,4,638,1227,82,-1,,720,1231,0.0
4,1,60,1,1,0,17,638,1214,17,-1,,655,1231,0.0
5,1,60,1,1,1,17,639,27,14,85,co,653,44,0.0
5,1,60,1,1,2,131,638,138,15,90,239-95-269,653,269,0.0
5,1,60,1,1,3,346,638,109,15,91,29750.61,653,455,0.0
5,1,60,1,1,4,538,638,82,15,96,2279.5,653,620,0.0
5,1,60,1,1,5,725,638,94,15,91,57464.5,653,819,0.0
5,1,60,1,1,6,928,638,95,15,95,9061.93,653,1023,0.0
5,1,60,1,1,7,1112,645,71,10,96,Rodriguez,655,1183,0.0
5,1,60,1,1,8,1193,645,38,8,96,Trail,653,1231,0.0
4,1,60,1,2,0,139,670,1092,22,-1,,692,1231,0.0
5,1,60,1,2,1,139,670,63,22,96,Wage,692,202,0.0
5,1,60,1,2,2,211,670,41,17,96,and,687,252,0.0
5,1,60,1,2,3,261,670,40,17,96,Tax,687,301,0.0
5,1,60,1,2,4,864,675,81,15,96,Department,690,945,0.0
5,1,60,1,2,5,950,675,12,12,96,of,687,962,0.0
5,1,60,1,2,6,966,675,20,12,93,the,687,986,0.0
5,1,60,1,2,7,991,675,118,15,35,TreasuryโInternal,690,1109,0.0
5,1,60,1,2,8,1115,675,59,12,96,Revenue,687,1174,0.0
5,1,60,1,2,9,1180,675,51,12,97,Service,687,1231,0.0
4,1,60,1,3,0,4,677,689,51,-1,,728,693,0.0
5,1,60,1,3,1,4,709,34,11,93,Form,720,38,0.0
5,1,60,1,3,2,47,709,25,11,91,W-2,720,72,0.0
5,1,60,1,3,3,140,697,114,31,96,Statement,728,254,0.0
5,1,60,1,3,4,549,677,27,42,21,c,719,576,0.0
5,1,60,1,3,5,588,677,27,42,50,0,719,615,0.0
5,1,60,1,3,6,628,677,26,42,59,1,719,654,0.0
5,1,60,1,3,7,666,677,27,42,52,0,719,693,0.0
2,1,61,0,0,0,4,732,482,37,-1,,769,486,0.0
3,1,61,1,0,0,4,732,482,37,-1,,769,486,0.0
4,1,61,1,1,0,5,732,462,15,-1,,747,467,0.0
5,1,61,1,1,1,5,732,40,15,93,Copy,747,45,0.0
5,1,61,1,1,2,51,732,43,12,91,B--To,744,94,0.0
5,1,61,1,1,3,100,732,20,12,96,Be,744,120,0.0
5,1,61,1,1,4,126,732,35,12,95,Filed,744,161,0.0
5,1,61,1,1,5,167,732,32,12,96,with,744,199,0.0
5,1,61,1,1,6,206,732,87,15,85,Employee's,747,293,0.0
5,1,61,1,1,7,300,732,76,12,96,FEDERAL,744,376,0.0
5,1,61,1,1,8,382,732,27,12,95,Tax,744,409,0.0
5,1,61,1,1,9,415,732,52,12,96,Return,744,467,0.0
4,1,61,1,2,0,4,754,482,15,-1,,769,486,0.0
5,1,61,1,2,1,4,754,29,12,96,This,766,33,0.0
5,1,61,1,2,2,40,754,79,12,93,information,766,119,0.0
5,1,61,1,2,3,126,757,10,9,93,is,766,136,0.0
5,1,61,1,2,4,143,754,38,15,94,being,769,181,0.0
5,1,61,1,2,5,187,754,67,12,96,furnished,766,254,0.0
5,1,61,1,2,6,260,754,12,12,96,to,766,272,0.0
5,1,61,1,2,7,278,754,22,12,96,the,766,300,0.0
5,1,61,1,2,8,307,754,52,12,93,Internal,766,359,0.0
5,1,61,1,2,9,365,754,62,12,95,Revenue,766,427,0.0
5,1,61,1,2,10,433,754,53,12,96,Service,766,486,0.0
2,1,62,0,0,0,469,825,294,14,-1,,839,763,0.0
3,1,62,1,0,0,469,825,294,14,-1,,839,763,0.0
4,1,62,1,1,0,469,825,294,14,-1,,839,763,0.0
5,1,62,1,1,1,469,825,55,11,51,Tuthere.,836,524,0.0
5,1,62,1,1,2,537,825,32,14,92,Keep,839,569,0.0
5,1,62,1,1,3,575,825,34,11,94,lower,836,609,0.0
5,1,62,1,1,4,614,826,42,13,96,portion,839,656,0.0
5,1,62,1,1,5,661,825,17,11,72,for,836,678,0.0
5,1,62,1,1,6,682,828,28,11,94,your,839,710,0.0
5,1,62,1,1,7,715,825,48,11,67,records,836,763,0.0
2,1,63,0,0,0,1,871,1235,7,-1,,878,1236,0.0
3,1,63,1,0,0,1,871,1235,7,-1,,878,1236,0.0
4,1,63,1,1,0,1,871,1235,7,-1,,878,1236,0.0
5,1,63,1,1,1,1,871,1235,7,95, ,878,1236,0.0
2,1,64,0,0,0,211,874,3,52,-1,,926,214,0.0
3,1,64,1,0,0,211,874,3,52,-1,,926,214,0.0
4,1,64,1,1,0,211,874,3,52,-1,,926,214,0.0
5,1,64,1,1,1,211,874,3,52,95, ,926,214,0.0
2,1,65,0,0,0,595,874,3,52,-1,,926,598,0.0
3,1,65,1,0,0,595,874,3,52,-1,,926,598,0.0
4,1,65,1,1,0,595,874,3,52,-1,,926,598,0.0
5,1,65,1,1,1,595,874,3,52,95, ,926,598,0.0
2,1,66,0,0,0,1,922,1235,7,-1,,929,1236,0.0
3,1,66,1,0,0,1,922,1235,7,-1,,929,1236,0.0
4,1,66,1,1,0,1,922,1235,7,-1,,929,1236,0.0
5,1,66,1,1,1,1,922,1235,7,95, ,929,1236,0.0
2,1,67,0,0,0,1,973,1235,7,-1,,980,1236,0.0
3,1,67,1,0,0,1,973,1235,7,-1,,980,1236,0.0
4,1,67,1,1,0,1,973,1235,7,-1,,980,1236,0.0
5,1,67,1,1,1,1,973,1235,7,95, ,980,1236,0.0
2,1,68,0,0,0,660,1025,576,5,-1,,1030,1236,0.0
3,1,68,1,0,0,660,1025,576,5,-1,,1030,1236,0.0
4,1,68,1,1,0,660,1025,576,5,-1,,1030,1236,0.0
5,1,68,1,1,1,660,1025,576,5,95, ,1030,1236,0.0
2,1,69,0,0,0,660,1076,576,5,-1,,1081,1236,0.0
3,1,69,1,0,0,660,1076,576,5,-1,,1081,1236,0.0
4,1,69,1,1,0,660,1076,576,5,-1,,1081,1236,0.0
5,1,69,1,1,1,660,1076,576,5,95, ,1081,1236,0.0
2,1,70,0,0,0,1,1126,1235,7,-1,,1133,1236,0.0
3,1,70,1,0,0,1,1126,1235,7,-1,,1133,1236,0.0
4,1,70,1,1,0,1,1126,1235,7,-1,,1133,1236,0.0
5,1,70,1,1,1,1,1126,1235,7,95, ,1133,1236,0.0
2,1,71,0,0,0,1,1177,1235,7,-1,,1184,1236,0.0
3,1,71,1,0,0,1,1177,1235,7,-1,,1184,1236,0.0
4,1,71,1,1,0,1,1177,1235,7,-1,,1184,1236,0.0
5,1,71,1,1,1,1,1177,1235,7,95, ,1184,1236,0.0
2,1,72,0,0,0,11,878,1217,525,-1,,1403,1228,0.0
3,1,72,1,0,0,11,878,1217,525,-1,,1403,1228,0.0
4,1,72,1,1,0,55,878,1137,16,-1,,894,1192,0.0
5,1,72,1,1,1,55,879,103,15,91,REISSUED,894,158,0.0
5,1,72,1,1,2,216,881,6,7,60,[a,888,222,0.0
5,1,72,1,1,3,236,878,71,13,32,Employee's,891,307,0.0
5,1,72,1,1,4,311,878,36,10,90,social,888,347,0.0
5,1,72,1,1,5,352,878,48,13,90,security,891,400,0.0
5,1,72,1,1,6,406,878,48,10,96,number,888,454,0.0
5,1,72,1,1,7,750,878,23,10,95,This,888,773,0.0
5,1,72,1,1,8,779,878,61,10,96,information,888,840,0.0
5,1,72,1,1,9,846,881,8,7,90,is,888,854,0.0
5,1,72,1,1,10,860,878,29,13,90,being,891,889,0.0
5,1,72,1,1,11,894,878,51,10,93,furnished,888,945,0.0
5,1,72,1,1,12,950,879,10,9,96,to,888,960,0.0
5,1,72,1,1,13,965,878,17,10,96,the,888,982,0.0
5,1,72,1,1,14,988,878,40,10,84,Internal,888,1028,0.0
5,1,72,1,1,15,1034,878,47,10,93,Revenue,888,1081,0.0
5,1,72,1,1,16,1087,878,40,10,74,Senice.,888,1127,0.0
5,1,72,1,1,17,1141,878,6,10,77,If,888,1147,0.0
5,1,72,1,1,18,1150,881,20,10,77,you,891,1170,0.0
5,1,72,1,1,19,1176,881,16,7,94,are,888,1192,0.0
4,1,72,1,2,0,751,895,477,13,-1,,908,1228,0.0
5,1,72,1,2,1,751,895,44,13,95,required,908,795,0.0
5,1,72,1,2,2,800,887,8,26,96,to,913,808,0.0
5,1,72,1,2,3,805,895,25,10,96,file,905,830,0.0
5,1,72,1,2,4,836,898,5,7,78,a,905,841,0.0
5,1,72,1,2,5,846,896,18,9,78,tax,905,864,0.0
5,1,72,1,2,6,869,896,35,10,65,"return,",906,904,0.0
5,1,72,1,2,7,910,898,5,7,95,a,905,915,0.0
5,1,72,1,2,8,921,895,60,13,96,negligence,908,981,0.0
5,1,72,1,2,9,987,895,41,13,96,penalty,908,1028,0.0
5,1,72,1,2,10,1033,898,10,7,95,or,905,1043,0.0
5,1,72,1,2,11,1048,895,28,10,96,other,905,1076,0.0
5,1,72,1,2,12,1081,896,47,9,96,sanction,905,1128,0.0
5,1,72,1,2,13,1134,898,24,10,97,may,908,1158,0.0
5,1,72,1,2,14,1163,895,12,10,96,be,905,1175,0.0
5,1,72,1,2,15,1181,895,47,13,88,imposed,908,1228,0.0
4,1,72,1,3,0,44,903,1018,22,-1,,925,1062,0.0
5,1,72,1,3,1,44,906,126,15,96,STATEMENT,921,170,0.0
5,1,72,1,3,2,312,903,150,15,79,077-49-4905,918,462,0.0
5,1,72,1,3,3,612,903,28,10,96,OMB,913,640,0.0
5,1,72,1,3,4,646,903,14,10,79,No.,913,660,0.0
5,1,72,1,3,5,671,903,57,10,80,1645-0008,913,728,0.0
5,1,72,1,3,6,751,915,12,7,50,on,922,763,0.0
5,1,72,1,3,7,776,915,12,7,38,you,922,788,0.0
5,1,72,1,3,8,794,912,6,10,38,if,922,800,0.0
5,1,72,1,3,9,803,912,20,10,79,this,922,823,0.0
5,1,72,1,3,10,829,915,40,7,55,income,922,869,0.0
5,1,72,1,3,11,875,915,8,7,92,is,922,883,0.0
5,1,72,1,3,12,888,912,41,10,92,taxable,922,929,0.0
5,1,72,1,3,13,935,912,19,10,96,and,922,954,0.0
5,1,72,1,3,14,967,915,12,7,75,you,922,979,0.0
5,1,72,1,3,15,984,912,15,10,75,fail,922,999,0.0
5,1,72,1,3,16,1004,913,10,9,86,to,922,1014,0.0
5,1,72,1,3,17,1020,913,31,12,52,report,925,1051,0.0
5,1,72,1,3,18,1057,913,5,9,52,it,922,1062,0.0
4,1,72,1,4,0,12,929,1143,13,-1,,942,1155,0.0
5,1,72,1,4,1,12,929,7,10,78,b,939,19,0.0
5,1,72,1,4,2,29,929,54,13,94,Employer,942,83,0.0
5,1,72,1,4,3,88,929,70,10,94,identification,939,158,0.0
5,1,72,1,4,4,164,929,42,10,96,number,939,206,0.0
5,1,72,1,4,5,681,929,4,10,61,1,939,685,0.0
5,1,72,1,4,6,704,929,40,13,83,"Wages,",942,744,0.0
5,1,72,1,4,7,753,930,20,12,89,"tips,",942,773,0.0
5,1,72,1,4,8,783,929,28,10,92,other,939,811,0.0
5,1,72,1,4,9,816,930,79,12,96,compensation,942,895,0.0
5,1,72,1,4,10,970,929,7,10,2,2,939,977,0.0
5,1,72,1,4,11,995,929,41,10,75,Federal,939,1036,0.0
5,1,72,1,4,12,1042,932,40,7,95,income,939,1082,0.0
5,1,72,1,4,13,1087,930,18,9,96,tax,939,1105,0.0
5,1,72,1,4,14,1109,929,46,10,96,withheld,939,1155,0.0
4,1,72,1,5,0,66,954,1028,15,-1,,969,1094,0.0
5,1,72,1,5,1,66,954,137,15,75,37-2766773,969,203,0.0
5,1,72,1,5,2,725,954,109,15,83,55151.93,969,834,0.0
5,1,72,1,5,3,986,954,108,15,90,16606.17,969,1094,0.0
4,1,72,1,6,0,13,980,1139,13,-1,,993,1152,0.0
5,1,72,1,6,1,13,983,6,7,34,ยข,990,19,0.0
5,1,72,1,6,2,29,980,62,13,95,Employers,993,91,0.0
5,1,72,1,6,3,97,983,30,7,93,"name,",990,127,0.0
5,1,72,1,6,4,137,980,44,10,92,"address,",990,181,0.0
5,1,72,1,6,5,191,980,19,10,92,and,990,210,0.0
5,1,72,1,6,6,215,980,18,10,93,ZIP,990,233,0.0
5,1,72,1,6,7,239,980,26,10,96,code,990,265,0.0
5,1,72,1,6,8,681,980,6,10,63,3,990,687,0.0
5,1,72,1,6,9,705,980,34,10,87,Social,990,739,0.0
5,1,72,1,6,10,745,972,45,25,96,security,997,790,0.0
5,1,72,1,6,11,797,983,33,10,96,wages,993,830,0.0
5,1,72,1,6,12,970,980,7,10,47,4,990,977,0.0
5,1,72,1,6,13,995,980,34,10,83,Social,990,1029,0.0
5,1,72,1,6,14,1035,980,117,13,96,security,993,1152,0.0
5,1,72,1,6,15,1084,972,18,25,96,tax,997,1102,0.0
5,1,72,1,6,16,1107,980,45,13,96,withheld,993,1152,0.0
4,1,72,1,7,0,64,1005,1016,15,-1,,1020,1080,0.0
5,1,72,1,7,1,64,1005,224,15,90,Richardson-Brown,1020,288,0.0
5,1,72,1,7,2,303,1006,40,14,96,PLC,1020,343,0.0
5,1,72,1,7,3,725,1005,108,15,89,67588.01,1020,833,0.0
5,1,72,1,7,4,986,1005,94,15,95,5170.48,1020,1080,0.0
4,1,72,1,8,0,65,1031,1054,23,-1,,1054,1119,0.0
5,1,72,1,8,1,65,1039,54,15,96,2936,1054,119,0.0
5,1,72,1,8,2,135,1039,83,15,95,Howard,1054,218,0.0
5,1,72,1,8,3,232,1039,83,15,96,Radial,1054,315,0.0
5,1,72,1,8,4,681,1031,6,10,70,5,1041,687,0.0
5,1,72,1,8,5,705,1031,51,10,78,Medicare,1041,756,0.0
5,1,72,1,8,6,761,1034,36,10,96,wages,1044,797,0.0
5,1,72,1,8,7,803,1031,19,10,91,and,1041,822,0.0
5,1,72,1,8,8,827,1032,20,12,91,tips,1044,847,0.0
5,1,72,1,8,9,970,1031,6,10,72,6,1041,976,0.0
5,1,72,1,8,10,995,1031,51,10,72,Medicare,1041,1046,0.0
5,1,72,1,8,11,1051,1032,18,9,96,tax,1041,1069,0.0
5,1,72,1,8,12,1074,1031,45,10,93,withheld,1041,1119,0.0
4,1,72,1,9,0,725,1056,419,15,-1,,1071,1144,0.0
5,1,72,1,9,1,725,1056,109,15,91,50518.06,1071,834,0.0
5,1,72,1,9,2,1050,1056,94,15,94,1465.02,1071,1144,0.0
4,1,72,1,10,0,64,1073,1008,22,-1,,1095,1072,0.0
5,1,72,1,10,1,64,1073,55,15,96,West,1088,119,0.0
5,1,72,1,10,2,134,1073,98,20,96,Raymond,1093,232,0.0
5,1,72,1,10,3,260,1074,29,14,64,NV,1088,289,0.0
5,1,72,1,10,4,331,1073,137,15,77,44735-6958,1088,468,0.0
5,1,72,1,10,5,681,1082,5,10,71,7,1092,686,0.0
5,1,72,1,10,6,705,1082,34,10,71,Social,1092,739,0.0
5,1,72,1,10,7,746,1083,42,12,48,security,1095,788,0.0
5,1,72,1,10,8,795,1083,19,12,87,tps,1095,814,0.0
5,1,72,1,10,9,971,1082,5,10,51,8,1092,976,0.0
5,1,72,1,10,10,994,1082,53,10,85,Allocated,1092,1047,0.0
5,1,72,1,10,11,1052,1083,20,12,89,tips,1095,1072,0.0
4,1,72,1,11,0,725,1107,434,15,-1,,1122,1159,0.0
5,1,72,1,11,1,725,1107,108,15,89,67588.01,1122,833,0.0
5,1,72,1,11,2,1050,1107,109,15,90,50518.06,1122,1159,0.0
4,1,72,1,12,0,11,1133,1122,13,-1,,1146,1133,0.0
5,1,72,1,12,1,11,1133,57,10,0,โControl,1143,68,0.0
5,1,72,1,12,2,74,1133,42,10,96,number,1143,116,0.0
5,1,72,1,12,3,680,1133,7,10,66,9,1143,687,0.0
5,1,72,1,12,4,704,1133,48,10,66,Advance,1143,752,0.0
5,1,72,1,12,5,758,1133,19,10,92,EIC,1143,777,0.0
5,1,72,1,12,6,783,1134,48,12,96,payment,1146,831,0.0
5,1,72,1,12,7,964,1133,13,10,78,40,1143,977,0.0
5,1,72,1,12,8,995,1133,60,13,72,Dependent,1146,1055,0.0
5,1,72,1,12,9,1061,1136,23,7,92,care,1143,1084,0.0
5,1,72,1,12,10,1090,1133,43,10,92,benefits,1143,1133,0.0
4,1,72,1,13,0,66,1158,1022,15,-1,,1173,1088,0.0
5,1,72,1,13,1,66,1158,94,15,96,4741345,1173,160,0.0
5,1,72,1,13,2,1049,1158,39,15,96,238,1173,1088,0.0
4,1,72,1,14,0,12,1184,1163,13,-1,,1197,1175,0.0
5,1,72,1,14,1,12,1187,6,7,30,@,1194,18,0.0
5,1,72,1,14,2,29,1184,65,13,75,Employee's,1197,94,0.0
5,1,72,1,14,3,99,1184,20,10,95,first,1194,119,0.0
5,1,72,1,14,4,125,1187,30,7,95,name,1194,155,0.0
5,1,72,1,14,5,161,1184,19,10,96,and,1194,180,0.0
5,1,72,1,14,6,186,1184,28,10,94,initial,1194,214,0.0
5,1,72,1,14,7,280,1184,23,10,96,Last,1194,303,0.0
5,1,72,1,14,8,309,1187,30,7,94,name,1194,339,0.0
5,1,72,1,14,9,674,1184,11,10,60,11,1194,685,0.0
5,1,72,1,14,10,705,1184,68,13,79,Nonqualified,1197,773,0.0
5,1,72,1,14,11,779,1184,29,13,76,plans,1197,808,0.0
5,1,72,1,14,12,966,1184,20,10,38,12a,1194,986,0.0
5,1,72,1,14,13,1009,1184,22,10,60,See,1194,1031,0.0
5,1,72,1,14,14,1037,1184,71,10,92,instructions,1194,1108,0.0
5,1,72,1,14,15,1112,1184,17,10,96,for,1194,1129,0.0
5,1,72,1,14,16,1134,1184,22,10,96,box,1194,1156,0.0
5,1,72,1,14,17,1162,1184,13,10,90,12,1194,1175,0.0
4,1,72,1,15,0,118,1215,984,17,-1,,1232,1102,0.0
5,1,72,1,15,1,118,1229,3,3,0,-,1232,121,0.0
5,1,72,1,15,2,724,1215,39,15,96,210,1230,763,0.0
5,1,72,1,15,3,1006,1216,13,14,87,G,1230,1019,0.0
5,1,72,1,15,4,1050,1215,52,15,82,|8500,1230,1102,0.0
4,1,72,1,16,0,63,1229,924,29,-1,,1258,987,0.0
5,1,72,1,16,1,63,1229,80,22,95,April,1251,143,0.0
5,1,72,1,16,2,193,1230,61,16,95,Hens,1246,254,0.0
5,1,72,1,16,3,258,1229,46,22,96,ley,1251,304,0.0
5,1,72,1,16,4,674,1241,13,10,87,13,1251,687,0.0
5,1,72,1,16,5,693,1242,43,10,75,Statutory,1252,736,0.0
5,1,72,1,16,6,776,1237,53,21,61,Retirement,1258,829,0.0
5,1,72,1,16,7,866,1237,58,21,48,Third-party.,1258,924,0.0
5,1,72,1,16,8,966,1241,21,10,84,12b,1251,987,0.0
4,1,72,1,17,0,693,1257,213,10,-1,,1267,906,0.0
5,1,72,1,17,1,693,1257,44,10,59,empoyee,1267,737,0.0
5,1,72,1,17,2,780,1257,18,10,31,plan,1267,798,0.0
5,1,72,1,17,3,867,1257,18,8,95,sick,1265,885,0.0
5,1,72,1,17,4,889,1259,17,8,93,pay,1267,906,0.0
4,1,72,1,18,0,786,1275,97,11,-1,,1286,883,0.0
5,1,72,1,18,1,786,1275,10,11,95,x,1286,796,0.0
5,1,72,1,18,2,873,1275,10,11,95,x,1286,883,0.0
4,1,72,1,19,0,66,1269,1023,17,-1,,1286,1089,0.0
5,1,72,1,19,1,66,1269,76,17,96,31403,1286,142,0.0
5,1,72,1,19,2,160,1269,80,17,96,David,1286,240,0.0
5,1,72,1,19,3,257,1269,109,17,95,Circles,1286,366,0.0
5,1,72,1,19,4,386,1270,77,16,95,Suite,1286,463,0.0
5,1,72,1,19,5,482,1269,44,17,96,863,1286,526,0.0
5,1,72,1,19,6,1050,1271,39,15,96,489,1286,1089,0.0
4,1,72,1,20,0,64,1300,922,25,-1,,1325,986,0.0
5,1,72,1,20,1,64,1309,63,16,93,West,1325,127,0.0
5,1,72,1,20,2,144,1308,127,17,88,Erinfort,1325,271,0.0
5,1,72,1,20,3,304,1309,32,16,92,WY,1325,336,0.0
5,1,72,1,20,4,402,1308,156,17,96,45881-3334,1325,558,0.0
5,1,72,1,20,5,674,1300,13,10,42,44,1310,687,0.0
5,1,72,1,20,6,705,1300,31,10,84,Other,1310,736,0.0
5,1,72,1,20,7,741,1301,23,12,85,(see,1313,764,0.0
5,1,72,1,20,8,770,1300,50,10,96,enclosed,1310,820,0.0
5,1,72,1,20,9,826,1300,35,10,96,Notice,1310,861,0.0
5,1,72,1,20,10,866,1301,10,9,96,to,1310,876,0.0
5,1,72,1,20,11,882,1300,61,13,96,Employee),1313,943,0.0
5,1,72,1,20,12,949,1292,9,25,45,|,1317,958,0.0
5,1,72,1,20,13,966,1300,20,10,32,12c,1310,986,0.0
4,1,72,1,21,0,1005,1331,84,15,-1,,1346,1089,0.0
5,1,72,1,21,1,1005,1332,13,14,81,D,1346,1018,0.0
5,1,72,1,21,2,1050,1331,39,15,66,[999,1346,1089,0.0
4,1,72,1,22,0,966,1357,20,10,-1,,1367,986,0.0
5,1,72,1,22,1,966,1357,20,10,88,12d,1367,986,0.0
4,1,72,1,23,0,1006,1388,82,15,-1,,1403,1088,0.0
5,1,72,1,23,1,1006,1389,13,14,92,G,1403,1019,0.0
5,1,72,1,23,2,1050,1388,38,15,14,{381,1403,1088,0.0
2,1,73,0,0,0,11,1418,213,13,-1,,1431,224,0.0
3,1,73,1,0,0,11,1418,213,13,-1,,1431,224,0.0
4,1,73,1,1,0,11,1418,213,13,-1,,1431,224,0.0
5,1,73,1,1,1,11,1418,83,13,48,f_Employee's,1431,94,0.0
5,1,73,1,1,2,100,1418,44,10,91,address,1428,144,0.0
5,1,73,1,1,3,150,1418,19,10,93,and,1428,169,0.0
5,1,73,1,1,4,174,1418,18,10,96,ZIP,1428,192,0.0
5,1,73,1,1,5,197,1418,27,10,95,code,1428,224,0.0
2,1,74,0,0,0,660,1235,576,5,-1,,1240,1236,0.0
3,1,74,1,0,0,660,1235,576,5,-1,,1240,1236,0.0
4,1,74,1,1,0,660,1235,576,5,-1,,1240,1236,0.0
5,1,74,1,1,1,660,1235,576,5,95, ,1240,1236,0.0
2,1,75,0,0,0,689,1266,204,3,-1,,1269,893,0.0
3,1,75,1,0,0,689,1266,204,3,-1,,1269,893,0.0
4,1,75,1,1,0,689,1266,204,3,-1,,1269,893,0.0
5,1,75,1,1,1,689,1266,204,3,95, ,1269,893,0.0
2,1,76,0,0,0,689,1267,1,28,-1,,1295,690,0.0
3,1,76,1,0,0,689,1267,1,28,-1,,1295,690,0.0
4,1,76,1,1,0,689,1267,1,28,-1,,1295,690,0.0
5,1,76,1,1,1,689,1267,1,28,95, ,1295,690,0.0
2,1,77,0,0,0,718,1267,1,28,-1,,1295,719,0.0
3,1,77,1,0,0,718,1267,1,28,-1,,1295,719,0.0
4,1,77,1,1,0,718,1267,1,28,-1,,1295,719,0.0
5,1,77,1,1,1,718,1267,1,28,95, ,1295,719,0.0
2,1,78,0,0,0,776,1267,1,28,-1,,1295,777,0.0
3,1,78,1,0,0,776,1267,1,28,-1,,1295,777,0.0
4,1,78,1,1,0,776,1267,1,28,-1,,1295,777,0.0
5,1,78,1,1,1,776,1267,1,28,95, ,1295,777,0.0
2,1,79,0,0,0,805,1267,1,28,-1,,1295,806,0.0
3,1,79,1,0,0,805,1267,1,28,-1,,1295,806,0.0
4,1,79,1,1,0,805,1267,1,28,-1,,1295,806,0.0
5,1,79,1,1,1,805,1267,1,28,95, ,1295,806,0.0
2,1,80,0,0,0,863,1267,1,28,-1,,1295,864,0.0
3,1,80,1,0,0,863,1267,1,28,-1,,1295,864,0.0
4,1,80,1,1,0,863,1267,1,28,-1,,1295,864,0.0
5,1,80,1,1,1,863,1267,1,28,95, ,1295,864,0.0
2,1,81,0,0,0,892,1267,1,28,-1,,1295,893,0.0
3,1,81,1,0,0,892,1267,1,28,-1,,1295,893,0.0
4,1,81,1,1,0,892,1267,1,28,-1,,1295,893,0.0
5,1,81,1,1,1,892,1267,1,28,95, ,1295,893,0.0
2,1,82,0,0,0,660,1292,576,7,-1,,1299,1236,0.0
3,1,82,1,0,0,660,1292,576,7,-1,,1299,1236,0.0
4,1,82,1,1,0,660,1292,576,7,-1,,1299,1236,0.0
5,1,82,1,1,1,660,1292,576,7,95, ,1299,1236,0.0
2,1,83,0,0,0,659,925,3,507,-1,,1432,662,0.0
3,1,83,1,0,0,659,925,3,507,-1,,1432,662,0.0
4,1,83,1,1,0,659,925,3,507,-1,,1432,662,0.0
5,1,83,1,1,1,659,925,3,507,95, ,1432,662,0.0
2,1,84,0,0,0,689,1292,547,7,-1,,1299,1236,0.0
3,1,84,1,0,0,689,1292,547,7,-1,,1299,1236,0.0
4,1,84,1,1,0,689,1292,547,7,-1,,1299,1236,0.0
5,1,84,1,1,1,689,1292,547,7,95, ,1299,1236,0.0
2,1,85,0,0,0,689,1292,547,7,-1,,1299,1236,0.0
3,1,85,1,0,0,689,1292,547,7,-1,,1299,1236,0.0
4,1,85,1,1,0,689,1292,547,7,-1,,1299,1236,0.0
5,1,85,1,1,1,689,1292,547,7,95, ,1299,1236,0.0
2,1,86,0,0,0,689,1292,547,7,-1,,1299,1236,0.0
3,1,86,1,0,0,689,1292,547,7,-1,,1299,1236,0.0
4,1,86,1,1,0,689,1292,547,7,-1,,1299,1236,0.0
5,1,86,1,1,1,689,1292,547,7,95, ,1299,1236,0.0
2,1,87,0,0,0,950,1352,286,3,-1,,1355,1236,0.0
3,1,87,1,0,0,950,1352,286,3,-1,,1355,1236,0.0
4,1,87,1,1,0,950,1352,286,3,-1,,1355,1236,0.0
5,1,87,1,1,1,950,1352,286,3,95, ,1355,1236,0.0
2,1,88,0,0,0,1042,1197,3,214,-1,,1411,1045,0.0
3,1,88,1,0,0,1042,1197,3,214,-1,,1411,1045,0.0
4,1,88,1,1,0,1042,1197,3,214,-1,,1411,1045,0.0
5,1,88,1,1,1,1042,1197,3,214,95, ,1411,1045,0.0
2,1,89,0,0,0,949,1409,287,3,-1,,1412,1236,0.0
3,1,89,1,0,0,949,1409,287,3,-1,,1412,1236,0.0
4,1,89,1,1,0,949,1409,287,3,-1,,1412,1236,0.0
5,1,89,1,1,1,949,1409,287,3,95, ,1412,1236,0.0
2,1,90,0,0,0,949,925,3,507,-1,,1432,952,0.0
3,1,90,1,0,0,949,925,3,507,-1,,1432,952,0.0
4,1,90,1,1,0,949,925,3,507,-1,,1432,952,0.0
5,1,90,1,1,1,949,925,3,507,95, ,1432,952,0.0
2,1,91,0,0,0,1,1428,1235,7,-1,,1435,1236,0.0
3,1,91,1,0,0,1,1428,1235,7,-1,,1435,1236,0.0
4,1,91,1,1,0,1,1428,1235,7,-1,,1435,1236,0.0
5,1,91,1,1,1,1,1428,1235,7,95, ,1435,1236,0.0
2,1,92,0,0,0,6,1435,489,13,-1,,1448,495,0.0
3,1,92,1,0,0,6,1435,489,13,-1,,1448,495,0.0
4,1,92,1,1,0,6,1435,489,13,-1,,1448,495,0.0
5,1,92,1,1,1,6,1435,13,10,88,15,1445,19,0.0
5,1,92,1,1,2,29,1435,29,10,58,State!,1445,58,0.0
5,1,92,1,1,3,88,1435,62,13,54,Employer's,1448,150,0.0
5,1,92,1,1,4,156,1436,27,9,86,state,1445,183,0.0
5,1,92,1,1,5,189,1435,10,10,86,ID,1445,199,0.0
5,1,92,1,1,6,205,1435,42,10,95,number,1445,247,0.0
5,1,92,1,1,7,349,1435,11,10,53,16,1445,360,0.0
5,1,92,1,1,8,370,1435,29,10,93,State,1445,399,0.0
5,1,92,1,1,9,404,1438,36,10,90,"wages,",1448,440,0.0
5,1,92,1,1,10,449,1436,20,12,90,"tips,",1448,469,0.0
5,1,92,1,1,11,479,1436,16,9,77,etc,1445,495,0.0
2,1,93,0,0,0,0,1456,1236,31,-1,,1487,1236,0.0
3,1,93,1,0,0,0,1456,1236,31,-1,,1487,1236,0.0
4,1,93,1,1,0,0,1456,1236,31,-1,,1487,1236,0.0
5,1,93,1,1,1,0,1456,1236,31,95, ,1487,1236,0.0
2,1,94,0,0,0,59,1431,1,104,-1,,1535,60,0.0
3,1,94,1,0,0,59,1431,1,104,-1,,1535,60,0.0
4,1,94,1,1,0,59,1431,1,104,-1,,1535,60,0.0
5,1,94,1,1,1,59,1431,1,104,95, ,1535,60,0.0
2,1,95,0,0,0,340,1431,1,104,-1,,1535,341,0.0
3,1,95,1,0,0,340,1431,1,104,-1,,1535,341,0.0
4,1,95,1,1,0,340,1431,1,104,-1,,1535,341,0.0
5,1,95,1,1,1,340,1431,1,104,95, ,1535,341,0.0
2,1,96,0,0,0,0,1530,341,9,-1,,1539,341,0.0
3,1,96,1,0,0,0,1530,341,9,-1,,1539,341,0.0
4,1,96,1,1,0,0,1530,341,9,-1,,1539,341,0.0
5,1,96,1,1,1,0,1530,341,9,95, ,1539,341,0.0
2,1,97,0,0,0,532,1431,1,104,-1,,1535,533,0.0
3,1,97,1,0,0,532,1431,1,104,-1,,1535,533,0.0
4,1,97,1,1,0,532,1431,1,104,-1,,1535,533,0.0
5,1,97,1,1,1,532,1431,1,104,95, ,1535,533,0.0
2,1,98,0,0,0,541,1435,119,10,-1,,1445,660,0.0
3,1,98,1,0,0,541,1435,119,10,-1,,1445,660,0.0
4,1,98,1,1,0,541,1435,119,10,-1,,1445,660,0.0
5,1,98,1,1,1,541,1435,12,10,63,17,1445,553,0.0
5,1,98,1,1,2,562,1435,29,10,94,State,1445,591,0.0
5,1,98,1,1,3,597,1438,40,7,95,income,1445,637,0.0
5,1,98,1,1,4,642,1436,18,9,96,tax,1445,660,0.0
2,1,99,0,0,0,538,1512,81,15,-1,,1527,619,0.0
3,1,99,1,0,0,538,1512,81,15,-1,,1527,619,0.0
4,1,99,1,1,0,538,1512,81,15,-1,,1527,619,0.0
5,1,99,1,1,1,538,1512,81,15,65,2279.5,1527,619,0.0
2,1,100,0,0,0,727,1435,146,13,-1,,1448,873,0.0
3,1,100,1,0,0,727,1435,146,13,-1,,1448,873,0.0
4,1,100,1,1,0,727,1435,146,13,-1,,1448,873,0.0
5,1,100,1,1,1,727,1435,11,10,69,78,1445,738,0.0
5,1,100,1,1,2,748,1435,29,10,94,Local,1445,777,0.0
5,1,100,1,1,3,782,1438,40,10,94,"wages,",1448,822,0.0
5,1,100,1,1,4,827,1436,20,12,94,"tips,",1448,847,0.0
5,1,100,1,1,5,857,1436,16,9,75,etc,1445,873,0.0
2,1,101,0,0,0,725,1512,94,15,-1,,1527,819,0.0
3,1,101,1,0,0,725,1512,94,15,-1,,1527,819,0.0
4,1,101,1,1,0,725,1512,94,15,-1,,1527,819,0.0
5,1,101,1,1,1,725,1512,94,15,89,57464.5,1527,819,0.0
2,1,102,0,0,0,717,1267,3,268,-1,,1535,720,0.0
3,1,102,1,0,0,717,1267,3,268,-1,,1535,720,0.0
4,1,102,1,1,0,717,1267,3,268,-1,,1535,720,0.0
5,1,102,1,1,1,717,1267,3,268,95, ,1535,720,0.0
2,1,103,0,0,0,921,1431,1,104,-1,,1535,922,0.0
3,1,103,1,0,0,921,1431,1,104,-1,,1535,922,0.0
4,1,103,1,1,0,921,1431,1,104,-1,,1535,922,0.0
5,1,103,1,1,1,921,1431,1,104,95, ,1535,922,0.0
2,1,104,0,0,0,929,1435,120,10,-1,,1445,1049,0.0
3,1,104,1,0,0,929,1435,120,10,-1,,1445,1049,0.0
4,1,104,1,1,0,929,1435,120,10,-1,,1445,1049,0.0
5,1,104,1,1,1,929,1435,12,10,63,49,1445,941,0.0
5,1,104,1,1,2,951,1435,29,10,86,Local,1445,980,0.0
5,1,104,1,1,3,986,1438,40,7,96,income,1445,1026,0.0
5,1,104,1,1,4,1031,1436,18,9,95,tax,1445,1049,0.0
2,1,105,0,0,0,928,1512,95,15,-1,,1527,1023,0.0
3,1,105,1,0,0,928,1512,95,15,-1,,1527,1023,0.0
4,1,105,1,1,0,928,1512,95,15,-1,,1527,1023,0.0
5,1,105,1,1,1,928,1512,95,15,96,9061.93,1527,1023,0.0
2,1,106,0,0,0,1114,1435,102,13,-1,,1448,1216,0.0
3,1,106,1,0,0,1114,1435,102,13,-1,,1448,1216,0.0
4,1,106,1,1,0,1114,1435,102,13,-1,,1448,1216,0.0
5,1,106,1,1,1,1114,1435,13,10,85,20,1445,1127,0.0
5,1,106,1,1,2,1137,1435,44,13,89,Locality,1448,1181,0.0
5,1,106,1,1,3,1186,1438,30,7,96,name,1445,1216,0.0
2,1,107,0,0,0,1112,1519,119,10,-1,,1529,1231,0.0
3,1,107,1,0,0,1112,1519,119,10,-1,,1529,1231,0.0
4,1,107,1,1,0,1112,1519,119,10,-1,,1529,1231,0.0
5,1,107,1,1,1,1112,1519,71,10,96,Rodriguez,1529,1183,0.0
5,1,107,1,1,2,1193,1519,38,8,96,Trail,1527,1231,0.0
2,1,108,0,0,0,1233,874,3,661,-1,,1535,1236,0.0
3,1,108,1,0,0,1233,874,3,661,-1,,1535,1236,0.0
4,1,108,1,1,0,1233,874,3,661,-1,,1535,1236,0.0
5,1,108,1,1,1,1233,874,3,661,95, ,1535,1236,0.0
2,1,109,0,0,0,1107,1431,1,104,-1,,1535,1108,0.0
3,1,109,1,0,0,1107,1431,1,104,-1,,1535,1108,0.0
4,1,109,1,1,0,1107,1431,1,104,-1,,1535,1108,0.0
5,1,109,1,1,1,1107,1431,1,104,95, ,1535,1108,0.0
2,1,110,0,0,0,338,1532,898,5,-1,,1537,1236,0.0
3,1,110,1,0,0,338,1532,898,5,-1,,1537,1236,0.0
4,1,110,1,1,0,338,1532,898,5,-1,,1537,1236,0.0
5,1,110,1,1,1,338,1532,898,5,95, ,1537,1236,0.0
2,1,111,0,0,0,4,1512,451,78,-1,,1590,455,0.0
3,1,111,1,0,0,4,1512,451,78,-1,,1590,455,0.0
4,1,111,1,1,0,17,1512,438,15,-1,,1527,455,0.0
5,1,111,1,1,1,17,1513,27,14,85,co,1527,44,0.0
5,1,111,1,1,2,131,1512,138,15,91,239-95-269,1527,269,0.0
5,1,111,1,1,3,346,1512,109,15,91,29750.61,1527,455,0.0
4,1,111,1,2,0,139,1542,162,22,-1,,1564,301,0.0
5,1,111,1,2,1,139,1542,63,22,95,Wage,1564,202,0.0
5,1,111,1,2,2,211,1542,41,17,96,and,1559,252,0.0
5,1,111,1,2,3,261,1542,40,17,95,Tax,1559,301,0.0
4,1,111,1,3,0,4,1573,250,17,-1,,1590,254,0.0
5,1,111,1,3,1,4,1579,34,11,93,Form,1590,38,0.0
5,1,111,1,3,2,47,1579,25,11,89,W-2,1590,72,0.0
5,1,111,1,3,3,140,1573,114,17,96,Statement,1590,254,0.0
2,1,112,0,0,0,5,1602,291,37,-1,,1639,296,0.0
3,1,112,1,0,0,5,1602,291,37,-1,,1639,296,0.0
4,1,112,1,1,0,5,1602,291,15,-1,,1617,296,0.0
5,1,112,1,1,1,5,1602,40,15,93,Copy,1617,45,0.0
5,1,112,1,1,2,51,1602,10,12,91,C,1614,61,0.0
5,1,112,1,1,3,68,1602,26,12,96,For,1614,94,0.0
5,1,112,1,1,4,100,1602,103,12,86,EMPLOYEE'S,1614,203,0.0
5,1,112,1,1,5,210,1602,86,12,96,RECORDS.,1614,296,0.0
4,1,112,1,2,0,5,1624,276,15,-1,,1639,281,0.0
5,1,112,1,2,1,5,1624,33,15,95,(See,1639,38,0.0
5,1,112,1,2,2,44,1624,69,12,96,enclosed,1636,113,0.0
5,1,112,1,2,3,120,1624,49,12,96,Notice,1636,169,0.0
5,1,112,1,2,4,174,1624,16,12,96,to,1636,190,0.0
5,1,112,1,2,5,196,1624,85,15,95,Employee.),1639,281,0.0
2,1,113,0,0,0,549,1549,105,42,-1,,1591,654,0.0
3,1,113,1,0,0,549,1549,105,42,-1,,1591,654,0.0
4,1,113,1,1,0,549,1549,105,42,-1,,1591,654,0.0
5,1,113,1,1,1,549,1549,105,42,74,cOl,1591,654,0.0
2,1,114,0,0,0,666,1549,27,42,-1,,1591,693,0.0
3,1,114,1,0,0,666,1549,27,42,-1,,1591,693,0.0
4,1,114,1,1,0,666,1549,27,42,-1,,1591,693,0.0
5,1,114,1,1,1,666,1549,27,42,75,0,1591,693,0.0
2,1,115,0,0,0,926,1575,110,33,-1,,1608,1036,0.0
3,1,115,1,0,0,926,1575,110,33,-1,,1608,1036,0.0
4,1,115,1,1,0,927,1575,109,15,-1,,1590,1036,0.0
5,1,115,1,1,1,927,1575,35,15,92,"Safe,",1590,962,0.0
5,1,115,1,1,2,967,1575,69,15,92,"accurate,",1590,1036,0.0
4,1,115,1,2,0,926,1596,82,12,-1,,1608,1008,0.0
5,1,115,1,2,1,926,1596,44,12,94,FAST!,1608,970,0.0
5,1,115,1,2,2,980,1596,28,12,94,Use,1608,1008,0.0
2,1,116,0,0,0,864,1547,367,15,-1,,1562,1231,0.0
3,1,116,1,0,0,864,1547,367,15,-1,,1562,1231,0.0
4,1,116,1,1,0,864,1547,367,15,-1,,1562,1231,0.0
5,1,116,1,1,1,864,1547,81,15,95,Department,1562,945,0.0
5,1,116,1,1,2,950,1547,12,12,95,of,1559,962,0.0
5,1,116,1,1,3,966,1547,20,12,93,the,1559,986,0.0
5,1,116,1,1,4,991,1547,118,15,64,Treasury-Internal,1562,1109,0.0
5,1,116,1,1,5,1115,1547,59,12,94,Revenue,1559,1174,0.0
5,1,116,1,1,6,1180,1547,51,12,96,Service,1559,1231,0.0
2,1,117,0,0,0,1048,1578,134,33,-1,,1611,1182,0.0
3,1,117,1,0,0,1048,1578,134,33,-1,,1611,1182,0.0
4,1,117,1,1,0,1048,1578,134,33,-1,,1611,1182,0.0
5,1,117,1,1,1,1044,1574,48,52,30,Pe,1626,1092,0.0
5,1,117,1,1,2,1113,1574,48,52,51,file,1626,1161,0.0
5,1,117,1,1,3,1173,1574,10,52,19,|,1626,1183,0.0
1,1,0,0,0,0,0,0,1236,1658,-1,,1658,1236,0.0
2,1,1,0,0,0,596,1,1,50,-1,,51,597,0.0
3,1,1,1,0,0,596,1,1,50,-1,,51,597,0.0
4,1,1,1,1,0,596,1,1,50,-1,,51,597,0.0
5,1,1,1,1,1,596,1,1,50,95, ,51,597,0.0
2,1,2,0,0,0,1,50,658,3,-1,,53,659,0.0
3,1,2,1,0,0,1,50,658,3,-1,,53,659,0.0
4,1,2,1,1,0,1,50,658,3,-1,,53,659,0.0
5,1,2,1,1,1,1,50,658,3,95, ,53,659,0.0
2,1,3,0,0,0,1,102,658,3,-1,,105,659,0.0
3,1,3,1,0,0,1,102,658,3,-1,,105,659,0.0
4,1,3,1,1,0,1,102,658,3,-1,,105,659,0.0
5,1,3,1,1,1,1,102,658,3,95, ,105,659,0.0
2,1,4,0,0,0,660,154,576,3,-1,,157,1236,0.0
3,1,4,1,0,0,660,154,576,3,-1,,157,1236,0.0
4,1,4,1,1,0,660,154,576,3,-1,,157,1236,0.0
5,1,4,1,1,1,660,154,576,3,95, ,157,1236,0.0
2,1,5,0,0,0,660,205,576,3,-1,,208,1236,0.0
3,1,5,1,0,0,660,205,576,3,-1,,208,1236,0.0
4,1,5,1,1,0,660,205,576,3,-1,,208,1236,0.0
5,1,5,1,1,1,660,205,576,3,95, ,208,1236,0.0
2,1,6,0,0,0,1,256,658,3,-1,,259,659,0.0
3,1,6,1,0,0,1,256,658,3,-1,,259,659,0.0
4,1,6,1,1,0,1,256,658,3,-1,,259,659,0.0
5,1,6,1,1,1,1,256,658,3,95, ,259,659,0.0
2,1,7,0,0,0,1,308,658,3,-1,,311,659,0.0
3,1,7,1,0,0,1,308,658,3,-1,,311,659,0.0
4,1,7,1,1,0,1,308,658,3,-1,,311,659,0.0
5,1,7,1,1,1,1,308,658,3,95, ,311,659,0.0
2,1,8,0,0,0,660,365,576,3,-1,,368,1236,0.0
3,1,8,1,0,0,660,365,576,3,-1,,368,1236,0.0
4,1,8,1,1,0,660,365,576,3,-1,,368,1236,0.0
5,1,8,1,1,1,660,365,576,3,95, ,368,1236,0.0
2,1,9,0,0,0,689,394,204,1,-1,,395,893,0.0
3,1,9,1,0,0,689,394,204,1,-1,,395,893,0.0
4,1,9,1,1,0,689,394,204,1,-1,,395,893,0.0
5,1,9,1,1,1,689,394,204,1,95, ,395,893,0.0
2,1,10,0,0,0,689,394,1,28,-1,,422,690,0.0
3,1,10,1,0,0,689,394,1,28,-1,,422,690,0.0
4,1,10,1,1,0,689,394,1,28,-1,,422,690,0.0
5,1,10,1,1,1,689,394,1,28,95, ,422,690,0.0
2,1,11,0,0,0,718,394,1,28,-1,,422,719,0.0
3,1,11,1,0,0,718,394,1,28,-1,,422,719,0.0
4,1,11,1,1,0,718,394,1,28,-1,,422,719,0.0
5,1,11,1,1,1,718,394,1,28,95, ,422,719,0.0
2,1,12,0,0,0,776,394,1,28,-1,,422,777,0.0
3,1,12,1,0,0,776,394,1,28,-1,,422,777,0.0
4,1,12,1,1,0,776,394,1,28,-1,,422,777,0.0
5,1,12,1,1,1,776,394,1,28,95, ,422,777,0.0
2,1,13,0,0,0,805,394,1,28,-1,,422,806,0.0
3,1,13,1,0,0,805,394,1,28,-1,,422,806,0.0
4,1,13,1,1,0,805,394,1,28,-1,,422,806,0.0
5,1,13,1,1,1,805,394,1,28,95, ,422,806,0.0
2,1,14,0,0,0,863,394,1,28,-1,,422,864,0.0
3,1,14,1,0,0,863,394,1,28,-1,,422,864,0.0
4,1,14,1,1,0,863,394,1,28,-1,,422,864,0.0
5,1,14,1,1,1,863,394,1,28,95, ,422,864,0.0
2,1,15,0,0,0,892,394,1,28,-1,,422,893,0.0
3,1,15,1,0,0,892,394,1,28,-1,,422,893,0.0
4,1,15,1,1,0,892,394,1,28,-1,,422,893,0.0
5,1,15,1,1,1,892,394,1,28,95, ,422,893,0.0
2,1,16,0,0,0,660,420,576,5,-1,,425,1236,0.0
3,1,16,1,0,0,660,420,576,5,-1,,425,1236,0.0
4,1,16,1,1,0,660,420,576,5,-1,,425,1236,0.0
5,1,16,1,1,1,660,420,576,5,95, ,425,1236,0.0
2,1,17,0,0,0,689,420,547,5,-1,,425,1236,0.0
3,1,17,1,0,0,689,420,547,5,-1,,425,1236,0.0
4,1,17,1,1,0,689,420,547,5,-1,,425,1236,0.0
5,1,17,1,1,1,689,420,547,5,95, ,425,1236,0.0
2,1,18,0,0,0,689,420,547,5,-1,,425,1236,0.0
3,1,18,1,0,0,689,420,547,5,-1,,425,1236,0.0
4,1,18,1,1,0,689,420,547,5,-1,,425,1236,0.0
5,1,18,1,1,1,689,420,547,5,95, ,425,1236,0.0
2,1,19,0,0,0,689,420,547,5,-1,,425,1236,0.0
3,1,19,1,0,0,689,420,547,5,-1,,425,1236,0.0
4,1,19,1,1,0,689,420,547,5,-1,,425,1236,0.0
5,1,19,1,1,1,689,420,547,5,95, ,425,1236,0.0
2,1,20,0,0,0,950,479,286,3,-1,,482,1236,0.0
3,1,20,1,0,0,950,479,286,3,-1,,482,1236,0.0
4,1,20,1,1,0,950,479,286,3,-1,,482,1236,0.0
5,1,20,1,1,1,950,479,286,3,95, ,482,1236,0.0
2,1,21,0,0,0,1042,326,3,212,-1,,538,1045,0.0
3,1,21,1,0,0,1042,326,3,212,-1,,538,1045,0.0
4,1,21,1,1,0,1042,326,3,212,-1,,538,1045,0.0
5,1,21,1,1,1,1042,326,3,212,95, ,538,1045,0.0
2,1,22,0,0,0,950,536,286,3,-1,,539,1236,0.0
3,1,22,1,0,0,950,536,286,3,-1,,539,1236,0.0
4,1,22,1,1,0,950,536,286,3,-1,,539,1236,0.0
5,1,22,1,1,1,950,536,286,3,95, ,539,1236,0.0
2,1,23,0,0,0,659,105,3,454,-1,,559,662,0.0
3,1,23,1,0,0,659,105,3,454,-1,,559,662,0.0
4,1,23,1,1,0,659,105,3,454,-1,,559,662,0.0
5,1,23,1,1,1,659,105,3,454,95, ,559,662,0.0
2,1,24,0,0,0,949,105,3,454,-1,,559,952,0.0
3,1,24,1,0,0,949,105,3,454,-1,,559,952,0.0
4,1,24,1,1,0,949,105,3,454,-1,,559,952,0.0
5,1,24,1,1,1,949,105,3,454,95, ,559,952,0.0
2,1,25,0,0,0,1,556,1235,5,-1,,561,1236,0.0
3,1,25,1,0,0,1,556,1235,5,-1,,561,1236,0.0
4,1,25,1,1,0,1,556,1235,5,-1,,561,1236,0.0
5,1,25,1,1,1,1,556,1235,5,95, ,561,1236,0.0
2,1,26,0,0,0,3,609,1109,1,-1,,610,1112,0.0
3,1,26,1,0,0,3,609,1109,1,-1,,610,1112,0.0
4,1,26,1,1,0,3,609,1109,1,-1,,610,1112,0.0
5,1,26,1,1,1,3,609,1109,1,95, ,610,1112,0.0
2,1,27,0,0,0,59,558,1,103,-1,,661,60,0.0
3,1,27,1,0,0,59,558,1,103,-1,,661,60,0.0
4,1,27,1,1,0,59,558,1,103,-1,,661,60,0.0
5,1,27,1,1,1,59,558,1,103,95, ,661,60,0.0
2,1,28,0,0,0,340,558,1,103,-1,,661,341,0.0
3,1,28,1,0,0,340,558,1,103,-1,,661,341,0.0
4,1,28,1,1,0,340,558,1,103,-1,,661,341,0.0
5,1,28,1,1,1,340,558,1,103,95, ,661,341,0.0
2,1,29,0,0,0,532,558,1,103,-1,,661,533,0.0
3,1,29,1,0,0,532,558,1,103,-1,,661,533,0.0
4,1,29,1,1,0,532,558,1,103,-1,,661,533,0.0
5,1,29,1,1,1,532,558,1,103,95, ,661,533,0.0
2,1,30,0,0,0,717,394,3,267,-1,,661,720,0.0
3,1,30,1,0,0,717,394,3,267,-1,,661,720,0.0
4,1,30,1,1,0,717,394,3,267,-1,,661,720,0.0
5,1,30,1,1,1,717,394,3,267,95, ,661,720,0.0
2,1,31,0,0,0,921,558,1,103,-1,,661,922,0.0
3,1,31,1,0,0,921,558,1,103,-1,,661,922,0.0
4,1,31,1,1,0,921,558,1,103,-1,,661,922,0.0
5,1,31,1,1,1,921,558,1,103,95, ,661,922,0.0
2,1,32,0,0,0,1234,1,2,660,-1,,661,1236,0.0
3,1,32,1,0,0,1234,1,2,660,-1,,661,1236,0.0
4,1,32,1,1,0,1234,1,2,660,-1,,661,1236,0.0
5,1,32,1,1,1,1234,1,2,660,95, ,661,1236,0.0
2,1,33,0,0,0,1107,558,1,103,-1,,661,1108,0.0
3,1,33,1,0,0,1107,558,1,103,-1,,661,1108,0.0
4,1,33,1,1,0,1107,558,1,103,-1,,661,1108,0.0
5,1,33,1,1,1,1107,558,1,103,95, ,661,1108,0.0
2,1,34,0,0,0,1,658,1235,5,-1,,663,1236,0.0
3,1,34,1,0,0,1,658,1235,5,-1,,663,1236,0.0
4,1,34,1,1,0,1,658,1235,5,-1,,663,1236,0.0
5,1,34,1,1,1,1,658,1235,5,95, ,663,1236,0.0
2,1,35,0,0,0,4,3,1230,717,-1,,720,1234,0.0
3,1,35,1,0,0,4,3,1230,717,-1,,720,1234,0.0
4,1,35,1,1,0,55,3,1138,17,-1,,20,1193,0.0
5,1,35,1,1,1,55,5,103,15,91,REISSUED,20,158,0.0
5,1,35,1,1,2,216,7,6,7,31,{a,14,222,0.0
5,1,35,1,1,3,236,0,70,24,65,Employee's,24,306,0.0
5,1,35,1,1,4,312,4,35,10,96,social,14,347,0.0
5,1,35,1,1,5,352,4,48,13,95,security,17,400,0.0
5,1,35,1,1,6,406,4,48,10,95,number,14,454,0.0
5,1,35,1,1,7,782,3,35,14,96,"Safe,",17,817,0.0
5,1,35,1,1,8,822,3,71,14,96,"Accurate,",17,893,0.0
5,1,35,1,1,9,1043,0,35,26,95,Visit,26,1078,0.0
5,1,35,1,1,10,1084,4,18,12,95,the,16,1102,0.0
5,1,35,1,1,11,1108,4,23,12,96,IRS,16,1131,0.0
5,1,35,1,1,12,1136,4,57,12,96,Website,16,1193,0.0
4,1,35,1,2,0,44,6,1136,45,-1,,51,1180,0.0
5,1,35,1,2,1,44,17,126,34,96,STATEMENT,51,170,0.0
5,1,35,1,2,2,312,17,151,32,37,7719-70-5706,49,463,0.0
5,1,35,1,2,3,612,29,28,10,93,OMB,39,640,0.0
5,1,35,1,2,4,646,29,14,10,93,No.,39,660,0.0
5,1,35,1,2,5,671,29,57,10,69,1646-0008,39,728,0.0
5,1,35,1,2,6,781,28,44,12,94,FAST!,40,825,0.0
5,1,35,1,2,7,835,28,28,12,94,Use,40,863,0.0
5,1,35,1,2,8,900,6,120,45,0,e-file,51,1020,0.0
5,1,35,1,2,9,1031,6,12,45,0,),51,1043,0.0
5,1,35,1,2,10,1048,30,12,11,93,at,41,1060,0.0
5,1,35,1,2,11,1069,29,111,15,64,www.irs.goviefile.,44,1180,0.0
4,1,35,1,3,0,12,56,1143,13,-1,,69,1155,0.0
5,1,35,1,3,1,12,56,7,10,79,b,66,19,0.0
5,1,35,1,3,2,29,56,54,13,90,Employer,69,83,0.0
5,1,35,1,3,3,88,56,70,10,95,identification,66,158,0.0
5,1,35,1,3,4,164,56,42,10,96,number,66,206,0.0
5,1,35,1,3,5,681,56,4,10,70,1,66,685,0.0
5,1,35,1,3,6,704,56,40,13,79,"Wages,",69,744,0.0
5,1,35,1,3,7,753,57,24,12,95,"tips,",69,777,0.0
5,1,35,1,3,8,783,56,28,10,96,other,66,811,0.0
5,1,35,1,3,9,819,48,76,26,96,compensation,74,895,0.0
5,1,35,1,3,10,970,56,7,10,31,2,66,977,0.0
5,1,35,1,3,11,995,56,41,10,83,Federal,66,1036,0.0
5,1,35,1,3,12,1042,59,40,7,96,income,66,1082,0.0
5,1,35,1,3,13,1087,57,18,9,96,tax,66,1105,0.0
5,1,35,1,3,14,1109,56,46,10,96,withheld,66,1155,0.0
4,1,35,1,4,0,66,80,1028,15,-1,,95,1094,0.0
5,1,35,1,4,1,66,80,136,15,91,39-3114215,95,202,0.0
5,1,35,1,4,2,725,80,123,15,90,126204.09,95,848,0.0
5,1,35,1,4,3,985,80,109,15,89,40043.57,95,1094,0.0
4,1,35,1,5,0,13,108,1139,13,-1,,121,1152,0.0
5,1,35,1,5,1,13,111,6,7,48,ยข,118,19,0.0
5,1,35,1,5,2,29,108,62,13,94,Employers,121,91,0.0
5,1,35,1,5,3,97,111,30,7,87,"name,",118,127,0.0
5,1,35,1,5,4,137,108,44,10,90,"address,",118,181,0.0
5,1,35,1,5,5,191,108,19,10,96,and,118,210,0.0
5,1,35,1,5,6,215,108,18,10,96,ZIP,118,233,0.0
5,1,35,1,5,7,239,108,26,10,96,code,118,265,0.0
5,1,35,1,5,8,681,108,6,10,69,3,118,687,0.0
5,1,35,1,5,9,705,108,34,10,89,Social,118,739,0.0
5,1,35,1,5,10,745,109,45,12,93,security,121,790,0.0
5,1,35,1,5,11,794,111,36,10,96,wages,121,830,0.0
5,1,35,1,5,12,970,108,7,10,66,4,118,977,0.0
5,1,35,1,5,13,995,108,34,10,71,Social,118,1029,0.0
5,1,35,1,5,14,1036,100,43,25,96,security,125,1079,0.0
5,1,35,1,5,15,1084,109,18,9,96,tax,118,1102,0.0
5,1,35,1,5,16,1106,108,46,10,96,withheld,118,1152,0.0
4,1,35,1,6,0,65,133,1015,20,-1,,153,1080,0.0
5,1,35,1,6,1,65,133,97,15,96,Carlson,148,162,0.0
5,1,35,1,6,2,177,134,68,19,96,Group,153,245,0.0
5,1,35,1,6,3,261,134,68,19,95,Group,153,329,0.0
5,1,35,1,6,4,725,133,123,15,91,123655.86,148,848,0.0
5,1,35,1,6,5,986,133,94,15,93,9459.67,148,1080,0.0
4,1,35,1,7,0,66,159,1053,23,-1,,182,1119,0.0
5,1,35,1,7,1,66,167,67,15,96,56319,182,133,0.0
5,1,35,1,7,2,148,167,126,15,96,Underwood,182,274,0.0
5,1,35,1,7,3,287,167,70,15,96,Views,182,357,0.0
5,1,35,1,7,4,681,159,6,10,71,5,169,687,0.0
5,1,35,1,7,5,705,159,51,10,81,Medicare,169,756,0.0
5,1,35,1,7,6,761,162,36,10,96,wages,172,797,0.0
5,1,35,1,7,7,803,159,19,10,89,and,169,822,0.0
5,1,35,1,7,8,827,160,20,12,89,tips,172,847,0.0
5,1,35,1,7,9,970,159,6,10,63,6,169,976,0.0
5,1,35,1,7,10,995,159,51,10,74,Medicare,169,1046,0.0
5,1,35,1,7,11,1051,160,18,9,96,tax,169,1069,0.0
5,1,35,1,7,12,1073,159,46,10,96,withheld,169,1119,0.0
4,1,35,1,8,0,725,184,405,15,-1,,199,1130,0.0
5,1,35,1,8,1,725,184,123,15,91,152406.79,199,848,0.0
5,1,35,1,8,2,1050,184,80,15,95,4419.8,199,1130,0.0
4,1,35,1,9,0,65,201,1007,22,-1,,223,1072,0.0
5,1,35,1,9,1,65,201,54,15,93,Lake,216,119,0.0
5,1,35,1,9,2,134,201,140,15,92,Debramouth,216,274,0.0
5,1,35,1,9,3,288,202,27,14,96,NE,216,315,0.0
5,1,35,1,9,4,332,201,136,15,95,33667-9751,216,468,0.0
5,1,35,1,9,5,681,210,5,10,58,7,220,686,0.0
5,1,35,1,9,6,705,210,34,10,82,Social,220,739,0.0
5,1,35,1,9,7,747,198,40,30,51,securty,228,787,0.0
5,1,35,1,9,8,794,211,20,12,95,tips,223,814,0.0
5,1,35,1,9,9,971,210,5,10,56,@,220,976,0.0
5,1,35,1,9,10,994,210,53,10,52,Allocated,220,1047,0.0
5,1,35,1,9,11,1052,211,20,12,96,tips,223,1072,0.0
4,1,35,1,10,0,725,235,446,15,-1,,250,1171,0.0
5,1,35,1,10,1,725,235,123,15,91,123655.86,250,848,0.0
5,1,35,1,10,2,1050,235,121,15,65,152406.79,250,1171,0.0
4,1,35,1,11,0,11,262,1122,13,-1,,275,1133,0.0
5,1,35,1,11,1,11,262,7,10,0,d-,272,18,0.0
5,1,35,1,11,2,29,262,39,10,94,Control,272,68,0.0
5,1,35,1,11,3,74,262,42,10,96,number,272,116,0.0
5,1,35,1,11,4,680,262,7,10,65,9,272,687,0.0
5,1,35,1,11,5,704,262,48,10,78,Advance,272,752,0.0
5,1,35,1,11,6,758,262,19,10,92,EIC,272,777,0.0
5,1,35,1,11,7,783,263,48,12,96,payment,275,831,0.0
5,1,35,1,11,8,964,262,13,10,82,10,272,977,0.0
5,1,35,1,11,9,995,262,60,13,74,Dependent,275,1055,0.0
5,1,35,1,11,10,1061,265,23,7,96,care,272,1084,0.0
5,1,35,1,11,11,1090,262,43,10,94,benefits,272,1133,0.0
4,1,35,1,12,0,12,313,1163,13,-1,,326,1175,0.0
5,1,35,1,12,1,29,313,65,13,81,Employee's,326,94,0.0
5,1,35,1,12,2,99,313,20,10,94,first,323,119,0.0
5,1,35,1,12,3,125,316,30,7,94,name,323,155,0.0
5,1,35,1,12,4,161,313,19,10,96,and,323,180,0.0
5,1,35,1,12,5,186,313,28,10,95,initial,323,214,0.0
5,1,35,1,12,6,280,313,23,10,95,Last,323,303,0.0
5,1,35,1,12,7,309,316,30,7,94,name,323,339,0.0
5,1,35,1,12,8,674,313,11,10,56,71,323,685,0.0
5,1,35,1,12,9,705,313,68,13,69,Nonqualified,326,773,0.0
5,1,35,1,12,10,779,313,29,13,65,"plans,",326,808,0.0
5,1,35,1,12,11,966,313,20,10,36,12a,323,986,0.0
5,1,35,1,12,12,1009,313,22,10,64,See,323,1031,0.0
5,1,35,1,12,13,1037,313,71,10,95,instructions,323,1108,0.0
5,1,35,1,12,14,1112,313,17,10,96,for,323,1129,0.0
5,1,35,1,12,15,1134,313,22,10,96,box,323,1156,0.0
5,1,35,1,12,16,1162,313,13,10,91,12,323,1175,0.0
4,1,35,1,13,0,724,344,379,15,-1,,359,1103,0.0
5,1,35,1,13,1,724,344,40,15,96,233,359,764,0.0
5,1,35,1,13,2,1006,345,13,14,88,P,359,1019,0.0
5,1,35,1,13,3,1050,344,53,15,7,{9966,359,1103,0.0
4,1,35,1,14,0,65,358,922,23,-1,,381,987,0.0
5,1,35,1,14,1,65,358,94,22,96,Taylor,380,159,0.0
5,1,35,1,14,2,177,359,46,16,96,Cox,375,223,0.0
5,1,35,1,14,3,674,370,13,10,54,1B,380,687,0.0
5,1,35,1,14,4,693,371,43,10,37,Slatutory,381,736,0.0
5,1,35,1,14,5,780,371,50,8,0,Retirement,379,830,0.0
5,1,35,1,14,6,866,371,24,8,0,Thre,379,890,0.0
5,1,35,1,14,7,895,359,24,30,3,parky,389,919,0.0
5,1,35,1,14,8,966,370,21,10,58,1,380,987,0.0
4,1,35,1,15,0,693,385,213,9,-1,,394,906,0.0
5,1,35,1,15,1,693,385,45,9,18,empeyee,394,738,0.0
5,1,35,1,15,2,780,385,18,9,46,plan,394,798,0.0
5,1,35,1,15,3,867,385,18,8,85,sick,393,885,0.0
5,1,35,1,15,4,895,387,11,7,85,pay,394,906,0.0
4,1,35,1,16,0,67,396,1021,22,-1,,418,1088,0.0
5,1,35,1,16,1,67,396,43,17,96,613,413,110,1.0
5,1,35,1,16,2,128,397,79,21,96,Roger,418,207,1.0
5,1,35,1,16,3,225,397,78,16,96,Crest,413,303,1.0
5,1,35,1,16,4,319,397,59,21,96,Apt.,418,378,1.0
5,1,35,1,16,5,402,396,44,17,96,802,413,446,1.0
5,1,35,1,16,6,786,402,10,11,66,x,413,796,0.0
5,1,35,1,16,7,1049,398,39,15,96,284,413,1088,0.0
4,1,35,1,17,0,65,427,921,25,-1,,452,986,0.0
5,1,35,1,17,1,65,436,94,16,91,Leeton,452,159,1.0
5,1,35,1,17,2,178,436,31,16,95,IA,452,209,1.0
5,1,35,1,17,3,273,435,157,17,95,26442-8249,452,430,0.0
5,1,35,1,17,4,674,427,13,10,49,44,437,687,0.0
5,1,35,1,17,5,705,427,31,10,81,Other,437,736,0.0
5,1,35,1,17,6,741,427,23,13,86,(see,440,764,0.0
5,1,35,1,17,7,770,427,50,10,96,enclosed,437,820,0.0
5,1,35,1,17,8,826,427,35,10,96,Notice,437,861,0.0
5,1,35,1,17,9,866,428,10,9,96,to,437,876,0.0
5,1,35,1,17,10,882,427,61,13,94,Employee),440,943,0.0
5,1,35,1,17,11,949,419,11,25,46,|,444,960,0.0
5,1,35,1,17,12,966,427,20,10,38,12c,437,986,0.0
4,1,35,1,18,0,1007,458,81,15,-1,,473,1088,0.0
5,1,35,1,18,1,1007,459,12,14,91,P,473,1019,0.0
5,1,35,1,18,2,1050,458,38,15,18,(307,473,1088,0.0
4,1,35,1,19,0,966,484,20,10,-1,,494,986,0.0
5,1,35,1,19,1,966,484,20,10,88,12d,494,986,0.0
4,1,35,1,20,0,1006,515,82,15,-1,,530,1088,0.0
5,1,35,1,20,1,1006,516,13,14,82,H,530,1019,0.0
5,1,35,1,20,2,1049,515,39,15,82,|242,530,1088,0.0
4,1,35,1,21,0,11,545,213,13,-1,,558,224,0.0
5,1,35,1,21,1,11,545,5,10,91,f,555,16,0.0
5,1,35,1,21,2,29,545,65,13,53,Employee's,558,94,0.0
5,1,35,1,21,3,100,545,44,10,91,address,555,144,0.0
5,1,35,1,21,4,150,545,19,10,96,and,555,169,0.0
5,1,35,1,21,5,174,545,18,10,94,ZIP,555,192,0.0
5,1,35,1,21,6,197,545,27,10,96,code,555,224,0.0
4,1,35,1,22,0,6,562,1210,13,-1,,575,1216,0.0
5,1,35,1,22,1,6,562,13,10,70,15,572,19,0.0
5,1,35,1,22,2,29,562,29,10,22,State!,572,58,0.0
5,1,35,1,22,3,88,562,62,13,76,Employer's,575,150,0.0
5,1,35,1,22,4,156,563,27,9,96,state,572,183,0.0
5,1,35,1,22,5,189,562,10,10,95,ID,572,199,0.0
5,1,35,1,22,6,205,562,42,10,96,number,572,247,0.0
5,1,35,1,22,7,349,562,12,10,88,16,572,361,0.0
5,1,35,1,22,8,370,562,29,10,96,State,572,399,0.0
5,1,35,1,22,9,404,565,36,10,83,wages.,575,440,0.0
5,1,35,1,22,10,449,563,20,12,95,"tips,",575,469,0.0
5,1,35,1,22,11,479,563,16,9,88,etc.,572,495,0.0
5,1,35,1,22,12,541,562,11,10,89,17,572,552,0.0
5,1,35,1,22,13,562,562,29,10,92,State,572,591,0.0
5,1,35,1,22,14,597,565,40,7,95,income,572,637,0.0
5,1,35,1,22,15,642,563,18,9,93,tax,572,660,0.0
5,1,35,1,22,16,726,562,12,10,77,48,572,738,0.0
5,1,35,1,22,17,748,562,29,10,92,Local,572,777,0.0
5,1,35,1,22,18,782,565,36,10,95,wages.,575,818,0.0
5,1,35,1,22,19,827,563,20,12,94,"tips,",575,847,0.0
5,1,35,1,22,20,857,563,16,9,93,etc.,572,873,0.0
5,1,35,1,22,21,930,562,11,10,79,19,572,941,0.0
5,1,35,1,22,22,951,562,29,10,93,Local,572,980,0.0
5,1,35,1,22,23,986,565,40,7,95,income,572,1026,0.0
5,1,35,1,22,24,1031,563,18,9,96,tax,572,1049,0.0
5,1,35,1,22,25,1114,562,13,10,87,20,572,1127,0.0
5,1,35,1,22,26,1137,562,44,13,91,Locality,575,1181,0.0
5,1,35,1,22,27,1186,565,30,7,96,name,572,1216,0.0
4,1,35,1,23,0,12,583,1222,28,-1,,611,1234,0.0
5,1,35,1,23,1,12,583,33,28,96,MA,611,45,0.0
5,1,35,1,23,2,132,587,137,15,81,678-77-709,602,269,0.0
5,1,35,1,23,3,347,587,109,15,89,66553.66,602,456,0.0
5,1,35,1,23,4,539,587,95,15,96,8190.59,602,634,0.0
5,1,35,1,23,5,725,587,122,15,90,131974.67,602,847,0.0
5,1,35,1,23,6,928,587,109,15,0,13955:55,602,1037,0.0
5,1,35,1,23,7,1112,593,64,9,96,Melissa,602,1176,0.0
5,1,35,1,23,8,1186,593,48,17,96,Pines,610,1234,0.0
4,1,35,1,24,0,12,634,1219,28,-1,,662,1231,0.0
5,1,35,1,24,1,12,634,32,28,96,MN,662,44,0.0
5,1,35,1,24,2,132,638,136,15,92,940-46-434,653,268,0.0
5,1,35,1,24,3,347,638,108,15,88,66754.52,653,455,0.0
5,1,35,1,24,4,539,638,95,15,96,6506.63,653,634,0.0
5,1,35,1,24,5,725,638,122,15,90,104567.25,653,847,0.0
5,1,35,1,24,6,928,638,108,15,89,19328.85,653,1036,0.0
5,1,35,1,24,7,1112,641,59,12,96,Duane,653,1171,0.0
5,1,35,1,24,8,1185,640,46,13,96,Flat,653,1231,0.0
4,1,35,1,25,0,139,670,1092,22,-1,,692,1231,0.0
5,1,35,1,25,1,139,670,63,22,96,Wage,692,202,0.0
5,1,35,1,25,2,211,670,41,17,96,and,687,252,0.0
5,1,35,1,25,3,261,670,40,17,96,Tax,687,301,0.0
5,1,35,1,25,4,864,675,81,15,96,Department,690,945,0.0
5,1,35,1,25,5,950,675,12,12,96,of,687,962,0.0
5,1,35,1,25,6,966,675,20,12,93,the,687,986,0.0
5,1,35,1,25,7,991,675,118,15,35,TreasuryโInternal,690,1109,0.0
5,1,35,1,25,8,1115,675,59,12,96,Revenue,687,1174,0.0
5,1,35,1,25,9,1180,675,51,12,97,Service,687,1231,0.0
4,1,35,1,26,0,4,677,689,43,-1,,720,693,0.0
5,1,35,1,26,1,4,709,34,11,93,Form,720,38,0.0
5,1,35,1,26,2,47,709,25,11,91,W-2,720,72,0.0
5,1,35,1,26,3,140,701,114,17,96,Statement,718,254,0.0
5,1,35,1,26,4,549,677,27,42,21,c,719,576,0.0
5,1,35,1,26,5,588,677,27,42,50,0,719,615,0.0
5,1,35,1,26,6,628,677,26,42,59,1,719,654,0.0
5,1,35,1,26,7,666,677,27,42,52,0,719,693,0.0
2,1,36,0,0,0,4,732,482,37,-1,,769,486,0.0
3,1,36,1,0,0,4,732,482,37,-1,,769,486,0.0
4,1,36,1,1,0,5,732,462,15,-1,,747,467,0.0
5,1,36,1,1,1,5,732,40,15,93,Copy,747,45,0.0
5,1,36,1,1,2,51,732,43,12,91,B--To,744,94,0.0
5,1,36,1,1,3,100,732,20,12,96,Be,744,120,0.0
5,1,36,1,1,4,126,732,35,12,95,Filed,744,161,0.0
5,1,36,1,1,5,167,732,32,12,96,with,744,199,0.0
5,1,36,1,1,6,206,732,87,15,85,Employee's,747,293,0.0
5,1,36,1,1,7,300,732,76,12,96,FEDERAL,744,376,0.0
5,1,36,1,1,8,382,732,27,12,95,Tax,744,409,0.0
5,1,36,1,1,9,415,732,52,12,96,Return,744,467,0.0
4,1,36,1,2,0,4,754,482,15,-1,,769,486,0.0
5,1,36,1,2,1,4,754,29,12,96,This,766,33,0.0
5,1,36,1,2,2,40,754,79,12,93,information,766,119,0.0
5,1,36,1,2,3,126,757,10,9,93,is,766,136,0.0
5,1,36,1,2,4,143,754,38,15,94,being,769,181,0.0
5,1,36,1,2,5,187,754,67,12,96,furnished,766,254,0.0
5,1,36,1,2,6,260,754,12,12,96,to,766,272,0.0
5,1,36,1,2,7,278,754,22,12,96,the,766,300,0.0
5,1,36,1,2,8,307,754,52,12,93,Internal,766,359,0.0
5,1,36,1,2,9,365,754,62,12,95,Revenue,766,427,0.0
5,1,36,1,2,10,433,754,53,12,96,Service,766,486,0.0
2,1,37,0,0,0,469,825,294,14,-1,,839,763,0.0
3,1,37,1,0,0,469,825,294,14,-1,,839,763,0.0
4,1,37,1,1,0,469,825,294,14,-1,,839,763,0.0
5,1,37,1,1,1,469,825,55,11,51,Tuthere.,836,524,0.0
5,1,37,1,1,2,537,825,32,14,92,Keep,839,569,0.0
5,1,37,1,1,3,575,825,34,11,94,lower,836,609,0.0
5,1,37,1,1,4,614,826,42,13,96,portion,839,656,0.0
5,1,37,1,1,5,661,825,17,11,72,for,836,678,0.0
5,1,37,1,1,6,682,828,28,11,94,your,839,710,0.0
5,1,37,1,1,7,715,825,48,11,67,records,836,763,0.0
2,1,38,0,0,0,1,872,1235,5,-1,,877,1236,0.0
3,1,38,1,0,0,1,872,1235,5,-1,,877,1236,0.0
4,1,38,1,1,0,1,872,1235,5,-1,,877,1236,0.0
5,1,38,1,1,1,1,872,1235,5,95, ,877,1236,0.0
2,1,39,0,0,0,212,874,1,52,-1,,926,213,0.0
3,1,39,1,0,0,212,874,1,52,-1,,926,213,0.0
4,1,39,1,1,0,212,874,1,52,-1,,926,213,0.0
5,1,39,1,1,1,212,874,1,52,95, ,926,213,0.0
2,1,40,0,0,0,596,874,1,52,-1,,926,597,0.0
3,1,40,1,0,0,596,874,1,52,-1,,926,597,0.0
4,1,40,1,1,0,596,874,1,52,-1,,926,597,0.0
5,1,40,1,1,1,596,874,1,52,95, ,926,597,0.0
2,1,41,0,0,0,1,923,1235,5,-1,,928,1236,0.0
3,1,41,1,0,0,1,923,1235,5,-1,,928,1236,0.0
4,1,41,1,1,0,1,923,1235,5,-1,,928,1236,0.0
5,1,41,1,1,1,1,923,1235,5,95, ,928,1236,0.0
2,1,42,0,0,0,1,974,1235,5,-1,,979,1236,0.0
3,1,42,1,0,0,1,974,1235,5,-1,,979,1236,0.0
4,1,42,1,1,0,1,974,1235,5,-1,,979,1236,0.0
5,1,42,1,1,1,1,974,1235,5,95, ,979,1236,0.0
2,1,43,0,0,0,660,1026,576,3,-1,,1029,1236,0.0
3,1,43,1,0,0,660,1026,576,3,-1,,1029,1236,0.0
4,1,43,1,1,0,660,1026,576,3,-1,,1029,1236,0.0
5,1,43,1,1,1,660,1026,576,3,95, ,1029,1236,0.0
2,1,44,0,0,0,660,1077,576,3,-1,,1080,1236,0.0
3,1,44,1,0,0,660,1077,576,3,-1,,1080,1236,0.0
4,1,44,1,1,0,660,1077,576,3,-1,,1080,1236,0.0
5,1,44,1,1,1,660,1077,576,3,95, ,1080,1236,0.0
2,1,45,0,0,0,1,1127,1235,5,-1,,1132,1236,0.0
3,1,45,1,0,0,1,1127,1235,5,-1,,1132,1236,0.0
4,1,45,1,1,0,1,1127,1235,5,-1,,1132,1236,0.0
5,1,45,1,1,1,1,1127,1235,5,95, ,1132,1236,0.0
2,1,46,0,0,0,1,1178,1235,5,-1,,1183,1236,0.0
3,1,46,1,0,0,1,1178,1235,5,-1,,1183,1236,0.0
4,1,46,1,1,0,1,1178,1235,5,-1,,1183,1236,0.0
5,1,46,1,1,1,1,1178,1235,5,95, ,1183,1236,0.0
2,1,47,0,0,0,11,878,1217,553,-1,,1431,1228,0.0
3,1,47,1,0,0,11,878,1217,553,-1,,1431,1228,0.0
4,1,47,1,1,0,55,878,1137,16,-1,,894,1192,0.0
5,1,47,1,1,1,55,879,103,15,91,REISSUED,894,158,0.0
5,1,47,1,1,2,216,881,6,7,61,[a,888,222,0.0
5,1,47,1,1,3,236,878,71,13,28,Employee's,891,307,0.0
5,1,47,1,1,4,311,878,36,10,95,social,888,347,0.0
5,1,47,1,1,5,352,878,48,13,95,security,891,400,0.0
5,1,47,1,1,6,406,878,48,10,96,number,888,454,0.0
5,1,47,1,1,7,750,878,23,10,95,This,888,773,0.0
5,1,47,1,1,8,779,878,61,10,96,information,888,840,0.0
5,1,47,1,1,9,846,881,8,7,90,is,888,854,0.0
5,1,47,1,1,10,860,878,29,13,90,being,891,889,0.0
5,1,47,1,1,11,894,878,51,10,93,furnished,888,945,0.0
5,1,47,1,1,12,950,879,10,9,96,to,888,960,0.0
5,1,47,1,1,13,965,878,17,10,96,the,888,982,0.0
5,1,47,1,1,14,988,878,40,10,84,Internal,888,1028,0.0
5,1,47,1,1,15,1034,878,47,10,93,Revenue,888,1081,0.0
5,1,47,1,1,16,1087,878,40,10,74,Senice.,888,1127,0.0
5,1,47,1,1,17,1141,878,6,10,77,If,888,1147,0.0
5,1,47,1,1,18,1150,881,20,10,77,you,891,1170,0.0
5,1,47,1,1,19,1176,881,16,7,94,are,888,1192,0.0
4,1,47,1,2,0,698,895,530,15,-1,,910,1228,0.0
5,1,47,1,2,1,698,909,3,1,13,c,910,701,0.0
5,1,47,1,2,2,751,895,44,13,95,required,908,795,0.0
5,1,47,1,2,3,800,887,8,26,96,to,913,808,0.0
5,1,47,1,2,4,805,895,25,10,96,file,905,830,0.0
5,1,47,1,2,5,836,898,5,7,78,a,905,841,0.0
5,1,47,1,2,6,846,896,18,9,78,tax,905,864,0.0
5,1,47,1,2,7,869,896,35,10,65,"return,",906,904,0.0
5,1,47,1,2,8,910,898,5,7,95,a,905,915,0.0
5,1,47,1,2,9,921,895,60,13,96,negligence,908,981,0.0
5,1,47,1,2,10,987,895,41,13,96,penalty,908,1028,0.0
5,1,47,1,2,11,1033,898,10,7,95,or,905,1043,0.0
5,1,47,1,2,12,1048,895,28,10,96,other,905,1076,0.0
5,1,47,1,2,13,1081,896,47,9,96,sanction,905,1128,0.0
5,1,47,1,2,14,1134,898,24,10,97,may,908,1158,0.0
5,1,47,1,2,15,1163,895,12,10,96,be,905,1175,0.0
5,1,47,1,2,16,1181,895,47,13,88,imposed,908,1228,0.0
4,1,47,1,3,0,44,899,1018,34,-1,,933,1062,0.0
5,1,47,1,3,1,44,906,126,15,96,STATEMENT,921,170,0.0
5,1,47,1,3,2,312,899,151,34,41,779-710-5706,933,463,0.0
5,1,47,1,3,3,612,903,28,10,96,OMB,913,640,0.0
5,1,47,1,3,4,646,903,14,10,79,No.,913,660,0.0
5,1,47,1,3,5,671,903,57,10,80,1645-0008,913,728,0.0
5,1,47,1,3,6,751,915,12,7,50,on,922,763,0.0
5,1,47,1,3,7,776,915,12,7,38,you,922,788,0.0
5,1,47,1,3,8,794,912,6,10,38,if,922,800,0.0
5,1,47,1,3,9,803,912,20,10,79,this,922,823,0.0
5,1,47,1,3,10,829,915,40,7,55,income,922,869,0.0
5,1,47,1,3,11,875,915,8,7,92,is,922,883,0.0
5,1,47,1,3,12,888,912,41,10,92,taxable,922,929,0.0
5,1,47,1,3,13,935,912,19,10,96,and,922,954,0.0
5,1,47,1,3,14,967,915,12,7,75,you,922,979,0.0
5,1,47,1,3,15,984,912,15,10,75,fail,922,999,0.0
5,1,47,1,3,16,1004,913,10,9,86,to,922,1014,0.0
5,1,47,1,3,17,1020,913,31,12,52,report,925,1051,0.0
5,1,47,1,3,18,1057,913,5,9,52,it,922,1062,0.0
4,1,47,1,4,0,12,929,1143,13,-1,,942,1155,0.0
5,1,47,1,4,1,12,929,7,10,79,b,939,19,0.0
5,1,47,1,4,2,29,929,54,13,93,Employer,942,83,0.0
5,1,47,1,4,3,88,929,70,10,96,identification,939,158,0.0
5,1,47,1,4,4,164,929,42,10,96,number,939,206,0.0
5,1,47,1,4,5,681,929,4,10,63,1,939,685,0.0
5,1,47,1,4,6,704,929,40,13,81,"Wages,",942,744,0.0
5,1,47,1,4,7,753,930,20,12,95,"tips,",942,773,0.0
5,1,47,1,4,8,783,929,28,10,95,other,939,811,0.0
5,1,47,1,4,9,816,930,79,12,95,compensation,942,895,0.0
5,1,47,1,4,10,970,929,7,10,18,2,939,977,0.0
5,1,47,1,4,11,995,929,41,10,66,Federal,939,1036,0.0
5,1,47,1,4,12,1042,932,40,7,94,income,939,1082,0.0
5,1,47,1,4,13,1087,930,18,9,96,tax,939,1105,0.0
5,1,47,1,4,14,1109,929,46,10,96,withheld,939,1155,0.0
4,1,47,1,5,0,66,954,1028,15,-1,,969,1094,0.0
5,1,47,1,5,1,66,954,136,15,91,39-3114215,969,202,0.0
5,1,47,1,5,2,725,954,123,15,91,126204.09,969,848,0.0
5,1,47,1,5,3,986,954,108,15,91,40043.57,969,1094,0.0
4,1,47,1,6,0,13,980,1139,13,-1,,993,1152,0.0
5,1,47,1,6,1,13,983,6,7,45,ยข,990,19,0.0
5,1,47,1,6,2,29,980,62,13,94,Employers,993,91,0.0
5,1,47,1,6,3,97,983,30,7,93,"name,",990,127,0.0
5,1,47,1,6,4,137,980,44,10,92,"address,",990,181,0.0
5,1,47,1,6,5,191,980,19,10,94,and,990,210,0.0
5,1,47,1,6,6,215,980,18,10,95,ZIP,990,233,0.0
5,1,47,1,6,7,239,980,26,10,96,code,990,265,0.0
5,1,47,1,6,8,681,980,6,10,67,3,990,687,0.0
5,1,47,1,6,9,705,980,34,10,88,Social,990,739,0.0
5,1,47,1,6,10,745,972,45,25,96,security,997,790,0.0
5,1,47,1,6,11,797,983,33,10,96,wages,993,830,0.0
5,1,47,1,6,12,970,980,7,10,41,4,990,977,0.0
5,1,47,1,6,13,995,980,34,10,79,Social,990,1029,0.0
5,1,47,1,6,14,1035,980,117,13,96,security,993,1152,0.0
5,1,47,1,6,15,1084,972,18,25,96,tax,997,1102,0.0
5,1,47,1,6,16,1107,980,45,13,96,withheld,993,1152,0.0
4,1,47,1,7,0,65,1005,1015,20,-1,,1025,1080,0.0
5,1,47,1,7,1,65,1005,97,15,96,Carlson,1020,162,0.0
5,1,47,1,7,2,177,1006,69,19,96,Group,1025,246,0.0
5,1,47,1,7,3,261,1006,68,19,96,Group,1025,329,0.0
5,1,47,1,7,4,725,1005,123,15,91,123655.86,1020,848,0.0
5,1,47,1,7,5,986,1005,94,15,93,9459.67,1020,1080,0.0
4,1,47,1,8,0,66,1031,1053,23,-1,,1054,1119,0.0
5,1,47,1,8,1,66,1039,67,15,96,56319,1054,133,0.0
5,1,47,1,8,2,148,1039,126,15,96,Underwood,1054,274,0.0
5,1,47,1,8,3,287,1039,70,15,96,Views,1054,357,0.0
5,1,47,1,8,4,681,1031,6,10,69,5,1041,687,0.0
5,1,47,1,8,5,705,1031,51,10,81,Medicare,1041,756,0.0
5,1,47,1,8,6,761,1034,36,10,96,wages,1044,797,0.0
5,1,47,1,8,7,803,1031,19,10,93,and,1041,822,0.0
5,1,47,1,8,8,827,1032,20,12,93,tips,1044,847,0.0
5,1,47,1,8,9,970,1031,6,10,64,6,1041,976,0.0
5,1,47,1,8,10,995,1031,51,10,71,Medicare,1041,1046,0.0
5,1,47,1,8,11,1051,1032,18,9,96,tax,1041,1069,0.0
5,1,47,1,8,12,1073,1031,46,10,95,withheld,1041,1119,0.0
4,1,47,1,9,0,725,1056,405,15,-1,,1071,1130,0.0
5,1,47,1,9,1,725,1056,123,15,91,152406.79,1071,848,0.0
5,1,47,1,9,2,1049,1056,81,15,93,4419.8,1071,1130,0.0
4,1,47,1,10,0,65,1073,1007,22,-1,,1095,1072,0.0
5,1,47,1,10,1,65,1073,54,15,92,Lake,1088,119,0.0
5,1,47,1,10,2,134,1073,140,15,92,Debramouth,1088,274,0.0
5,1,47,1,10,3,288,1074,27,14,96,NE,1088,315,0.0
5,1,47,1,10,4,332,1073,136,15,95,33667-9751,1088,468,0.0
5,1,47,1,10,5,681,1082,5,10,80,T,1092,686,0.0
5,1,47,1,10,6,705,1082,34,10,96,Social,1092,739,0.0
5,1,47,1,10,7,747,1070,41,29,95,security,1099,788,0.0
5,1,47,1,10,8,795,1083,19,12,96,tips,1095,814,0.0
5,1,47,1,10,9,971,1082,5,10,53,@,1092,976,0.0
5,1,47,1,10,10,994,1082,53,10,91,Allocated,1092,1047,0.0
5,1,47,1,10,11,1052,1083,20,12,65,tips,1095,1072,0.0
4,1,47,1,11,0,725,1107,446,15,-1,,1122,1171,0.0
5,1,47,1,11,1,725,1107,123,15,91,123655.86,1122,848,0.0
5,1,47,1,11,2,1050,1107,121,15,61,152406.79,1122,1171,0.0
4,1,47,1,12,0,11,1133,1122,13,-1,,1146,1133,0.0
5,1,47,1,12,1,11,1133,57,10,0,โControl,1143,68,0.0
5,1,47,1,12,2,74,1133,42,10,96,number,1143,116,0.0
5,1,47,1,12,3,680,1133,7,10,66,9,1143,687,0.0
5,1,47,1,12,4,704,1133,48,10,66,Advance,1143,752,0.0
5,1,47,1,12,5,758,1133,19,10,92,EIC,1143,777,0.0
5,1,47,1,12,6,783,1134,48,12,96,payment,1146,831,0.0
5,1,47,1,12,7,964,1133,13,10,76,40,1143,977,0.0
5,1,47,1,12,8,995,1133,60,13,71,Dependent,1146,1055,0.0
5,1,47,1,12,9,1061,1136,23,7,94,care,1143,1084,0.0
5,1,47,1,12,10,1090,1133,43,10,92,benefits,1143,1133,0.0
4,1,47,1,13,0,66,1158,1023,15,-1,,1173,1089,0.0
5,1,47,1,13,1,66,1158,94,15,95,9744017,1173,160,0.0
5,1,47,1,13,2,1049,1158,40,15,96,219,1173,1089,0.0
4,1,47,1,14,0,12,1184,1163,13,-1,,1197,1175,0.0
5,1,47,1,14,1,12,1187,6,7,34,@,1194,18,0.0
5,1,47,1,14,2,29,1184,65,13,74,Employee's,1197,94,0.0
5,1,47,1,14,3,99,1184,20,10,96,first,1194,119,0.0
5,1,47,1,14,4,125,1187,30,7,96,name,1194,155,0.0
5,1,47,1,14,5,161,1184,19,10,96,and,1194,180,0.0
5,1,47,1,14,6,186,1184,28,10,92,initial,1194,214,0.0
5,1,47,1,14,7,280,1184,23,10,96,Last,1194,303,0.0
5,1,47,1,14,8,309,1187,30,7,94,name,1194,339,0.0
5,1,47,1,14,9,674,1184,11,10,60,11,1194,685,0.0
5,1,47,1,14,10,705,1184,68,13,79,Nonqualified,1197,773,0.0
5,1,47,1,14,11,779,1184,29,13,76,plans,1197,808,0.0
5,1,47,1,14,12,966,1184,20,10,38,12a,1194,986,0.0
5,1,47,1,14,13,1009,1184,22,10,60,See,1194,1031,0.0
5,1,47,1,14,14,1037,1184,92,10,95,instructions,1194,1129,0.0
5,1,47,1,14,15,1112,1176,19,25,96,for,1201,1131,0.0
5,1,47,1,14,16,1134,1184,22,10,96,box,1194,1156,0.0
5,1,47,1,14,17,1162,1184,13,10,89,12,1194,1175,0.0
4,1,47,1,15,0,724,1215,379,15,-1,,1230,1103,0.0
5,1,47,1,15,1,724,1215,40,15,82,233,1230,764,0.0
5,1,47,1,15,2,1006,1216,13,14,89,P,1230,1019,0.0
5,1,47,1,15,3,1050,1215,53,15,17,{9966,1230,1103,0.0
4,1,47,1,16,0,65,1229,922,23,-1,,1252,987,0.0
5,1,47,1,16,1,65,1229,94,22,96,Taylor,1251,159,0.0
5,1,47,1,16,2,177,1230,46,16,96,Cox,1246,223,0.0
5,1,47,1,16,3,674,1241,13,10,55,13,1251,687,0.0
5,1,47,1,16,4,693,1242,43,10,41,Slatutory,1252,736,0.0
5,1,47,1,16,5,780,1242,50,8,9,___Relrement,1250,830,0.0
5,1,47,1,16,6,866,1242,23,8,0,Thre,1250,889,0.0
5,1,47,1,16,7,895,1230,28,30,0,pariy,1260,923,0.0
5,1,47,1,16,8,966,1241,21,10,51,1,1251,987,0.0
4,1,47,1,17,0,693,1257,213,10,-1,,1267,906,0.0
5,1,47,1,17,1,693,1257,44,10,59,empoyee,1267,737,0.0
5,1,47,1,17,2,780,1257,18,10,31,plan,1267,798,0.0
5,1,47,1,17,3,867,1257,18,8,95,sick,1265,885,0.0
5,1,47,1,17,4,889,1259,17,8,94,pay,1267,906,0.0
4,1,47,1,18,0,67,1269,1021,22,-1,,1291,1088,0.0
5,1,47,1,18,1,67,1269,43,17,96,613,1286,110,0.0
5,1,47,1,18,2,128,1270,79,21,96,Roger,1291,207,0.0
5,1,47,1,18,3,225,1270,78,16,96,Crest,1286,303,0.0
5,1,47,1,18,4,319,1270,59,21,96,Apt.,1291,378,0.0
5,1,47,1,18,5,402,1269,44,17,96,802,1286,446,0.0
5,1,47,1,18,6,786,1275,10,11,92,x,1286,796,0.0
5,1,47,1,18,7,1049,1271,39,15,96,284,1286,1088,0.0
4,1,47,1,19,0,674,1300,312,13,-1,,1313,986,0.0
5,1,47,1,19,1,674,1300,13,10,49,44,1310,687,0.0
5,1,47,1,19,2,705,1300,31,10,84,Other,1310,736,0.0
5,1,47,1,19,3,741,1301,23,12,85,(see,1313,764,0.0
5,1,47,1,19,4,770,1300,50,10,96,enclosed,1310,820,0.0
5,1,47,1,19,5,826,1300,35,10,96,Notice,1310,861,0.0
5,1,47,1,19,6,866,1301,10,9,96,to,1310,876,0.0
5,1,47,1,19,7,882,1300,61,13,96,Employee),1313,943,0.0
5,1,47,1,19,8,949,1292,9,25,49,|,1317,958,0.0
5,1,47,1,19,9,966,1300,20,10,49,12c,1310,986,0.0
4,1,47,1,20,0,65,1308,365,17,-1,,1325,430,0.0
5,1,47,1,20,1,65,1309,94,16,92,Leeton,1325,159,0.0
5,1,47,1,20,2,178,1309,31,16,96,IA,1325,209,0.0
5,1,47,1,20,3,273,1308,157,17,95,26442-8249,1325,430,0.0
4,1,47,1,21,0,1007,1331,81,15,-1,,1346,1088,0.0
5,1,47,1,21,1,1007,1332,12,14,91,P,1346,1019,0.0
5,1,47,1,21,2,1050,1331,38,15,18,(307,1346,1088,0.0
4,1,47,1,22,0,966,1357,20,10,-1,,1367,986,0.0
5,1,47,1,22,1,966,1357,20,10,88,12d,1367,986,0.0
4,1,47,1,23,0,1006,1388,82,15,-1,,1403,1088,0.0
5,1,47,1,23,1,1006,1389,13,14,81,H,1403,1019,0.0
5,1,47,1,23,2,1049,1388,39,15,81,|242,1403,1088,0.0
4,1,47,1,24,0,11,1418,213,13,-1,,1431,224,0.0
5,1,47,1,24,1,11,1418,5,10,69,f,1428,16,0.0
5,1,47,1,24,2,29,1418,65,13,69,Employee's,1431,94,0.0
5,1,47,1,24,3,100,1418,44,10,93,address,1428,144,0.0
5,1,47,1,24,4,150,1418,19,10,96,and,1428,169,0.0
5,1,47,1,24,5,174,1418,18,10,92,ZIP,1428,192,0.0
5,1,47,1,24,6,197,1418,27,10,92,code,1428,224,0.0
2,1,48,0,0,0,660,1236,576,3,-1,,1239,1236,0.0
3,1,48,1,0,0,660,1236,576,3,-1,,1239,1236,0.0
4,1,48,1,1,0,660,1236,576,3,-1,,1239,1236,0.0
5,1,48,1,1,1,660,1236,576,3,95, ,1239,1236,0.0
2,1,49,0,0,0,689,1267,204,1,-1,,1268,893,0.0
3,1,49,1,0,0,689,1267,204,1,-1,,1268,893,0.0
4,1,49,1,1,0,689,1267,204,1,-1,,1268,893,0.0
5,1,49,1,1,1,689,1267,204,1,95, ,1268,893,0.0
2,1,50,0,0,0,688,1267,3,28,-1,,1295,691,0.0
3,1,50,1,0,0,688,1267,3,28,-1,,1295,691,0.0
4,1,50,1,1,0,688,1267,3,28,-1,,1295,691,0.0
5,1,50,1,1,1,688,1267,3,28,95, ,1295,691,0.0
2,1,51,0,0,0,717,1267,3,28,-1,,1295,720,0.0
3,1,51,1,0,0,717,1267,3,28,-1,,1295,720,0.0
4,1,51,1,1,0,717,1267,3,28,-1,,1295,720,0.0
5,1,51,1,1,1,717,1267,3,28,95, ,1295,720,0.0
2,1,52,0,0,0,775,1267,3,28,-1,,1295,778,0.0
3,1,52,1,0,0,775,1267,3,28,-1,,1295,778,0.0
4,1,52,1,1,0,775,1267,3,28,-1,,1295,778,0.0
5,1,52,1,1,1,775,1267,3,28,95, ,1295,778,0.0
2,1,53,0,0,0,804,1267,3,28,-1,,1295,807,0.0
3,1,53,1,0,0,804,1267,3,28,-1,,1295,807,0.0
4,1,53,1,1,0,804,1267,3,28,-1,,1295,807,0.0
5,1,53,1,1,1,804,1267,3,28,95, ,1295,807,0.0
2,1,54,0,0,0,862,1267,3,28,-1,,1295,865,0.0
3,1,54,1,0,0,862,1267,3,28,-1,,1295,865,0.0
4,1,54,1,1,0,862,1267,3,28,-1,,1295,865,0.0
5,1,54,1,1,1,862,1267,3,28,95, ,1295,865,0.0
2,1,55,0,0,0,891,1267,3,28,-1,,1295,894,0.0
3,1,55,1,0,0,891,1267,3,28,-1,,1295,894,0.0
4,1,55,1,1,0,891,1267,3,28,-1,,1295,894,0.0
5,1,55,1,1,1,891,1267,3,28,95, ,1295,894,0.0
2,1,56,0,0,0,660,1293,576,5,-1,,1298,1236,0.0
3,1,56,1,0,0,660,1293,576,5,-1,,1298,1236,0.0
4,1,56,1,1,0,660,1293,576,5,-1,,1298,1236,0.0
5,1,56,1,1,1,660,1293,576,5,95, ,1298,1236,0.0
2,1,57,0,0,0,689,1293,547,5,-1,,1298,1236,0.0
3,1,57,1,0,0,689,1293,547,5,-1,,1298,1236,0.0
4,1,57,1,1,0,689,1293,547,5,-1,,1298,1236,0.0
5,1,57,1,1,1,689,1293,547,5,95, ,1298,1236,0.0
2,1,58,0,0,0,689,1293,547,5,-1,,1298,1236,0.0
3,1,58,1,0,0,689,1293,547,5,-1,,1298,1236,0.0
4,1,58,1,1,0,689,1293,547,5,-1,,1298,1236,0.0
5,1,58,1,1,1,689,1293,547,5,95, ,1298,1236,0.0
2,1,59,0,0,0,689,1293,547,5,-1,,1298,1236,0.0
3,1,59,1,0,0,689,1293,547,5,-1,,1298,1236,0.0
4,1,59,1,1,0,689,1293,547,5,-1,,1298,1236,0.0
5,1,59,1,1,1,689,1293,547,5,95, ,1298,1236,0.0
2,1,60,0,0,0,950,1352,286,3,-1,,1355,1236,0.0
3,1,60,1,0,0,950,1352,286,3,-1,,1355,1236,0.0
4,1,60,1,1,0,950,1352,286,3,-1,,1355,1236,0.0
5,1,60,1,1,1,950,1352,286,3,95, ,1355,1236,0.0
2,1,61,0,0,0,1042,1197,3,214,-1,,1411,1045,0.0
3,1,61,1,0,0,1042,1197,3,214,-1,,1411,1045,0.0
4,1,61,1,1,0,1042,1197,3,214,-1,,1411,1045,0.0
5,1,61,1,1,1,1042,1197,3,214,95, ,1411,1045,0.0
2,1,62,0,0,0,950,1409,286,3,-1,,1412,1236,0.0
3,1,62,1,0,0,950,1409,286,3,-1,,1412,1236,0.0
4,1,62,1,1,0,950,1409,286,3,-1,,1412,1236,0.0
5,1,62,1,1,1,950,1409,286,3,95, ,1412,1236,0.0
2,1,63,0,0,0,659,925,3,507,-1,,1432,662,0.0
3,1,63,1,0,0,659,925,3,507,-1,,1432,662,0.0
4,1,63,1,1,0,659,925,3,507,-1,,1432,662,0.0
5,1,63,1,1,1,659,925,3,507,95, ,1432,662,0.0
2,1,64,0,0,0,949,925,3,507,-1,,1432,952,0.0
3,1,64,1,0,0,949,925,3,507,-1,,1432,952,0.0
4,1,64,1,1,0,949,925,3,507,-1,,1432,952,0.0
5,1,64,1,1,1,949,925,3,507,95, ,1432,952,0.0
2,1,65,0,0,0,1,1429,1235,5,-1,,1434,1236,0.0
3,1,65,1,0,0,1,1429,1235,5,-1,,1434,1236,0.0
4,1,65,1,1,0,1,1429,1235,5,-1,,1434,1236,0.0
5,1,65,1,1,1,1,1429,1235,5,95, ,1434,1236,0.0
2,1,66,0,0,0,6,1435,489,13,-1,,1448,495,0.0
3,1,66,1,0,0,6,1435,489,13,-1,,1448,495,0.0
4,1,66,1,1,0,6,1435,489,13,-1,,1448,495,0.0
5,1,66,1,1,1,6,1435,13,10,88,15,1445,19,0.0
5,1,66,1,1,2,29,1435,29,10,58,State!,1445,58,0.0
5,1,66,1,1,3,88,1435,62,13,54,Employer's,1448,150,0.0
5,1,66,1,1,4,156,1436,27,9,86,state,1445,183,0.0
5,1,66,1,1,5,189,1435,10,10,86,ID,1445,199,0.0
5,1,66,1,1,6,205,1435,42,10,95,number,1445,247,0.0
5,1,66,1,1,7,349,1435,11,10,53,16,1445,360,0.0
5,1,66,1,1,8,370,1435,29,10,93,State,1445,399,0.0
5,1,66,1,1,9,404,1438,36,10,90,"wages,",1448,440,0.0
5,1,66,1,1,10,449,1436,20,12,90,"tips,",1448,469,0.0
5,1,66,1,1,11,479,1436,16,9,77,etc,1445,495,0.0
2,1,67,0,0,0,0,1456,1236,31,-1,,1487,1236,0.0
3,1,67,1,0,0,0,1456,1236,31,-1,,1487,1236,0.0
4,1,67,1,1,0,0,1456,1236,31,-1,,1487,1236,0.0
5,1,67,1,1,1,0,1456,1236,31,95, ,1487,1236,0.0
2,1,68,0,0,0,59,1431,1,104,-1,,1535,60,0.0
3,1,68,1,0,0,59,1431,1,104,-1,,1535,60,0.0
4,1,68,1,1,0,59,1431,1,104,-1,,1535,60,0.0
5,1,68,1,1,1,59,1431,1,104,95, ,1535,60,0.0
2,1,69,0,0,0,340,1431,1,104,-1,,1535,341,0.0
3,1,69,1,0,0,340,1431,1,104,-1,,1535,341,0.0
4,1,69,1,1,0,340,1431,1,104,-1,,1535,341,0.0
5,1,69,1,1,1,340,1431,1,104,95, ,1535,341,0.0
2,1,70,0,0,0,0,1530,341,9,-1,,1539,341,0.0
3,1,70,1,0,0,0,1530,341,9,-1,,1539,341,0.0
4,1,70,1,1,0,0,1530,341,9,-1,,1539,341,0.0
5,1,70,1,1,1,0,1530,341,9,95, ,1539,341,0.0
2,1,71,0,0,0,532,1431,1,104,-1,,1535,533,0.0
3,1,71,1,0,0,532,1431,1,104,-1,,1535,533,0.0
4,1,71,1,1,0,532,1431,1,104,-1,,1535,533,0.0
5,1,71,1,1,1,532,1431,1,104,95, ,1535,533,0.0
2,1,72,0,0,0,541,1435,332,13,-1,,1448,873,0.0
3,1,72,1,0,0,541,1435,332,13,-1,,1448,873,0.0
4,1,72,1,1,0,541,1435,332,13,-1,,1448,873,0.0
5,1,72,1,1,1,541,1435,12,10,59,TT,1445,553,0.0
5,1,72,1,1,2,562,1435,29,10,90,State,1445,591,0.0
5,1,72,1,1,3,597,1438,40,7,92,income,1445,637,0.0
5,1,72,1,1,4,642,1436,18,9,96,tax,1445,660,0.0
5,1,72,1,1,5,727,1435,11,10,69,78,1445,738,0.0
5,1,72,1,1,6,748,1435,29,10,94,Local,1445,777,0.0
5,1,72,1,1,7,782,1438,40,10,94,"wages,",1448,822,0.0
5,1,72,1,1,8,827,1436,20,12,94,"tips,",1448,847,0.0
5,1,72,1,1,9,857,1436,16,9,75,etc,1445,873,0.0
2,1,73,0,0,0,539,1512,308,15,-1,,1527,847,0.0
3,1,73,1,0,0,539,1512,308,15,-1,,1527,847,0.0
4,1,73,1,1,0,539,1512,308,15,-1,,1527,847,0.0
5,1,73,1,1,1,539,1512,95,15,96,6506.63,1527,634,0.0
5,1,73,1,1,2,725,1512,122,15,91,104567.25,1527,847,0.0
2,1,74,0,0,0,717,1267,3,268,-1,,1535,720,0.0
3,1,74,1,0,0,717,1267,3,268,-1,,1535,720,0.0
4,1,74,1,1,0,717,1267,3,268,-1,,1535,720,0.0
5,1,74,1,1,1,717,1267,3,268,95, ,1535,720,0.0
2,1,75,0,0,0,921,1431,1,104,-1,,1535,922,0.0
3,1,75,1,0,0,921,1431,1,104,-1,,1535,922,0.0
4,1,75,1,1,0,921,1431,1,104,-1,,1535,922,0.0
5,1,75,1,1,1,921,1431,1,104,95, ,1535,922,0.0
2,1,76,0,0,0,929,1435,120,10,-1,,1445,1049,0.0
3,1,76,1,0,0,929,1435,120,10,-1,,1445,1049,0.0
4,1,76,1,1,0,929,1435,120,10,-1,,1445,1049,0.0
5,1,76,1,1,1,929,1435,12,10,63,49,1445,941,0.0
5,1,76,1,1,2,951,1435,29,10,86,Local,1445,980,0.0
5,1,76,1,1,3,986,1438,40,7,96,income,1445,1026,0.0
5,1,76,1,1,4,1031,1436,18,9,95,tax,1445,1049,0.0
2,1,77,0,0,0,928,1512,108,15,-1,,1527,1036,0.0
3,1,77,1,0,0,928,1512,108,15,-1,,1527,1036,0.0
4,1,77,1,1,0,928,1512,108,15,-1,,1527,1036,0.0
5,1,77,1,1,1,928,1512,108,15,90,19328.85,1527,1036,0.0
2,1,78,0,0,0,1114,1435,102,13,-1,,1448,1216,0.0
3,1,78,1,0,0,1114,1435,102,13,-1,,1448,1216,0.0
4,1,78,1,1,0,1114,1435,102,13,-1,,1448,1216,0.0
5,1,78,1,1,1,1114,1435,13,10,85,20,1445,1127,0.0
5,1,78,1,1,2,1137,1435,44,13,89,Locality,1448,1181,0.0
5,1,78,1,1,3,1186,1438,30,7,96,name,1445,1216,0.0
2,1,79,0,0,0,1112,1514,119,13,-1,,1527,1231,0.0
3,1,79,1,0,0,1112,1514,119,13,-1,,1527,1231,0.0
4,1,79,1,1,0,1112,1514,119,13,-1,,1527,1231,0.0
5,1,79,1,1,1,1112,1515,59,12,96,Duane,1527,1171,0.0
5,1,79,1,1,2,1185,1514,46,13,96,Flat,1527,1231,0.0
2,1,80,0,0,0,1234,874,2,661,-1,,1535,1236,0.0
3,1,80,1,0,0,1234,874,2,661,-1,,1535,1236,0.0
4,1,80,1,1,0,1234,874,2,661,-1,,1535,1236,0.0
5,1,80,1,1,1,1234,874,2,661,95, ,1535,1236,0.0
2,1,81,0,0,0,1107,1431,1,104,-1,,1535,1108,0.0
3,1,81,1,0,0,1107,1431,1,104,-1,,1535,1108,0.0
4,1,81,1,1,0,1107,1431,1,104,-1,,1535,1108,0.0
5,1,81,1,1,1,1107,1431,1,104,95, ,1535,1108,0.0
2,1,82,0,0,0,338,1532,898,5,-1,,1537,1236,0.0
3,1,82,1,0,0,338,1532,898,5,-1,,1537,1236,0.0
4,1,82,1,1,0,338,1532,898,5,-1,,1537,1236,0.0
5,1,82,1,1,1,338,1532,898,5,95, ,1537,1236,0.0
2,1,83,0,0,0,4,1508,451,82,-1,,1590,455,0.0
3,1,83,1,0,0,4,1508,451,82,-1,,1590,455,0.0
4,1,83,1,1,0,12,1508,443,28,-1,,1536,455,0.0
5,1,83,1,1,1,12,1508,32,28,96,MN,1536,44,0.0
5,1,83,1,1,2,132,1512,136,15,91,940-46-434,1527,268,0.0
5,1,83,1,1,3,347,1512,108,15,92,66754.52,1527,455,0.0
4,1,83,1,2,0,139,1542,162,22,-1,,1564,301,0.0
5,1,83,1,2,1,139,1542,63,22,95,Wage,1564,202,0.0
5,1,83,1,2,2,211,1542,41,17,96,and,1559,252,0.0
5,1,83,1,2,3,261,1542,40,17,95,Tax,1559,301,0.0
4,1,83,1,3,0,4,1573,250,17,-1,,1590,254,0.0
5,1,83,1,3,1,4,1579,34,11,93,Form,1590,38,0.0
5,1,83,1,3,2,47,1579,25,11,89,W-2,1590,72,0.0
5,1,83,1,3,3,140,1573,114,17,96,Statement,1590,254,0.0
2,1,84,0,0,0,5,1602,291,37,-1,,1639,296,0.0
3,1,84,1,0,0,5,1602,291,37,-1,,1639,296,0.0
4,1,84,1,1,0,5,1602,291,15,-1,,1617,296,0.0
5,1,84,1,1,1,5,1602,40,15,93,Copy,1617,45,0.0
5,1,84,1,1,2,51,1602,10,12,91,C,1614,61,0.0
5,1,84,1,1,3,68,1602,26,12,96,For,1614,94,0.0
5,1,84,1,1,4,100,1602,103,12,86,EMPLOYEE'S,1614,203,0.0
5,1,84,1,1,5,210,1602,86,12,96,RECORDS.,1614,296,0.0
4,1,84,1,2,0,5,1624,276,15,-1,,1639,281,0.0
5,1,84,1,2,1,5,1624,33,15,95,(See,1639,38,0.0
5,1,84,1,2,2,44,1624,69,12,96,enclosed,1636,113,0.0
5,1,84,1,2,3,120,1624,49,12,96,Notice,1636,169,0.0
5,1,84,1,2,4,174,1624,16,12,96,to,1636,190,0.0
5,1,84,1,2,5,196,1624,85,15,95,Employee.),1639,281,0.0
2,1,85,0,0,0,549,1549,144,42,-1,,1591,693,0.0
3,1,85,1,0,0,549,1549,144,42,-1,,1591,693,0.0
4,1,85,1,1,0,549,1549,144,42,-1,,1591,693,0.0
5,1,85,1,1,1,549,1549,144,42,30,e010,1591,693,0.0
2,1,86,0,0,0,864,1547,367,15,-1,,1562,1231,0.0
3,1,86,1,0,0,864,1547,367,15,-1,,1562,1231,0.0
4,1,86,1,1,0,864,1547,367,15,-1,,1562,1231,0.0
5,1,86,1,1,1,864,1547,81,15,95,Department,1562,945,0.0
5,1,86,1,1,2,950,1547,12,12,95,of,1559,962,0.0
5,1,86,1,1,3,966,1547,20,12,93,the,1559,986,0.0
5,1,86,1,1,4,991,1547,118,15,64,Treasury-Internal,1562,1109,0.0
5,1,86,1,1,5,1115,1547,59,12,94,Revenue,1559,1174,0.0
5,1,86,1,1,6,1180,1547,51,12,96,Service,1559,1231,0.0
2,1,87,0,0,0,926,1575,256,36,-1,,1611,1182,0.0
3,1,87,1,0,0,926,1575,256,36,-1,,1611,1182,0.0
4,1,87,1,1,0,927,1575,109,15,-1,,1590,1036,0.0
5,1,87,1,1,1,927,1575,35,15,95,"Safe,",1590,962,0.0
5,1,87,1,1,2,967,1575,69,15,95,"accurate,",1590,1036,0.0
4,1,87,1,2,0,926,1578,256,33,-1,,1611,1182,0.0
5,1,87,1,2,1,926,1596,82,12,16,nto,1608,1008,0.0
5,1,87,1,2,2,1068,1573,12,45,29,@,1618,1080,0.0
5,1,87,1,2,3,1094,1573,12,45,58,>,1618,1106,0.0
5,1,87,1,2,4,1048,1578,134,33,80,file,1611,1182,0.0
5,1,87,1,2,5,1173,1573,12,45,46,),1618,1185,0.0
1,1,0,0,0,0,0,0,1236,1658,-1,,1658,1236,0.0
2,1,1,0,0,0,596,1,1,50,-1,,51,597,0.0
3,1,1,1,0,0,596,1,1,50,-1,,51,597,0.0
4,1,1,1,1,0,596,1,1,50,-1,,51,597,0.0
5,1,1,1,1,1,596,1,1,50,95, ,51,597,0.0
2,1,2,0,0,0,1,50,658,3,-1,,53,659,0.0
3,1,2,1,0,0,1,50,658,3,-1,,53,659,0.0
4,1,2,1,1,0,1,50,658,3,-1,,53,659,0.0
5,1,2,1,1,1,1,50,658,3,95, ,53,659,0.0
2,1,3,0,0,0,12,4,648,91,-1,,95,660,0.0
3,1,3,1,0,0,12,4,648,91,-1,,95,660,0.0
4,1,3,1,1,0,55,4,399,16,-1,,20,454,0.0
5,1,3,1,1,1,55,5,103,15,90,REISSUED,20,158,0.0
5,1,3,1,1,2,216,7,6,7,31,{a,14,222,0.0
5,1,3,1,1,3,236,4,71,13,69,Employee's,17,307,0.0
5,1,3,1,1,4,311,4,36,10,95,social,14,347,0.0
5,1,3,1,1,5,352,4,48,13,95,security,17,400,0.0
5,1,3,1,1,6,406,4,48,10,95,number,14,454,0.0
4,1,3,1,2,0,44,28,616,29,-1,,57,660,0.0
5,1,3,1,2,1,44,28,126,29,96,STATEMENT,57,170,0.0
5,1,3,1,2,2,312,28,150,15,86,675-52-6498,43,462,0.0
5,1,3,1,2,3,612,29,28,10,86,OMB,39,640,0.0
5,1,3,1,2,4,646,29,14,10,96,No.,39,660,0.0
4,1,3,1,3,0,12,56,194,13,-1,,69,206,0.0
5,1,3,1,3,1,12,56,7,10,81,b,66,19,0.0
5,1,3,1,3,2,29,56,54,13,48,Employer,69,83,0.0
5,1,3,1,3,3,88,56,70,10,96,identification,66,158,0.0
5,1,3,1,3,4,164,56,42,10,96,number,66,206,0.0
4,1,3,1,4,0,66,80,136,15,-1,,95,202,0.0
5,1,3,1,4,1,66,80,136,15,89,73-1267148,95,202,0.0
2,1,4,0,0,0,1,102,658,3,-1,,105,659,0.0
3,1,4,1,0,0,1,102,658,3,-1,,105,659,0.0
4,1,4,1,1,0,1,102,658,3,-1,,105,659,0.0
5,1,4,1,1,1,1,102,658,3,95, ,105,659,0.0
2,1,5,0,0,0,13,108,252,13,-1,,121,265,0.0
3,1,5,1,0,0,13,108,252,13,-1,,121,265,0.0
4,1,5,1,1,0,13,108,252,13,-1,,121,265,0.0
5,1,5,1,1,1,13,111,6,7,7,ยข,118,19,0.0
5,1,5,1,1,2,29,108,62,13,83,Employers,121,91,0.0
5,1,5,1,1,3,97,111,30,7,91,"name,",118,127,0.0
5,1,5,1,1,4,137,108,44,10,90,"address,",118,181,0.0
5,1,5,1,1,5,191,108,19,10,96,and,118,210,0.0
5,1,5,1,1,6,215,108,18,10,96,ZIP,118,233,0.0
5,1,5,1,1,7,239,108,26,10,96,code,118,265,0.0
2,1,6,0,0,0,64,133,446,88,-1,,221,510,0.0
3,1,6,1,0,0,64,133,446,88,-1,,221,510,0.0
4,1,6,1,1,0,64,133,223,15,-1,,148,287,0.0
5,1,6,1,1,1,64,133,111,15,96,Marshall,148,175,0.0
5,1,6,1,1,2,191,134,40,14,96,PLC,148,231,0.0
5,1,6,1,1,3,247,134,40,14,96,PLC,148,287,0.0
4,1,6,1,2,0,66,167,347,20,-1,,187,413,0.0
5,1,6,1,2,1,66,167,52,15,96,6822,182,118,0.0
5,1,6,1,2,2,135,168,69,19,96,Henry,187,204,0.0
5,1,6,1,2,3,218,167,56,15,96,Neck,182,274,0.0
5,1,6,1,2,4,290,167,67,15,96,Suite,182,357,0.0
5,1,6,1,2,5,374,167,39,15,96,843,182,413,0.0
4,1,6,1,3,0,65,201,445,20,-1,,221,510,0.0
5,1,6,1,3,1,65,201,54,15,92,Port,216,119,0.0
5,1,6,1,3,2,133,201,141,20,91,Angelastad,221,274,0.0
5,1,6,1,3,3,332,202,27,14,90,TA,216,359,0.0
5,1,6,1,3,4,374,201,136,15,95,13833-3941,216,510,0.0
2,1,7,0,0,0,782,3,111,14,-1,,17,893,0.0
3,1,7,1,0,0,782,3,111,14,-1,,17,893,0.0
4,1,7,1,1,0,782,3,111,14,-1,,17,893,0.0
5,1,7,1,1,1,782,3,35,14,96,"Safe,",17,817,0.0
5,1,7,1,1,2,822,3,71,14,96,"Accurate,",17,893,0.0
2,1,8,0,0,0,681,6,362,89,-1,,95,1043,0.0
3,1,8,1,0,0,681,6,362,89,-1,,95,1043,0.0
4,1,8,1,1,0,781,6,262,45,-1,,51,1043,0.0
5,1,8,1,1,1,781,28,44,12,95,FAST!,40,825,0.0
5,1,8,1,1,2,835,28,28,12,95,Use,40,863,0.0
5,1,8,1,1,3,900,6,120,45,0,e-file,51,1020,0.0
5,1,8,1,1,4,1031,6,12,45,0,),51,1043,0.0
4,1,8,1,2,0,681,56,214,13,-1,,69,895,0.0
5,1,8,1,2,1,681,56,4,10,70,1,66,685,0.0
5,1,8,1,2,2,704,56,40,13,79,"Wages,",69,744,0.0
5,1,8,1,2,3,753,57,24,12,95,"tips,",69,777,0.0
5,1,8,1,2,4,783,56,28,10,96,other,66,811,0.0
5,1,8,1,2,5,819,48,76,26,96,compensation,74,895,0.0
4,1,8,1,3,0,725,80,108,15,-1,,95,833,0.0
5,1,8,1,3,1,725,80,108,15,89,86286.94,95,833,0.0
2,1,9,0,0,0,1047,4,146,40,-1,,44,1193,0.0
3,1,9,1,0,0,1047,4,146,40,-1,,44,1193,0.0
4,1,9,1,1,0,1047,4,146,12,-1,,16,1193,0.0
5,1,9,1,1,1,1047,4,31,12,95,Visit,16,1078,0.0
5,1,9,1,1,2,1082,4,20,12,95,the,16,1102,0.0
5,1,9,1,1,3,1108,4,23,12,96,IRS,16,1131,0.0
5,1,9,1,1,4,1136,4,57,12,96,Website,16,1193,0.0
4,1,9,1,2,0,1048,29,132,15,-1,,44,1180,0.0
5,1,9,1,2,1,1048,30,12,11,93,at,41,1060,0.0
5,1,9,1,2,2,1064,29,116,15,34,www.irs.goviefile.,44,1180,0.0
2,1,10,0,0,0,970,56,185,10,-1,,66,1155,0.0
3,1,10,1,0,0,970,56,185,10,-1,,66,1155,0.0
4,1,10,1,1,0,970,56,185,10,-1,,66,1155,0.0
5,1,10,1,1,1,970,56,7,10,56,2,66,977,0.0
5,1,10,1,1,2,995,56,41,10,87,Federal,66,1036,0.0
5,1,10,1,1,3,1042,56,113,10,91,income,66,1155,0.0
5,1,10,1,1,4,1087,47,17,28,96,tax,75,1104,0.0
5,1,10,1,1,5,1110,56,45,10,95,withheld,66,1155,0.0
2,1,11,0,0,0,671,29,57,10,-1,,39,728,0.0
3,1,11,1,0,0,671,29,57,10,-1,,39,728,0.0
4,1,11,1,1,0,671,29,57,10,-1,,39,728,0.0
5,1,11,1,1,1,671,29,57,10,79,1645-0008,39,728,0.0
2,1,12,0,0,0,660,153,576,5,-1,,158,1236,0.0
3,1,12,1,0,0,660,153,576,5,-1,,158,1236,0.0
4,1,12,1,1,0,660,153,576,5,-1,,158,1236,0.0
5,1,12,1,1,1,660,153,576,5,95, ,158,1236,0.0
2,1,13,0,0,0,660,204,576,5,-1,,209,1236,0.0
3,1,13,1,0,0,660,204,576,5,-1,,209,1236,0.0
4,1,13,1,1,0,660,204,576,5,-1,,209,1236,0.0
5,1,13,1,1,1,660,204,576,5,95, ,209,1236,0.0
2,1,14,0,0,0,1,256,658,3,-1,,259,659,0.0
3,1,14,1,0,0,1,256,658,3,-1,,259,659,0.0
4,1,14,1,1,0,1,256,658,3,-1,,259,659,0.0
5,1,14,1,1,1,1,256,658,3,95, ,259,659,0.0
2,1,15,0,0,0,11,262,105,10,-1,,272,116,0.0
3,1,15,1,0,0,11,262,105,10,-1,,272,116,0.0
4,1,15,1,1,0,11,262,105,10,-1,,272,116,0.0
5,1,15,1,1,1,11,262,57,10,0,โControl,272,68,0.0
5,1,15,1,1,2,74,262,42,10,95,number,272,116,0.0
2,1,16,0,0,0,66,286,95,15,-1,,301,161,0.0
3,1,16,1,0,0,66,286,95,15,-1,,301,161,0.0
4,1,16,1,1,0,66,286,95,15,-1,,301,161,0.0
5,1,16,1,1,1,66,286,95,15,96,9176733,301,161,0.0
2,1,17,0,0,0,1,308,658,3,-1,,311,659,0.0
3,1,17,1,0,0,1,308,658,3,-1,,311,659,0.0
4,1,17,1,1,0,1,308,658,3,-1,,311,659,0.0
5,1,17,1,1,1,1,308,658,3,95, ,311,659,0.0
2,1,18,0,0,0,12,313,327,13,-1,,326,339,0.0
3,1,18,1,0,0,12,313,327,13,-1,,326,339,0.0
4,1,18,1,1,0,12,313,327,13,-1,,326,339,0.0
5,1,18,1,1,1,12,316,6,7,59,@,323,18,0.0
5,1,18,1,1,2,29,313,65,13,54,Employee's,326,94,0.0
5,1,18,1,1,3,99,313,20,10,79,frst,323,119,0.0
5,1,18,1,1,4,125,316,30,7,96,name,323,155,0.0
5,1,18,1,1,5,161,313,19,10,96,and,323,180,0.0
5,1,18,1,1,6,186,313,28,10,96,initial,323,214,0.0
5,1,18,1,1,7,280,313,23,10,90,Tast,323,303,0.0
5,1,18,1,1,8,309,316,30,7,91,name,323,339,0.0
2,1,19,0,0,0,65,359,269,54,-1,,413,334,0.0
3,1,19,1,0,0,65,359,269,54,-1,,413,334,0.0
4,1,19,1,1,0,65,359,174,16,-1,,375,239,0.0
5,1,19,1,1,1,65,359,78,16,96,Laura,375,143,0.0
5,1,19,1,1,2,160,359,79,16,96,Russo,375,239,0.0
4,1,19,1,2,0,65,396,269,17,-1,,413,334,0.0
5,1,19,1,2,1,65,396,61,17,96,2199,413,126,1.0
5,1,19,1,2,2,145,396,94,17,96,Little,413,239,1.0
5,1,19,1,2,3,257,396,77,17,95,Falls,413,334,1.0
2,1,20,0,0,0,66,435,238,22,-1,,457,304,0.0
3,1,20,1,0,0,66,435,238,22,-1,,457,304,0.0
4,1,20,1,1,0,66,435,238,22,-1,,457,304,0.0
5,1,20,1,1,1,66,435,141,22,91,Snyderton,457,207,1.0
5,1,20,1,1,2,273,436,31,16,89,TX,452,304,1.0
2,1,21,0,0,0,11,545,213,13,-1,,558,224,0.0
3,1,21,1,0,0,11,545,213,13,-1,,558,224,0.0
4,1,21,1,1,0,11,545,213,13,-1,,558,224,0.0
5,1,21,1,1,1,11,545,83,13,48,f_Employee's,558,94,0.0
5,1,21,1,1,2,100,545,44,10,91,address,555,144,0.0
5,1,21,1,1,3,150,545,19,10,95,and,555,169,0.0
5,1,21,1,1,4,174,545,18,10,96,ZIP,555,192,0.0
5,1,21,1,1,5,197,545,27,10,91,code,555,224,0.0
2,1,22,0,0,0,660,364,576,5,-1,,369,1236,0.0
3,1,22,1,0,0,660,364,576,5,-1,,369,1236,0.0
4,1,22,1,1,0,660,364,576,5,-1,,369,1236,0.0
5,1,22,1,1,1,660,364,576,5,95, ,369,1236,0.0
2,1,23,0,0,0,689,393,204,3,-1,,396,893,0.0
3,1,23,1,0,0,689,393,204,3,-1,,396,893,0.0
4,1,23,1,1,0,689,393,204,3,-1,,396,893,0.0
5,1,23,1,1,1,689,393,204,3,95, ,396,893,0.0
2,1,24,0,0,0,689,394,1,28,-1,,422,690,0.0
3,1,24,1,0,0,689,394,1,28,-1,,422,690,0.0
4,1,24,1,1,0,689,394,1,28,-1,,422,690,0.0
5,1,24,1,1,1,689,394,1,28,95, ,422,690,0.0
2,1,25,0,0,0,718,394,1,28,-1,,422,719,0.0
3,1,25,1,0,0,718,394,1,28,-1,,422,719,0.0
4,1,25,1,1,0,718,394,1,28,-1,,422,719,0.0
5,1,25,1,1,1,718,394,1,28,95, ,422,719,0.0
2,1,26,0,0,0,776,394,1,28,-1,,422,777,0.0
3,1,26,1,0,0,776,394,1,28,-1,,422,777,0.0
4,1,26,1,1,0,776,394,1,28,-1,,422,777,0.0
5,1,26,1,1,1,776,394,1,28,95, ,422,777,0.0
2,1,27,0,0,0,805,394,1,28,-1,,422,806,0.0
3,1,27,1,0,0,805,394,1,28,-1,,422,806,0.0
4,1,27,1,1,0,805,394,1,28,-1,,422,806,0.0
5,1,27,1,1,1,805,394,1,28,95, ,422,806,0.0
2,1,28,0,0,0,863,394,1,28,-1,,422,864,0.0
3,1,28,1,0,0,863,394,1,28,-1,,422,864,0.0
4,1,28,1,1,0,863,394,1,28,-1,,422,864,0.0
5,1,28,1,1,1,863,394,1,28,95, ,422,864,0.0
2,1,29,0,0,0,892,394,1,28,-1,,422,893,0.0
3,1,29,1,0,0,892,394,1,28,-1,,422,893,0.0
4,1,29,1,1,0,892,394,1,28,-1,,422,893,0.0
5,1,29,1,1,1,892,394,1,28,95, ,422,893,0.0
2,1,30,0,0,0,660,419,576,7,-1,,426,1236,0.0
3,1,30,1,0,0,660,419,576,7,-1,,426,1236,0.0
4,1,30,1,1,0,660,419,576,7,-1,,426,1236,0.0
5,1,30,1,1,1,660,419,576,7,95, ,426,1236,0.0
2,1,31,0,0,0,385,435,157,17,-1,,452,542,0.0
3,1,31,1,0,0,385,435,157,17,-1,,452,542,0.0
4,1,31,1,1,0,385,435,157,17,-1,,452,542,0.0
5,1,31,1,1,1,385,435,157,17,95,28420-7250,452,542,0.0
2,1,32,0,0,0,689,419,547,7,-1,,426,1236,0.0
3,1,32,1,0,0,689,419,547,7,-1,,426,1236,0.0
4,1,32,1,1,0,689,419,547,7,-1,,426,1236,0.0
5,1,32,1,1,1,689,419,547,7,95, ,426,1236,0.0
2,1,33,0,0,0,689,419,547,7,-1,,426,1236,0.0
3,1,33,1,0,0,689,419,547,7,-1,,426,1236,0.0
4,1,33,1,1,0,689,419,547,7,-1,,426,1236,0.0
5,1,33,1,1,1,689,419,547,7,95, ,426,1236,0.0
2,1,34,0,0,0,689,419,547,7,-1,,426,1236,0.0
3,1,34,1,0,0,689,419,547,7,-1,,426,1236,0.0
4,1,34,1,1,0,689,419,547,7,-1,,426,1236,0.0
5,1,34,1,1,1,689,419,547,7,95, ,426,1236,0.0
2,1,35,0,0,0,950,479,286,3,-1,,482,1236,0.0
3,1,35,1,0,0,950,479,286,3,-1,,482,1236,0.0
4,1,35,1,1,0,950,479,286,3,-1,,482,1236,0.0
5,1,35,1,1,1,950,479,286,3,95, ,482,1236,0.0
2,1,36,0,0,0,674,80,501,450,-1,,530,1175,0.0
3,1,36,1,0,0,674,80,501,450,-1,,530,1175,0.0
4,1,36,1,1,0,985,80,110,15,-1,,95,1095,0.0
5,1,36,1,1,1,985,80,110,15,91,23792.16,95,1095,0.0
4,1,36,1,2,0,681,108,471,13,-1,,121,1152,0.0
5,1,36,1,2,1,681,108,6,10,77,3,118,687,0.0
5,1,36,1,2,2,705,108,34,10,80,Social,118,739,0.0
5,1,36,1,2,3,745,109,45,12,96,security,121,790,0.0
5,1,36,1,2,4,794,111,36,10,80,wages,121,830,0.0
5,1,36,1,2,5,970,108,7,10,59,โ4,118,977,0.0
5,1,36,1,2,6,995,108,34,10,82,Social,118,1029,0.0
5,1,36,1,2,7,1036,109,44,12,82,security,121,1080,0.0
5,1,36,1,2,8,1084,109,18,9,96,tax,118,1102,0.0
5,1,36,1,2,9,1106,108,46,10,90,withheld,118,1152,0.0
4,1,36,1,3,0,725,133,355,15,-1,,148,1080,0.0
5,1,36,1,3,1,725,133,95,15,90,90335.6,148,820,0.0
5,1,36,1,3,2,986,133,94,15,96,6910.67,148,1080,0.0
4,1,36,1,4,0,681,159,438,13,-1,,172,1119,0.0
5,1,36,1,4,1,681,159,6,10,71,5,169,687,0.0
5,1,36,1,4,2,705,159,51,10,70,Medicare,169,756,0.0
5,1,36,1,4,3,761,162,36,10,96,wages,172,797,0.0
5,1,36,1,4,4,803,159,19,10,96,and,169,822,0.0
5,1,36,1,4,5,827,160,20,12,76,tips,172,847,0.0
5,1,36,1,4,6,970,159,6,10,60,ยฉ,169,976,0.0
5,1,36,1,4,7,995,159,51,10,81,Medicare,169,1046,0.0
5,1,36,1,4,8,1051,160,18,9,96,tax,169,1069,0.0
5,1,36,1,4,9,1073,159,46,10,87,withheld,169,1119,0.0
4,1,36,1,5,0,725,184,419,15,-1,,199,1144,0.0
5,1,36,1,5,1,725,184,108,15,87,67631.41,199,833,0.0
5,1,36,1,5,2,1050,184,94,15,96,1961.31,199,1144,0.0
4,1,36,1,6,0,681,210,391,13,-1,,223,1072,0.0
5,1,36,1,6,1,681,210,5,10,70,7,220,686,0.0
5,1,36,1,6,2,705,210,34,10,87,Social,220,739,0.0
5,1,36,1,6,3,747,201,41,29,93,security,230,788,0.0
5,1,36,1,6,4,793,211,21,12,96,tips,223,814,0.0
5,1,36,1,6,5,970,210,6,10,22,@,220,976,0.0
5,1,36,1,6,6,994,210,53,10,67,Allocated,220,1047,0.0
5,1,36,1,6,7,1052,211,20,12,96,tips,223,1072,0.0
4,1,36,1,7,0,725,235,433,15,-1,,250,1158,0.0
5,1,36,1,7,1,725,235,95,15,90,90335.6,250,820,0.0
5,1,36,1,7,2,1050,235,108,15,85,67631.41,250,1158,0.0
4,1,36,1,8,0,680,262,453,13,-1,,275,1133,0.0
5,1,36,1,8,1,680,262,7,10,45,โ9,272,687,0.0
5,1,36,1,8,2,704,262,48,10,78,Advance,272,752,0.0
5,1,36,1,8,3,758,262,19,10,91,EIC,272,777,0.0
5,1,36,1,8,4,783,263,48,12,96,payment,275,831,0.0
5,1,36,1,8,5,964,262,13,10,40,10,272,977,0.0
5,1,36,1,8,6,995,262,60,13,40,Dependent,275,1055,0.0
5,1,36,1,8,7,1061,265,23,7,96,care,272,1084,0.0
5,1,36,1,8,8,1090,262,43,10,91,benefits,272,1133,0.0
4,1,36,1,9,0,1049,286,39,15,-1,,301,1088,0.0
5,1,36,1,9,1,1049,286,39,15,96,267,301,1088,0.0
4,1,36,1,10,0,674,313,501,13,-1,,326,1175,0.0
5,1,36,1,10,1,674,313,11,10,0,TT,323,685,0.0
5,1,36,1,10,2,705,313,68,13,30,Nonqualifed,326,773,0.0
5,1,36,1,10,3,779,313,29,13,96,plans,326,808,0.0
5,1,36,1,10,4,966,313,20,10,21,โa,323,986,0.0
5,1,36,1,10,5,1009,313,22,10,78,See,323,1031,0.0
5,1,36,1,10,6,1037,313,71,10,96,instructions,323,1108,0.0
5,1,36,1,10,7,1112,313,17,10,96,for,323,1129,0.0
5,1,36,1,10,8,1134,313,22,10,96,box,323,1156,0.0
5,1,36,1,10,9,1162,313,13,10,96,12,323,1175,0.0
4,1,36,1,11,0,724,344,379,15,-1,,359,1103,0.0
5,1,36,1,11,1,724,344,40,15,96,259,359,764,0.0
5,1,36,1,11,2,1050,344,53,15,94,7236,359,1103,0.0
4,1,36,1,12,0,674,370,313,11,-1,,381,987,0.0
5,1,36,1,12,1,674,370,13,10,60,1B,380,687,0.0
5,1,36,1,12,2,693,371,43,10,86,Statutory,381,736,0.0
5,1,36,1,12,3,780,371,50,8,19,Retirement,379,830,0.0
5,1,36,1,12,4,866,371,53,10,52,Third-party,381,919,0.0
5,1,36,1,12,5,966,370,21,10,63,1b,380,987,0.0
4,1,36,1,13,0,693,385,213,9,-1,,394,906,0.0
5,1,36,1,13,1,693,385,45,9,9,emobovee,394,738,0.0
5,1,36,1,13,2,780,385,18,9,52,plan,394,798,0.0
5,1,36,1,13,3,867,385,39,9,72,sickpay,394,906,0.0
4,1,36,1,14,0,786,398,302,15,-1,,413,1088,0.0
5,1,36,1,14,1,786,402,10,11,95,x,413,796,0.0
5,1,36,1,14,2,1006,399,13,14,91,H,413,1019,0.0
5,1,36,1,14,3,1050,398,38,15,68,|138,413,1088,0.0
4,1,36,1,15,0,674,427,312,13,-1,,440,986,0.0
5,1,36,1,15,1,674,427,13,10,61,14,437,687,0.0
5,1,36,1,15,2,705,427,31,10,81,Other,437,736,0.0
5,1,36,1,15,3,741,427,23,13,82,(see,440,764,0.0
5,1,36,1,15,4,770,427,50,10,94,enclosed,437,820,0.0
5,1,36,1,15,5,826,427,35,10,95,Notice,437,861,0.0
5,1,36,1,15,6,866,428,10,9,91,to,437,876,0.0
5,1,36,1,15,7,882,427,61,13,91,Employee),440,943,0.0
5,1,36,1,15,8,950,418,8,29,34,|,447,958,0.0
5,1,36,1,15,9,966,427,20,10,34,12e,437,986,0.0
4,1,36,1,16,0,1050,458,39,15,-1,,473,1089,0.0
5,1,36,1,16,1,1050,458,39,15,96,323,473,1089,0.0
4,1,36,1,17,0,966,484,20,10,-1,,494,986,0.0
5,1,36,1,17,1,966,484,20,10,75,Td,494,986,0.0
4,1,36,1,18,0,1005,515,83,15,-1,,530,1088,0.0
5,1,36,1,18,1,1005,516,13,14,57,D,530,1018,0.0
5,1,36,1,18,2,1050,515,38,15,10,#{177,530,1088,0.0
2,1,37,0,0,0,1042,326,3,212,-1,,538,1045,0.0
3,1,37,1,0,0,1042,326,3,212,-1,,538,1045,0.0
4,1,37,1,1,0,1042,326,3,212,-1,,538,1045,0.0
5,1,37,1,1,1,1042,326,3,212,95, ,538,1045,0.0
2,1,38,0,0,0,950,536,286,3,-1,,539,1236,0.0
3,1,38,1,0,0,950,536,286,3,-1,,539,1236,0.0
4,1,38,1,1,0,950,536,286,3,-1,,539,1236,0.0
5,1,38,1,1,1,950,536,286,3,95, ,539,1236,0.0
2,1,39,0,0,0,659,105,3,454,-1,,559,662,0.0
3,1,39,1,0,0,659,105,3,454,-1,,559,662,0.0
4,1,39,1,1,0,659,105,3,454,-1,,559,662,0.0
5,1,39,1,1,1,659,105,3,454,95, ,559,662,0.0
2,1,40,0,0,0,949,105,3,454,-1,,559,952,0.0
3,1,40,1,0,0,949,105,3,454,-1,,559,952,0.0
4,1,40,1,1,0,949,105,3,454,-1,,559,952,0.0
5,1,40,1,1,1,949,105,3,454,95, ,559,952,0.0
2,1,41,0,0,0,1,555,1235,7,-1,,562,1236,0.0
3,1,41,1,0,0,1,555,1235,7,-1,,562,1236,0.0
4,1,41,1,1,0,1,555,1235,7,-1,,562,1236,0.0
5,1,41,1,1,1,1,555,1235,7,95, ,562,1236,0.0
2,1,42,0,0,0,6,562,263,40,-1,,602,269,0.0
3,1,42,1,0,0,6,562,263,40,-1,,602,269,0.0
4,1,42,1,1,0,6,562,241,13,-1,,575,247,0.0
5,1,42,1,1,1,6,562,13,10,90,15,572,19,0.0
5,1,42,1,1,2,29,562,29,10,62,State!,572,58,0.0
5,1,42,1,1,3,88,562,62,13,55,Employer's,575,150,0.0
5,1,42,1,1,4,156,563,27,9,85,state,572,183,0.0
5,1,42,1,1,5,189,562,10,10,85,ID,572,199,0.0
5,1,42,1,1,6,205,562,42,10,94,number,572,247,0.0
4,1,42,1,2,0,16,587,253,15,-1,,602,269,0.0
5,1,42,1,2,1,16,588,26,14,95,MI,602,42,0.0
5,1,42,1,2,2,132,587,137,15,88,352-10-416,602,269,0.0
2,1,43,0,0,0,349,562,146,13,-1,,575,495,0.0
3,1,43,1,0,0,349,562,146,13,-1,,575,495,0.0
4,1,43,1,1,0,349,562,146,13,-1,,575,495,0.0
5,1,43,1,1,1,349,562,12,10,60,16,572,361,0.0
5,1,43,1,1,2,370,562,29,10,91,State,572,399,0.0
5,1,43,1,1,3,404,565,36,10,85,"wages,",575,440,0.0
5,1,43,1,1,4,449,563,20,12,94,"tips,",575,469,0.0
5,1,43,1,1,5,479,563,16,9,78,etc,572,495,0.0
2,1,44,0,0,0,346,587,109,15,-1,,602,455,0.0
3,1,44,1,0,0,346,587,109,15,-1,,602,455,0.0
4,1,44,1,1,0,346,587,109,15,-1,,602,455,0.0
5,1,44,1,1,1,346,587,109,15,92,42876.97,602,455,0.0
2,1,45,0,0,0,3,608,1113,3,-1,,611,1116,0.0
3,1,45,1,0,0,3,608,1113,3,-1,,611,1116,0.0
4,1,45,1,1,0,3,608,1113,3,-1,,611,1116,0.0
5,1,45,1,1,1,3,608,1113,3,95, ,611,1116,0.0
2,1,46,0,0,0,59,558,1,103,-1,,661,60,0.0
3,1,46,1,0,0,59,558,1,103,-1,,661,60,0.0
4,1,46,1,1,0,59,558,1,103,-1,,661,60,0.0
5,1,46,1,1,1,59,558,1,103,95, ,661,60,0.0
2,1,47,0,0,0,340,558,1,103,-1,,661,341,0.0
3,1,47,1,0,0,340,558,1,103,-1,,661,341,0.0
4,1,47,1,1,0,340,558,1,103,-1,,661,341,0.0
5,1,47,1,1,1,340,558,1,103,95, ,661,341,0.0
2,1,48,0,0,0,532,558,1,103,-1,,661,533,0.0
3,1,48,1,0,0,532,558,1,103,-1,,661,533,0.0
4,1,48,1,1,0,532,558,1,103,-1,,661,533,0.0
5,1,48,1,1,1,532,558,1,103,95, ,661,533,0.0
2,1,49,0,0,0,541,562,119,10,-1,,572,660,0.0
3,1,49,1,0,0,541,562,119,10,-1,,572,660,0.0
4,1,49,1,1,0,541,562,119,10,-1,,572,660,0.0
5,1,49,1,1,1,541,562,11,10,65,TT,572,552,0.0
5,1,49,1,1,2,562,562,29,10,95,State,572,591,0.0
5,1,49,1,1,3,597,565,40,7,95,income,572,637,0.0
5,1,49,1,1,4,642,563,18,9,96,tax,572,660,0.0
2,1,50,0,0,0,539,587,94,15,-1,,602,633,0.0
3,1,50,1,0,0,539,587,94,15,-1,,602,633,0.0
4,1,50,1,1,0,539,587,94,15,-1,,602,633,0.0
5,1,50,1,1,1,539,587,94,15,95,5032.62,602,633,0.0
2,1,51,0,0,0,930,562,119,10,-1,,572,1049,0.0
3,1,51,1,0,0,930,562,119,10,-1,,572,1049,0.0
4,1,51,1,1,0,930,562,119,10,-1,,572,1049,0.0
5,1,51,1,1,1,930,562,11,10,75,19,572,941,0.0
5,1,51,1,1,2,951,562,29,10,86,Local,572,980,0.0
5,1,51,1,1,3,986,565,40,7,90,income,572,1026,0.0
5,1,51,1,1,4,1031,563,18,9,96,tax,572,1049,0.0
2,1,52,0,0,0,928,587,95,15,-1,,602,1023,0.0
3,1,52,1,0,0,928,587,95,15,-1,,602,1023,0.0
4,1,52,1,1,0,928,587,95,15,-1,,602,1023,0.0
5,1,52,1,1,1,928,587,95,15,95,8993.53,602,1023,0.0
2,1,53,0,0,0,726,562,490,13,-1,,575,1216,0.0
3,1,53,1,0,0,726,562,490,13,-1,,575,1216,0.0
4,1,53,1,1,0,726,562,490,13,-1,,575,1216,0.0
5,1,53,1,1,1,726,562,12,10,74,78,572,738,0.0
5,1,53,1,1,2,748,562,29,10,93,Local,572,777,0.0
5,1,53,1,1,3,782,565,36,10,76,wages.,575,818,0.0
5,1,53,1,1,4,827,563,20,12,94,"tips,",575,847,0.0
5,1,53,1,1,5,857,563,16,9,77,ete,572,873,0.0
5,1,53,1,1,6,1114,562,13,10,82,20,572,1127,0.0
5,1,53,1,1,7,1137,562,44,13,90,Locality,575,1181,0.0
5,1,53,1,1,8,1186,565,30,7,96,name,572,1216,0.0
2,1,54,0,0,0,725,587,108,15,-1,,602,833,0.0
3,1,54,1,0,0,725,587,108,15,-1,,602,833,0.0
4,1,54,1,1,0,725,587,108,15,-1,,602,833,0.0
5,1,54,1,1,1,725,587,108,15,90,82626.27,602,833,0.0
2,1,55,0,0,0,1116,594,112,8,-1,,602,1228,0.0
3,1,55,1,0,0,1116,594,112,8,-1,,602,1228,0.0
4,1,55,1,1,0,1116,594,112,8,-1,,602,1228,0.0
5,1,55,1,1,1,1116,594,63,8,95,Elizabeth,602,1179,0.0
5,1,55,1,1,2,1186,594,42,8,96,Garden,602,1228,0.0
2,1,56,0,0,0,1234,1,2,660,-1,,661,1236,0.0
3,1,56,1,0,0,1234,1,2,660,-1,,661,1236,0.0
4,1,56,1,1,0,1234,1,2,660,-1,,661,1236,0.0
5,1,56,1,1,1,1234,1,2,660,95, ,661,1236,0.0
2,1,57,0,0,0,717,394,3,267,-1,,661,720,0.0
3,1,57,1,0,0,717,394,3,267,-1,,661,720,0.0
4,1,57,1,1,0,717,394,3,267,-1,,661,720,0.0
5,1,57,1,1,1,717,394,3,267,95, ,661,720,0.0
2,1,58,0,0,0,921,558,1,103,-1,,661,922,0.0
3,1,58,1,0,0,921,558,1,103,-1,,661,922,0.0
4,1,58,1,1,0,921,558,1,103,-1,,661,922,0.0
5,1,58,1,1,1,921,558,1,103,95, ,661,922,0.0
2,1,59,0,0,0,1107,558,1,103,-1,,661,1108,0.0
3,1,59,1,0,0,1107,558,1,103,-1,,661,1108,0.0
4,1,59,1,1,0,1107,558,1,103,-1,,661,1108,0.0
5,1,59,1,1,1,1107,558,1,103,95, ,661,1108,0.0
2,1,60,0,0,0,1,657,1235,7,-1,,664,1236,0.0
3,1,60,1,0,0,1,657,1235,7,-1,,664,1236,0.0
4,1,60,1,1,0,1,657,1235,7,-1,,664,1236,0.0
5,1,60,1,1,1,1,657,1235,7,95, ,664,1236,0.0
2,1,61,0,0,0,4,634,1227,94,-1,,728,1231,0.0
3,1,61,1,0,0,4,634,1227,86,-1,,720,1231,0.0
4,1,61,1,1,0,12,634,1217,28,-1,,662,1229,0.0
5,1,61,1,1,1,12,634,31,28,96,MT,662,43,0.0
5,1,61,1,1,2,131,638,138,15,89,408-57-949,653,269,0.0
5,1,61,1,1,3,347,638,109,15,90,40122.56,653,456,0.0
5,1,61,1,1,4,539,638,95,15,95,5354.06,653,634,0.0
5,1,61,1,1,5,725,638,108,15,87,85363.24,653,833,0.0
5,1,61,1,1,6,928,638,94,15,89,16517.4,653,1022,0.0
5,1,61,1,1,7,1112,645,55,11,95,Morgan,656,1167,0.0
5,1,61,1,1,8,1176,645,53,11,95,Bypass,656,1229,0.0
4,1,61,1,2,0,139,670,1092,22,-1,,692,1231,0.0
5,1,61,1,2,1,139,670,63,22,96,Wage,692,202,0.0
5,1,61,1,2,2,211,670,41,17,96,and,687,252,0.0
5,1,61,1,2,3,261,670,40,17,96,Tax,687,301,0.0
5,1,61,1,2,4,864,675,81,15,96,Department,690,945,0.0
5,1,61,1,2,5,950,675,12,12,96,of,687,962,0.0
5,1,61,1,2,6,966,675,20,12,93,the,687,986,0.0
5,1,61,1,2,7,991,675,118,15,35,TreasuryโInternal,690,1109,0.0
5,1,61,1,2,8,1115,675,59,12,96,Revenue,687,1174,0.0
5,1,61,1,2,9,1180,675,51,12,97,Service,687,1231,0.0
4,1,61,1,3,0,4,677,689,51,-1,,728,693,0.0
5,1,61,1,3,1,4,709,34,11,93,Form,720,38,0.0
5,1,61,1,3,2,47,709,25,11,91,W-2,720,72,0.0
5,1,61,1,3,3,140,697,114,31,96,Statement,728,254,0.0
5,1,61,1,3,4,549,677,27,42,21,c,719,576,0.0
5,1,61,1,3,5,588,677,27,42,50,0,719,615,0.0
5,1,61,1,3,6,628,677,26,42,59,1,719,654,0.0
5,1,61,1,3,7,666,677,27,42,52,0,719,693,0.0
2,1,62,0,0,0,4,732,482,37,-1,,769,486,0.0
3,1,62,1,0,0,4,732,482,37,-1,,769,486,0.0
4,1,62,1,1,0,5,732,462,15,-1,,747,467,0.0
5,1,62,1,1,1,5,732,40,15,93,Copy,747,45,0.0
5,1,62,1,1,2,51,732,43,12,91,B--To,744,94,0.0
5,1,62,1,1,3,100,732,20,12,96,Be,744,120,0.0
5,1,62,1,1,4,126,732,35,12,95,Filed,744,161,0.0
5,1,62,1,1,5,167,732,32,12,96,with,744,199,0.0
5,1,62,1,1,6,206,732,87,15,85,Employee's,747,293,0.0
5,1,62,1,1,7,300,732,76,12,96,FEDERAL,744,376,0.0
5,1,62,1,1,8,382,732,27,12,95,Tax,744,409,0.0
5,1,62,1,1,9,415,732,52,12,96,Return,744,467,0.0
4,1,62,1,2,0,4,754,482,15,-1,,769,486,0.0
5,1,62,1,2,1,4,754,29,12,96,This,766,33,0.0
5,1,62,1,2,2,40,754,79,12,93,information,766,119,0.0
5,1,62,1,2,3,126,757,10,9,93,is,766,136,0.0
5,1,62,1,2,4,143,754,38,15,94,being,769,181,0.0
5,1,62,1,2,5,187,754,67,12,96,furnished,766,254,0.0
5,1,62,1,2,6,260,754,12,12,96,to,766,272,0.0
5,1,62,1,2,7,278,754,22,12,96,the,766,300,0.0
5,1,62,1,2,8,307,754,52,12,93,Internal,766,359,0.0
5,1,62,1,2,9,365,754,62,12,95,Revenue,766,427,0.0
5,1,62,1,2,10,433,754,53,12,96,Service,766,486,0.0
2,1,63,0,0,0,469,825,294,14,-1,,839,763,0.0
3,1,63,1,0,0,469,825,294,14,-1,,839,763,0.0
4,1,63,1,1,0,469,825,294,14,-1,,839,763,0.0
5,1,63,1,1,1,469,825,55,11,51,Tuthere.,836,524,0.0
5,1,63,1,1,2,537,825,32,14,92,Keep,839,569,0.0
5,1,63,1,1,3,575,825,34,11,94,lower,836,609,0.0
5,1,63,1,1,4,614,826,42,13,96,portion,839,656,0.0
5,1,63,1,1,5,661,825,17,11,72,for,836,678,0.0
5,1,63,1,1,6,682,828,28,11,94,your,839,710,0.0
5,1,63,1,1,7,715,825,48,11,67,records,836,763,0.0
2,1,64,0,0,0,1,871,1235,7,-1,,878,1236,0.0
3,1,64,1,0,0,1,871,1235,7,-1,,878,1236,0.0
4,1,64,1,1,0,1,871,1235,7,-1,,878,1236,0.0
5,1,64,1,1,1,1,871,1235,7,95, ,878,1236,0.0
2,1,65,0,0,0,211,874,3,52,-1,,926,214,0.0
3,1,65,1,0,0,211,874,3,52,-1,,926,214,0.0
4,1,65,1,1,0,211,874,3,52,-1,,926,214,0.0
5,1,65,1,1,1,211,874,3,52,95, ,926,214,0.0
2,1,66,0,0,0,595,874,3,52,-1,,926,598,0.0
3,1,66,1,0,0,595,874,3,52,-1,,926,598,0.0
4,1,66,1,1,0,595,874,3,52,-1,,926,598,0.0
5,1,66,1,1,1,595,874,3,52,95, ,926,598,0.0
2,1,67,0,0,0,1,922,1235,7,-1,,929,1236,0.0
3,1,67,1,0,0,1,922,1235,7,-1,,929,1236,0.0
4,1,67,1,1,0,1,922,1235,7,-1,,929,1236,0.0
5,1,67,1,1,1,1,922,1235,7,95, ,929,1236,0.0
2,1,68,0,0,0,1,973,1235,7,-1,,980,1236,0.0
3,1,68,1,0,0,1,973,1235,7,-1,,980,1236,0.0
4,1,68,1,1,0,1,973,1235,7,-1,,980,1236,0.0
5,1,68,1,1,1,1,973,1235,7,95, ,980,1236,0.0
2,1,69,0,0,0,660,1025,576,5,-1,,1030,1236,0.0
3,1,69,1,0,0,660,1025,576,5,-1,,1030,1236,0.0
4,1,69,1,1,0,660,1025,576,5,-1,,1030,1236,0.0
5,1,69,1,1,1,660,1025,576,5,95, ,1030,1236,0.0
2,1,70,0,0,0,660,1076,576,5,-1,,1081,1236,0.0
3,1,70,1,0,0,660,1076,576,5,-1,,1081,1236,0.0
4,1,70,1,1,0,660,1076,576,5,-1,,1081,1236,0.0
5,1,70,1,1,1,660,1076,576,5,95, ,1081,1236,0.0
2,1,71,0,0,0,1,1126,1235,7,-1,,1133,1236,0.0
3,1,71,1,0,0,1,1126,1235,7,-1,,1133,1236,0.0
4,1,71,1,1,0,1,1126,1235,7,-1,,1133,1236,0.0
5,1,71,1,1,1,1,1126,1235,7,95, ,1133,1236,0.0
2,1,72,0,0,0,1,1177,1235,7,-1,,1184,1236,0.0
3,1,72,1,0,0,1,1177,1235,7,-1,,1184,1236,0.0
4,1,72,1,1,0,1,1177,1235,7,-1,,1184,1236,0.0
5,1,72,1,1,1,1,1177,1235,7,95, ,1184,1236,0.0
2,1,73,0,0,0,11,878,1217,553,-1,,1431,1228,0.0
3,1,73,1,0,0,11,878,1217,553,-1,,1431,1228,0.0
4,1,73,1,1,0,55,878,1137,16,-1,,894,1192,0.0
5,1,73,1,1,1,55,879,103,15,91,REISSUED,894,158,0.0
5,1,73,1,1,2,216,881,6,7,64,[a,888,222,0.0
5,1,73,1,1,3,236,878,71,13,32,Employee's,891,307,0.0
5,1,73,1,1,4,311,878,36,10,92,social,888,347,0.0
5,1,73,1,1,5,352,878,48,13,92,security,891,400,0.0
5,1,73,1,1,6,406,878,48,10,96,number,888,454,0.0
5,1,73,1,1,7,750,878,23,10,95,This,888,773,0.0
5,1,73,1,1,8,779,878,61,10,96,information,888,840,0.0
5,1,73,1,1,9,846,881,8,7,90,is,888,854,0.0
5,1,73,1,1,10,860,878,29,13,90,being,891,889,0.0
5,1,73,1,1,11,894,878,51,10,93,furnished,888,945,0.0
5,1,73,1,1,12,950,879,10,9,96,to,888,960,0.0
5,1,73,1,1,13,965,878,17,10,96,the,888,982,0.0
5,1,73,1,1,14,988,878,40,10,84,Internal,888,1028,0.0
5,1,73,1,1,15,1034,878,47,10,93,Revenue,888,1081,0.0
5,1,73,1,1,16,1087,878,40,10,74,Senice.,888,1127,0.0
5,1,73,1,1,17,1141,878,6,10,77,If,888,1147,0.0
5,1,73,1,1,18,1150,881,20,10,77,you,891,1170,0.0
5,1,73,1,1,19,1176,881,16,7,94,are,888,1192,0.0
4,1,73,1,2,0,751,895,477,13,-1,,908,1228,0.0
5,1,73,1,2,1,751,895,44,13,95,required,908,795,0.0
5,1,73,1,2,2,800,887,8,26,96,to,913,808,0.0
5,1,73,1,2,3,805,895,25,10,96,file,905,830,0.0
5,1,73,1,2,4,836,898,5,7,78,a,905,841,0.0
5,1,73,1,2,5,846,896,18,9,78,tax,905,864,0.0
5,1,73,1,2,6,869,896,35,10,65,"return,",906,904,0.0
5,1,73,1,2,7,910,898,5,7,95,a,905,915,0.0
5,1,73,1,2,8,921,895,60,13,96,negligence,908,981,0.0
5,1,73,1,2,9,987,895,41,13,96,penalty,908,1028,0.0
5,1,73,1,2,10,1033,898,10,7,95,or,905,1043,0.0
5,1,73,1,2,11,1048,895,28,10,96,other,905,1076,0.0
5,1,73,1,2,12,1081,896,47,9,96,sanction,905,1128,0.0
5,1,73,1,2,13,1134,898,24,10,97,may,908,1158,0.0
5,1,73,1,2,14,1163,895,12,10,96,be,905,1175,0.0
5,1,73,1,2,15,1181,895,47,13,88,imposed,908,1228,0.0
4,1,73,1,3,0,44,903,1018,22,-1,,925,1062,0.0
5,1,73,1,3,1,44,906,126,15,96,STATEMENT,921,170,0.0
5,1,73,1,3,2,312,903,150,15,78,675-52-6498,918,462,0.0
5,1,73,1,3,3,612,903,28,10,96,OMB,913,640,0.0
5,1,73,1,3,4,646,903,14,10,79,No.,913,660,0.0
5,1,73,1,3,5,671,903,57,10,80,1645-0008,913,728,0.0
5,1,73,1,3,6,751,915,12,7,50,on,922,763,0.0
5,1,73,1,3,7,776,915,12,7,38,you,922,788,0.0
5,1,73,1,3,8,794,912,6,10,38,if,922,800,0.0
5,1,73,1,3,9,803,912,20,10,79,this,922,823,0.0
5,1,73,1,3,10,829,915,40,7,55,income,922,869,0.0
5,1,73,1,3,11,875,915,8,7,92,is,922,883,0.0
5,1,73,1,3,12,888,912,41,10,92,taxable,922,929,0.0
5,1,73,1,3,13,935,912,19,10,96,and,922,954,0.0
5,1,73,1,3,14,967,915,12,7,75,you,922,979,0.0
5,1,73,1,3,15,984,912,15,10,75,fail,922,999,0.0
5,1,73,1,3,16,1004,913,10,9,86,to,922,1014,0.0
5,1,73,1,3,17,1020,913,31,12,52,report,925,1051,0.0
5,1,73,1,3,18,1057,913,5,9,52,it,922,1062,0.0
4,1,73,1,4,0,12,929,1143,13,-1,,942,1155,0.0
5,1,73,1,4,1,12,929,7,10,89,b,939,19,0.0
5,1,73,1,4,2,29,929,54,13,95,Employer,942,83,0.0
5,1,73,1,4,3,88,929,70,10,94,identification,939,158,0.0
5,1,73,1,4,4,164,929,42,10,96,number,939,206,0.0
5,1,73,1,4,5,681,929,4,10,64,1,939,685,0.0
5,1,73,1,4,6,704,929,40,13,84,"Wages,",942,744,0.0
5,1,73,1,4,7,753,930,20,12,93,"tips,",942,773,0.0
5,1,73,1,4,8,783,929,28,10,95,other,939,811,0.0
5,1,73,1,4,9,816,930,79,12,92,compensation,942,895,0.0
5,1,73,1,4,10,970,929,7,10,0,2~,939,977,0.0
5,1,73,1,4,11,995,929,41,10,89,Federal,939,1036,0.0
5,1,73,1,4,12,1042,932,40,7,91,income,939,1082,0.0
5,1,73,1,4,13,1087,930,16,9,96,tax,939,1103,0.0
5,1,73,1,4,14,1109,929,46,10,96,withheld,939,1155,0.0
4,1,73,1,5,0,66,954,1029,15,-1,,969,1095,0.0
5,1,73,1,5,1,66,954,136,15,88,73-1267148,969,202,0.0
5,1,73,1,5,2,725,954,108,15,90,86286.94,969,833,0.0
5,1,73,1,5,3,985,954,110,15,83,23792.16,969,1095,0.0
4,1,73,1,6,0,13,980,1139,13,-1,,993,1152,0.0
5,1,73,1,6,1,13,983,6,7,80,c,990,19,0.0
5,1,73,1,6,2,29,980,62,13,86,Employer's,993,91,0.0
5,1,73,1,6,3,97,983,30,7,86,"name,",990,127,0.0
5,1,73,1,6,4,137,980,44,10,93,"address,",990,181,0.0
5,1,73,1,6,5,191,980,19,10,95,and,990,210,0.0
5,1,73,1,6,6,215,980,18,10,96,ZIP,990,233,0.0
5,1,73,1,6,7,239,980,26,10,96,code,990,265,0.0
5,1,73,1,6,8,681,980,6,10,55,3,990,687,0.0
5,1,73,1,6,9,705,980,34,10,92,Social,990,739,0.0
5,1,73,1,6,10,745,981,45,12,94,security,993,790,0.0
5,1,73,1,6,11,794,983,36,10,94,wages,993,830,0.0
5,1,73,1,6,12,970,980,7,10,45,4,990,977,0.0
5,1,73,1,6,13,995,980,34,10,80,Social,990,1029,0.0
5,1,73,1,6,14,1035,981,67,12,96,security,993,1102,0.0
5,1,73,1,6,15,1085,976,16,21,95,tax,997,1101,0.0
5,1,73,1,6,16,1106,980,46,10,95,withheld,990,1152,0.0
4,1,73,1,7,0,64,1005,1016,15,-1,,1020,1080,0.0
5,1,73,1,7,1,64,1005,111,15,95,Marshall,1020,175,0.0
5,1,73,1,7,2,191,1006,40,14,96,PLC,1020,231,0.0
5,1,73,1,7,3,247,1006,40,14,95,PLC,1020,287,0.0
5,1,73,1,7,4,725,1005,95,15,89,90335.6,1020,820,0.0
5,1,73,1,7,5,986,1005,94,15,94,6910.67,1020,1080,0.0
4,1,73,1,8,0,66,1031,1053,28,-1,,1059,1119,0.0
5,1,73,1,8,1,66,1039,52,15,96,6822,1054,118,0.0
5,1,73,1,8,2,135,1040,69,19,96,Henry,1059,204,0.0
5,1,73,1,8,3,218,1039,56,15,96,Neck,1054,274,0.0
5,1,73,1,8,4,290,1039,67,15,96,Suite,1054,357,0.0
5,1,73,1,8,5,374,1039,39,15,96,843,1054,413,0.0
5,1,73,1,8,6,681,1031,6,10,70,5,1041,687,0.0
5,1,73,1,8,7,705,1031,51,10,79,Medicare,1041,756,0.0
5,1,73,1,8,8,761,1034,36,10,96,wages,1044,797,0.0
5,1,73,1,8,9,803,1031,19,10,92,and,1041,822,0.0
5,1,73,1,8,10,827,1032,20,12,92,tips,1044,847,0.0
5,1,73,1,8,11,970,1031,6,10,58,6,1041,976,0.0
5,1,73,1,8,12,995,1031,51,10,67,Medicare,1041,1046,0.0
5,1,73,1,8,13,1051,1032,18,9,96,tax,1041,1069,0.0
5,1,73,1,8,14,1074,1031,45,10,92,withheld,1041,1119,0.0
4,1,73,1,9,0,725,1056,419,15,-1,,1071,1144,0.0
5,1,73,1,9,1,725,1056,108,15,89,67631.41,1071,833,0.0
5,1,73,1,9,2,1050,1056,94,15,0,1961.31,1071,1144,0.0
4,1,73,1,10,0,65,1073,1007,22,-1,,1095,1072,0.0
5,1,73,1,10,1,65,1073,54,15,93,Port,1088,119,0.0
5,1,73,1,10,2,133,1073,141,20,91,Angelastad,1093,274,0.0
5,1,73,1,10,3,332,1074,27,14,73,TA,1088,359,0.0
5,1,73,1,10,4,374,1073,136,15,94,13833-3941,1088,510,0.0
5,1,73,1,10,5,681,1082,5,10,68,7,1092,686,0.0
5,1,73,1,10,6,705,1082,34,10,87,Social,1092,739,0.0
5,1,73,1,10,7,746,1070,42,32,86,security,1102,788,0.0
5,1,73,1,10,8,794,1083,20,12,88,tips,1095,814,0.0
5,1,73,1,10,9,971,1082,5,10,52,8,1092,976,0.0
5,1,73,1,10,10,994,1082,53,10,83,Allocated,1092,1047,0.0
5,1,73,1,10,11,1052,1083,20,12,91,tips,1095,1072,0.0
4,1,73,1,11,0,725,1107,433,15,-1,,1122,1158,0.0
5,1,73,1,11,1,725,1107,95,15,90,90335.6,1122,820,0.0
5,1,73,1,11,2,1050,1107,108,15,90,67631.41,1122,1158,0.0
4,1,73,1,12,0,11,1133,1122,13,-1,,1146,1133,0.0
5,1,73,1,12,1,11,1133,57,10,0,โControl,1143,68,0.0
5,1,73,1,12,2,74,1133,42,10,96,number,1143,116,0.0
5,1,73,1,12,3,680,1133,7,10,66,9,1143,687,0.0
5,1,73,1,12,4,704,1133,48,10,66,Advance,1143,752,0.0
5,1,73,1,12,5,758,1133,19,10,92,EIC,1143,777,0.0
5,1,73,1,12,6,783,1134,48,12,96,payment,1146,831,0.0
5,1,73,1,12,7,964,1133,13,10,79,40,1143,977,0.0
5,1,73,1,12,8,995,1133,60,13,73,Dependent,1146,1055,0.0
5,1,73,1,12,9,1061,1136,23,7,96,care,1143,1084,0.0
5,1,73,1,12,10,1090,1133,43,10,91,benefits,1143,1133,0.0
4,1,73,1,13,0,66,1158,1022,15,-1,,1173,1088,0.0
5,1,73,1,13,1,66,1158,95,15,96,9176733,1173,161,0.0
5,1,73,1,13,2,1049,1158,39,15,96,267,1173,1088,0.0
4,1,73,1,14,0,12,1184,1163,13,-1,,1197,1175,0.0
5,1,73,1,14,1,29,1184,65,13,73,Employee's,1197,94,0.0
5,1,73,1,14,2,99,1184,20,10,95,first,1194,119,0.0
5,1,73,1,14,3,125,1187,30,7,95,name,1194,155,0.0
5,1,73,1,14,4,161,1184,19,10,96,and,1194,180,0.0
5,1,73,1,14,5,186,1184,28,10,95,initial,1194,214,0.0
5,1,73,1,14,6,280,1184,23,10,96,Last,1194,303,0.0
5,1,73,1,14,7,309,1187,30,7,94,name,1194,339,0.0
5,1,73,1,14,8,674,1184,11,10,60,11,1194,685,0.0
5,1,73,1,14,9,705,1184,68,13,79,Nonqualified,1197,773,0.0
5,1,73,1,14,10,779,1184,29,13,76,plans,1197,808,0.0
5,1,73,1,14,11,966,1184,20,10,33,12a,1194,986,0.0
5,1,73,1,14,12,1009,1184,22,10,63,See,1194,1031,0.0
5,1,73,1,14,13,1037,1184,71,10,92,instructions,1194,1108,0.0
5,1,73,1,14,14,1112,1184,17,10,96,for,1194,1129,0.0
5,1,73,1,14,15,1134,1184,22,10,96,box,1194,1156,0.0
5,1,73,1,14,16,1162,1184,13,10,90,12,1194,1175,0.0
4,1,73,1,15,0,724,1215,379,15,-1,,1230,1103,0.0
5,1,73,1,15,1,724,1215,40,15,96,259,1230,764,0.0
5,1,73,1,15,2,1050,1215,53,15,93,7236,1230,1103,0.0
4,1,73,1,16,0,65,1230,922,28,-1,,1258,987,0.0
5,1,73,1,16,1,65,1230,78,16,95,Laura,1246,143,0.0
5,1,73,1,16,2,160,1230,79,16,95,Russo,1246,239,0.0
5,1,73,1,16,3,674,1241,13,10,87,13,1251,687,0.0
5,1,73,1,16,4,693,1242,43,10,75,Statutory,1252,736,0.0
5,1,73,1,16,5,776,1237,53,21,61,Retirement,1258,829,0.0
5,1,73,1,16,6,866,1237,58,21,48,Third-party.,1258,924,0.0
5,1,73,1,16,7,966,1241,21,10,80,12b,1251,987,0.0
4,1,73,1,17,0,693,1257,213,10,-1,,1267,906,0.0
5,1,73,1,17,1,693,1257,44,10,23,employee,1267,737,0.0
5,1,73,1,17,2,780,1257,18,10,51,plan,1267,798,0.0
5,1,73,1,17,3,867,1257,18,8,95,sick,1265,885,0.0
5,1,73,1,17,4,889,1259,17,8,94,pay,1267,906,0.0
4,1,73,1,18,0,65,1269,1023,17,-1,,1286,1088,0.0
5,1,73,1,18,1,65,1269,61,17,96,2199,1286,126,0.0
5,1,73,1,18,2,145,1269,94,17,96,Little,1286,239,0.0
5,1,73,1,18,3,257,1269,77,17,95,Falls,1286,334,0.0
5,1,73,1,18,4,786,1275,10,11,93,x,1286,796,0.0
5,1,73,1,18,5,1006,1272,13,14,86,H,1286,1019,0.0
5,1,73,1,18,6,1050,1271,38,15,86,/138,1286,1088,0.0
4,1,73,1,19,0,674,1300,312,13,-1,,1313,986,0.0
5,1,73,1,19,1,674,1300,13,10,49,44,1310,687,0.0
5,1,73,1,19,2,705,1300,31,10,84,Other,1310,736,0.0
5,1,73,1,19,3,741,1301,23,12,85,(see,1313,764,0.0
5,1,73,1,19,4,770,1300,50,10,96,enclosed,1310,820,0.0
5,1,73,1,19,5,826,1300,35,10,96,Notice,1310,861,0.0
5,1,73,1,19,6,866,1301,10,9,96,to,1310,876,0.0
5,1,73,1,19,7,882,1300,61,13,96,Employee),1313,943,0.0
5,1,73,1,19,8,949,1292,9,25,49,|,1317,958,0.0
5,1,73,1,19,9,966,1300,20,10,49,12c,1310,986,0.0
4,1,73,1,20,0,66,1308,476,22,-1,,1330,542,0.0
5,1,73,1,20,1,66,1308,141,22,91,Snyderton,1330,207,0.0
5,1,73,1,20,2,273,1309,31,16,79,TX,1325,304,0.0
5,1,73,1,20,3,385,1308,157,17,95,28420-7250,1325,542,0.0
4,1,73,1,21,0,1050,1331,39,15,-1,,1346,1089,0.0
5,1,73,1,21,1,1050,1331,39,15,96,323,1346,1089,0.0
4,1,73,1,22,0,966,1357,20,10,-1,,1367,986,0.0
5,1,73,1,22,1,966,1357,20,10,87,12d,1367,986,0.0
4,1,73,1,23,0,1005,1388,83,15,-1,,1403,1088,0.0
5,1,73,1,23,1,1005,1389,13,14,77,D,1403,1018,0.0
5,1,73,1,23,2,1050,1388,38,15,71,(177,1403,1088,0.0
4,1,73,1,24,0,11,1418,213,13,-1,,1431,224,0.0
5,1,73,1,24,1,11,1418,5,10,92,f,1428,16,0.0
5,1,73,1,24,2,29,1418,65,13,52,Employee's,1431,94,0.0
5,1,73,1,24,3,100,1418,44,10,96,address,1428,144,0.0
5,1,73,1,24,4,150,1418,19,10,96,and,1428,169,0.0
5,1,73,1,24,5,174,1418,18,10,96,ZIP,1428,192,0.0
5,1,73,1,24,6,197,1418,27,10,96,code,1428,224,0.0
2,1,74,0,0,0,660,1235,576,5,-1,,1240,1236,0.0
3,1,74,1,0,0,660,1235,576,5,-1,,1240,1236,0.0
4,1,74,1,1,0,660,1235,576,5,-1,,1240,1236,0.0
5,1,74,1,1,1,660,1235,576,5,95, ,1240,1236,0.0
2,1,75,0,0,0,689,1266,204,3,-1,,1269,893,0.0
3,1,75,1,0,0,689,1266,204,3,-1,,1269,893,0.0
4,1,75,1,1,0,689,1266,204,3,-1,,1269,893,0.0
5,1,75,1,1,1,689,1266,204,3,95, ,1269,893,0.0
2,1,76,0,0,0,689,1267,1,28,-1,,1295,690,0.0
3,1,76,1,0,0,689,1267,1,28,-1,,1295,690,0.0
4,1,76,1,1,0,689,1267,1,28,-1,,1295,690,0.0
5,1,76,1,1,1,689,1267,1,28,95, ,1295,690,0.0
2,1,77,0,0,0,718,1267,1,28,-1,,1295,719,0.0
3,1,77,1,0,0,718,1267,1,28,-1,,1295,719,0.0
4,1,77,1,1,0,718,1267,1,28,-1,,1295,719,0.0
5,1,77,1,1,1,718,1267,1,28,95, ,1295,719,0.0
2,1,78,0,0,0,776,1267,1,28,-1,,1295,777,0.0
3,1,78,1,0,0,776,1267,1,28,-1,,1295,777,0.0
4,1,78,1,1,0,776,1267,1,28,-1,,1295,777,0.0
5,1,78,1,1,1,776,1267,1,28,95, ,1295,777,0.0
2,1,79,0,0,0,805,1267,1,28,-1,,1295,806,0.0
3,1,79,1,0,0,805,1267,1,28,-1,,1295,806,0.0
4,1,79,1,1,0,805,1267,1,28,-1,,1295,806,0.0
5,1,79,1,1,1,805,1267,1,28,95, ,1295,806,0.0
2,1,80,0,0,0,863,1267,1,28,-1,,1295,864,0.0
3,1,80,1,0,0,863,1267,1,28,-1,,1295,864,0.0
4,1,80,1,1,0,863,1267,1,28,-1,,1295,864,0.0
5,1,80,1,1,1,863,1267,1,28,95, ,1295,864,0.0
2,1,81,0,0,0,892,1267,1,28,-1,,1295,893,0.0
3,1,81,1,0,0,892,1267,1,28,-1,,1295,893,0.0
4,1,81,1,1,0,892,1267,1,28,-1,,1295,893,0.0
5,1,81,1,1,1,892,1267,1,28,95, ,1295,893,0.0
2,1,82,0,0,0,660,1292,576,7,-1,,1299,1236,0.0
3,1,82,1,0,0,660,1292,576,7,-1,,1299,1236,0.0
4,1,82,1,1,0,660,1292,576,7,-1,,1299,1236,0.0
5,1,82,1,1,1,660,1292,576,7,95, ,1299,1236,0.0
2,1,83,0,0,0,659,925,3,507,-1,,1432,662,0.0
3,1,83,1,0,0,659,925,3,507,-1,,1432,662,0.0
4,1,83,1,1,0,659,925,3,507,-1,,1432,662,0.0
5,1,83,1,1,1,659,925,3,507,95, ,1432,662,0.0
2,1,84,0,0,0,689,1292,547,7,-1,,1299,1236,0.0
3,1,84,1,0,0,689,1292,547,7,-1,,1299,1236,0.0
4,1,84,1,1,0,689,1292,547,7,-1,,1299,1236,0.0
5,1,84,1,1,1,689,1292,547,7,95, ,1299,1236,0.0
2,1,85,0,0,0,689,1292,547,7,-1,,1299,1236,0.0
3,1,85,1,0,0,689,1292,547,7,-1,,1299,1236,0.0
4,1,85,1,1,0,689,1292,547,7,-1,,1299,1236,0.0
5,1,85,1,1,1,689,1292,547,7,95, ,1299,1236,0.0
2,1,86,0,0,0,689,1292,547,7,-1,,1299,1236,0.0
3,1,86,1,0,0,689,1292,547,7,-1,,1299,1236,0.0
4,1,86,1,1,0,689,1292,547,7,-1,,1299,1236,0.0
5,1,86,1,1,1,689,1292,547,7,95, ,1299,1236,0.0
2,1,87,0,0,0,950,1352,286,3,-1,,1355,1236,0.0
3,1,87,1,0,0,950,1352,286,3,-1,,1355,1236,0.0
4,1,87,1,1,0,950,1352,286,3,-1,,1355,1236,0.0
5,1,87,1,1,1,950,1352,286,3,95, ,1355,1236,0.0
2,1,88,0,0,0,1042,1197,3,214,-1,,1411,1045,0.0
3,1,88,1,0,0,1042,1197,3,214,-1,,1411,1045,0.0
4,1,88,1,1,0,1042,1197,3,214,-1,,1411,1045,0.0
5,1,88,1,1,1,1042,1197,3,214,95, ,1411,1045,0.0
2,1,89,0,0,0,949,1409,287,3,-1,,1412,1236,0.0
3,1,89,1,0,0,949,1409,287,3,-1,,1412,1236,0.0
4,1,89,1,1,0,949,1409,287,3,-1,,1412,1236,0.0
5,1,89,1,1,1,949,1409,287,3,95, ,1412,1236,0.0
2,1,90,0,0,0,949,925,3,507,-1,,1432,952,0.0
3,1,90,1,0,0,949,925,3,507,-1,,1432,952,0.0
4,1,90,1,1,0,949,925,3,507,-1,,1432,952,0.0
5,1,90,1,1,1,949,925,3,507,95, ,1432,952,0.0
2,1,91,0,0,0,1,1428,1235,7,-1,,1435,1236,0.0
3,1,91,1,0,0,1,1428,1235,7,-1,,1435,1236,0.0
4,1,91,1,1,0,1,1428,1235,7,-1,,1435,1236,0.0
5,1,91,1,1,1,1,1428,1235,7,95, ,1435,1236,0.0
2,1,92,0,0,0,6,1435,489,13,-1,,1448,495,0.0
3,1,92,1,0,0,6,1435,489,13,-1,,1448,495,0.0
4,1,92,1,1,0,6,1435,489,13,-1,,1448,495,0.0
5,1,92,1,1,1,6,1435,13,10,88,15,1445,19,0.0
5,1,92,1,1,2,29,1435,29,10,58,State!,1445,58,0.0
5,1,92,1,1,3,88,1435,62,13,54,Employer's,1448,150,0.0
5,1,92,1,1,4,156,1436,27,9,86,state,1445,183,0.0
5,1,92,1,1,5,189,1435,10,10,86,ID,1445,199,0.0
5,1,92,1,1,6,205,1435,42,10,95,number,1445,247,0.0
5,1,92,1,1,7,349,1435,11,10,53,16,1445,360,0.0
5,1,92,1,1,8,370,1435,29,10,93,State,1445,399,0.0
5,1,92,1,1,9,404,1438,36,10,90,"wages,",1448,440,0.0
5,1,92,1,1,10,449,1436,20,12,90,"tips,",1448,469,0.0
5,1,92,1,1,11,479,1436,16,9,77,etc,1445,495,0.0
2,1,93,0,0,0,0,1456,1236,31,-1,,1487,1236,0.0
3,1,93,1,0,0,0,1456,1236,31,-1,,1487,1236,0.0
4,1,93,1,1,0,0,1456,1236,31,-1,,1487,1236,0.0
5,1,93,1,1,1,0,1456,1236,31,95, ,1487,1236,0.0
2,1,94,0,0,0,59,1431,1,104,-1,,1535,60,0.0
3,1,94,1,0,0,59,1431,1,104,-1,,1535,60,0.0
4,1,94,1,1,0,59,1431,1,104,-1,,1535,60,0.0
5,1,94,1,1,1,59,1431,1,104,95, ,1535,60,0.0
2,1,95,0,0,0,340,1431,1,104,-1,,1535,341,0.0
3,1,95,1,0,0,340,1431,1,104,-1,,1535,341,0.0
4,1,95,1,1,0,340,1431,1,104,-1,,1535,341,0.0
5,1,95,1,1,1,340,1431,1,104,95, ,1535,341,0.0
2,1,96,0,0,0,0,1530,341,9,-1,,1539,341,0.0
3,1,96,1,0,0,0,1530,341,9,-1,,1539,341,0.0
4,1,96,1,1,0,0,1530,341,9,-1,,1539,341,0.0
5,1,96,1,1,1,0,1530,341,9,95, ,1539,341,0.0
2,1,97,0,0,0,532,1431,1,104,-1,,1535,533,0.0
3,1,97,1,0,0,532,1431,1,104,-1,,1535,533,0.0
4,1,97,1,1,0,532,1431,1,104,-1,,1535,533,0.0
5,1,97,1,1,1,532,1431,1,104,95, ,1535,533,0.0
2,1,98,0,0,0,541,1435,119,10,-1,,1445,660,0.0
3,1,98,1,0,0,541,1435,119,10,-1,,1445,660,0.0
4,1,98,1,1,0,541,1435,119,10,-1,,1445,660,0.0
5,1,98,1,1,1,541,1435,12,10,63,17,1445,553,0.0
5,1,98,1,1,2,562,1435,29,10,94,State,1445,591,0.0
5,1,98,1,1,3,597,1438,40,7,95,income,1445,637,0.0
5,1,98,1,1,4,642,1436,18,9,96,tax,1445,660,0.0
2,1,99,0,0,0,539,1512,95,15,-1,,1527,634,0.0
3,1,99,1,0,0,539,1512,95,15,-1,,1527,634,0.0
4,1,99,1,1,0,539,1512,95,15,-1,,1527,634,0.0
5,1,99,1,1,1,539,1512,95,15,96,5354.06,1527,634,0.0
2,1,100,0,0,0,929,1435,120,10,-1,,1445,1049,0.0
3,1,100,1,0,0,929,1435,120,10,-1,,1445,1049,0.0
4,1,100,1,1,0,929,1435,120,10,-1,,1445,1049,0.0
5,1,100,1,1,1,929,1435,12,10,63,49,1445,941,0.0
5,1,100,1,1,2,951,1435,29,10,86,Local,1445,980,0.0
5,1,100,1,1,3,986,1438,40,7,96,income,1445,1026,0.0
5,1,100,1,1,4,1031,1436,18,9,95,tax,1445,1049,0.0
2,1,101,0,0,0,727,1435,146,13,-1,,1448,873,0.0
3,1,101,1,0,0,727,1435,146,13,-1,,1448,873,0.0
4,1,101,1,1,0,727,1435,146,13,-1,,1448,873,0.0
5,1,101,1,1,1,727,1435,11,10,69,78,1445,738,0.0
5,1,101,1,1,2,748,1435,29,10,94,Local,1445,777,0.0
5,1,101,1,1,3,782,1438,40,10,94,"wages,",1448,822,0.0
5,1,101,1,1,4,827,1436,20,12,94,"tips,",1448,847,0.0
5,1,101,1,1,5,857,1436,16,9,75,etc,1445,873,0.0
2,1,102,0,0,0,1114,1435,102,13,-1,,1448,1216,0.0
3,1,102,1,0,0,1114,1435,102,13,-1,,1448,1216,0.0
4,1,102,1,1,0,1114,1435,102,13,-1,,1448,1216,0.0
5,1,102,1,1,1,1114,1435,13,10,85,20,1445,1127,0.0
5,1,102,1,1,2,1137,1435,44,13,89,Locality,1448,1181,0.0
5,1,102,1,1,3,1186,1438,30,7,96,name,1445,1216,0.0
2,1,103,0,0,0,725,1512,297,15,-1,,1527,1022,0.0
3,1,103,1,0,0,725,1512,297,15,-1,,1527,1022,0.0
4,1,103,1,1,0,725,1512,297,15,-1,,1527,1022,0.0
5,1,103,1,1,1,725,1512,108,15,86,85363.24,1527,833,0.0
5,1,103,1,1,2,928,1512,94,15,88,16517.4,1527,1022,0.0
2,1,104,0,0,0,1113,1519,116,11,-1,,1530,1229,0.0
3,1,104,1,0,0,1113,1519,116,11,-1,,1530,1229,0.0
4,1,104,1,1,0,1113,1519,116,11,-1,,1530,1229,0.0
5,1,104,1,1,1,1113,1519,54,11,96,Morgan,1530,1167,0.0
5,1,104,1,1,2,1176,1519,53,11,92,Bypass,1530,1229,0.0
2,1,105,0,0,0,1233,874,3,661,-1,,1535,1236,0.0
3,1,105,1,0,0,1233,874,3,661,-1,,1535,1236,0.0
4,1,105,1,1,0,1233,874,3,661,-1,,1535,1236,0.0
5,1,105,1,1,1,1233,874,3,661,95, ,1535,1236,0.0
2,1,106,0,0,0,717,1267,3,268,-1,,1535,720,0.0
3,1,106,1,0,0,717,1267,3,268,-1,,1535,720,0.0
4,1,106,1,1,0,717,1267,3,268,-1,,1535,720,0.0
5,1,106,1,1,1,717,1267,3,268,95, ,1535,720,0.0
2,1,107,0,0,0,921,1431,1,104,-1,,1535,922,0.0
3,1,107,1,0,0,921,1431,1,104,-1,,1535,922,0.0
4,1,107,1,1,0,921,1431,1,104,-1,,1535,922,0.0
5,1,107,1,1,1,921,1431,1,104,95, ,1535,922,0.0
2,1,108,0,0,0,1107,1431,1,104,-1,,1535,1108,0.0
3,1,108,1,0,0,1107,1431,1,104,-1,,1535,1108,0.0
4,1,108,1,1,0,1107,1431,1,104,-1,,1535,1108,0.0
5,1,108,1,1,1,1107,1431,1,104,95, ,1535,1108,0.0
2,1,109,0,0,0,338,1532,898,5,-1,,1537,1236,0.0
3,1,109,1,0,0,338,1532,898,5,-1,,1537,1236,0.0
4,1,109,1,1,0,338,1532,898,5,-1,,1537,1236,0.0
5,1,109,1,1,1,338,1532,898,5,95, ,1537,1236,0.0
2,1,110,0,0,0,4,1508,452,82,-1,,1590,456,0.0
3,1,110,1,0,0,4,1508,452,82,-1,,1590,456,0.0
4,1,110,1,1,0,12,1508,444,28,-1,,1536,456,0.0
5,1,110,1,1,1,12,1508,31,28,96,MT,1536,43,0.0
5,1,110,1,1,2,131,1512,138,15,90,408-57-949,1527,269,0.0
5,1,110,1,1,3,347,1512,109,15,91,40122.56,1527,456,0.0
4,1,110,1,2,0,139,1542,162,22,-1,,1564,301,0.0
5,1,110,1,2,1,139,1542,63,22,95,Wage,1564,202,0.0
5,1,110,1,2,2,211,1542,41,17,96,and,1559,252,0.0
5,1,110,1,2,3,261,1542,40,17,95,Tax,1559,301,0.0
4,1,110,1,3,0,4,1573,250,17,-1,,1590,254,0.0
5,1,110,1,3,1,4,1579,34,11,93,Form,1590,38,0.0
5,1,110,1,3,2,47,1579,25,11,89,W-2,1590,72,0.0
5,1,110,1,3,3,140,1573,114,17,96,Statement,1590,254,0.0
2,1,111,0,0,0,5,1602,291,37,-1,,1639,296,0.0
3,1,111,1,0,0,5,1602,291,37,-1,,1639,296,0.0
4,1,111,1,1,0,5,1602,291,15,-1,,1617,296,0.0
5,1,111,1,1,1,5,1602,40,15,93,Copy,1617,45,0.0
5,1,111,1,1,2,51,1602,10,12,91,C,1614,61,0.0
5,1,111,1,1,3,68,1602,26,12,96,For,1614,94,0.0
5,1,111,1,1,4,100,1602,103,12,86,EMPLOYEE'S,1614,203,0.0
5,1,111,1,1,5,210,1602,86,12,96,RECORDS.,1614,296,0.0
4,1,111,1,2,0,5,1624,276,15,-1,,1639,281,0.0
5,1,111,1,2,1,5,1624,33,15,95,(See,1639,38,0.0
5,1,111,1,2,2,44,1624,69,12,96,enclosed,1636,113,0.0
5,1,111,1,2,3,120,1624,49,12,96,Notice,1636,169,0.0
5,1,111,1,2,4,174,1624,16,12,96,to,1636,190,0.0
5,1,111,1,2,5,196,1624,85,15,95,Employee.),1639,281,0.0
2,1,112,0,0,0,549,1549,105,42,-1,,1591,654,0.0
3,1,112,1,0,0,549,1549,105,42,-1,,1591,654,0.0
4,1,112,1,1,0,549,1549,105,42,-1,,1591,654,0.0
5,1,112,1,1,1,549,1549,105,42,74,cOl,1591,654,0.0
2,1,113,0,0,0,864,1547,367,15,-1,,1562,1231,0.0
3,1,113,1,0,0,864,1547,367,15,-1,,1562,1231,0.0
4,1,113,1,1,0,864,1547,367,15,-1,,1562,1231,0.0
5,1,113,1,1,1,864,1547,81,15,95,Department,1562,945,0.0
5,1,113,1,1,2,950,1547,12,12,95,of,1559,962,0.0
5,1,113,1,1,3,966,1547,20,12,93,the,1559,986,0.0
5,1,113,1,1,4,991,1547,118,15,64,Treasury-Internal,1562,1109,0.0
5,1,113,1,1,5,1115,1547,59,12,94,Revenue,1559,1174,0.0
5,1,113,1,1,6,1180,1547,51,12,96,Service,1559,1231,0.0
2,1,114,0,0,0,666,1549,519,76,-1,,1625,1185,0.0
3,1,114,1,0,0,666,1549,519,76,-1,,1625,1185,0.0
4,1,114,1,1,0,666,1549,519,76,-1,,1625,1185,0.0
5,1,114,1,1,1,666,1549,27,42,64,0,1591,693,0.0
5,1,114,1,1,2,1044,1574,141,51,0,<2zT>,1625,1185,0.0
2,1,115,0,0,0,926,1575,110,33,-1,,1608,1036,0.0
3,1,115,1,0,0,926,1575,110,33,-1,,1608,1036,0.0
4,1,115,1,1,0,927,1575,109,15,-1,,1590,1036,0.0
5,1,115,1,1,1,927,1575,35,15,92,"Safe,",1590,962,0.0
5,1,115,1,1,2,967,1575,69,15,92,"accurate,",1590,1036,0.0
4,1,115,1,2,0,926,1596,82,12,-1,,1608,1008,0.0
5,1,115,1,2,1,926,1596,44,12,94,FAST!,1608,970,0.0
5,1,115,1,2,2,980,1596,28,12,94,Use,1608,1008,0.0
1,1,0,0,0,0,0,0,1236,1658,-1,,1658,1236,0.0
2,1,1,0,0,0,55,5,103,15,-1,,20,158,0.0
3,1,1,1,0,0,55,5,103,15,-1,,20,158,0.0
4,1,1,1,1,0,55,5,103,15,-1,,20,158,0.0
5,1,1,1,1,1,55,5,103,15,92,REISSUED,20,158,0.0
2,1,2,0,0,0,216,4,238,13,-1,,17,454,0.0
3,1,2,1,0,0,216,4,238,13,-1,,17,454,0.0
4,1,2,1,1,0,216,4,238,13,-1,,17,454,0.0
5,1,2,1,1,1,216,7,6,7,0,a,14,222,0.0
5,1,2,1,1,2,236,4,71,13,68,Employee's,17,307,0.0
5,1,2,1,1,3,311,4,36,10,96,social,14,347,0.0
5,1,2,1,1,4,352,4,48,13,96,security,17,400,0.0
5,1,2,1,1,5,406,4,48,10,95,number,14,454,0.0
2,1,3,0,0,0,596,1,1,50,-1,,51,597,0.0
3,1,3,1,0,0,596,1,1,50,-1,,51,597,0.0
4,1,3,1,1,0,596,1,1,50,-1,,51,597,0.0
5,1,3,1,1,1,596,1,1,50,95, ,51,597,0.0
2,1,4,0,0,0,1,49,658,5,-1,,54,659,0.0
3,1,4,1,0,0,1,49,658,5,-1,,54,659,0.0
4,1,4,1,1,0,1,49,658,5,-1,,54,659,0.0
5,1,4,1,1,1,1,49,658,5,95, ,54,659,0.0
2,1,5,0,0,0,1,101,658,5,-1,,106,659,0.0
3,1,5,1,0,0,1,101,658,5,-1,,106,659,0.0
4,1,5,1,1,0,1,101,658,5,-1,,106,659,0.0
5,1,5,1,1,1,1,101,658,5,95, ,106,659,0.0
2,1,6,0,0,0,782,3,411,14,-1,,17,1193,0.0
3,1,6,1,0,0,782,3,411,14,-1,,17,1193,0.0
4,1,6,1,1,0,782,3,411,14,-1,,17,1193,0.0
5,1,6,1,1,1,782,3,35,14,95,"Safe,",17,817,0.0
5,1,6,1,1,2,822,3,71,14,96,"Accurate,",17,893,0.0
5,1,6,1,1,3,1047,4,31,12,96,Visit,16,1078,0.0
5,1,6,1,1,4,1082,4,20,12,96,the,16,1102,0.0
5,1,6,1,1,5,1108,4,23,12,96,IRS,16,1131,0.0
5,1,6,1,1,6,1136,4,57,12,96,Website,16,1193,0.0
2,1,7,0,0,0,904,10,136,34,-1,,44,1040,0.0
3,1,7,1,0,0,904,10,136,34,-1,,44,1040,0.0
4,1,7,1,1,0,904,10,136,34,-1,,44,1040,0.0
5,1,7,1,1,1,904,10,136,34,6,e-file],44,1040,0.0
2,1,8,0,0,0,660,153,576,5,-1,,158,1236,0.0
3,1,8,1,0,0,660,153,576,5,-1,,158,1236,0.0
4,1,8,1,1,0,660,153,576,5,-1,,158,1236,0.0
5,1,8,1,1,1,660,153,576,5,95, ,158,1236,0.0
2,1,9,0,0,0,659,204,577,5,-1,,209,1236,0.0
3,1,9,1,0,0,659,204,577,5,-1,,209,1236,0.0
4,1,9,1,1,0,659,204,577,5,-1,,209,1236,0.0
5,1,9,1,1,1,659,204,577,5,95, ,209,1236,0.0
2,1,10,0,0,0,1,255,658,5,-1,,260,659,0.0
3,1,10,1,0,0,1,255,658,5,-1,,260,659,0.0
4,1,10,1,1,0,1,255,658,5,-1,,260,659,0.0
5,1,10,1,1,1,1,255,658,5,95, ,260,659,0.0
2,1,11,0,0,0,1,307,658,5,-1,,312,659,0.0
3,1,11,1,0,0,1,307,658,5,-1,,312,659,0.0
4,1,11,1,1,0,1,307,658,5,-1,,312,659,0.0
5,1,11,1,1,1,1,307,658,5,95, ,312,659,0.0
2,1,12,0,0,0,660,364,576,5,-1,,369,1236,0.0
3,1,12,1,0,0,660,364,576,5,-1,,369,1236,0.0
4,1,12,1,1,0,660,364,576,5,-1,,369,1236,0.0
5,1,12,1,1,1,660,364,576,5,95, ,369,1236,0.0
2,1,13,0,0,0,689,393,204,3,-1,,396,893,0.0
3,1,13,1,0,0,689,393,204,3,-1,,396,893,0.0
4,1,13,1,1,0,689,393,204,3,-1,,396,893,0.0
5,1,13,1,1,1,689,393,204,3,95, ,396,893,0.0
2,1,14,0,0,0,689,394,1,28,-1,,422,690,0.0
3,1,14,1,0,0,689,394,1,28,-1,,422,690,0.0
4,1,14,1,1,0,689,394,1,28,-1,,422,690,0.0
5,1,14,1,1,1,689,394,1,28,95, ,422,690,0.0
2,1,15,0,0,0,718,394,1,28,-1,,422,719,0.0
3,1,15,1,0,0,718,394,1,28,-1,,422,719,0.0
4,1,15,1,1,0,718,394,1,28,-1,,422,719,0.0
5,1,15,1,1,1,718,394,1,28,95, ,422,719,0.0
2,1,16,0,0,0,776,394,1,28,-1,,422,777,0.0
3,1,16,1,0,0,776,394,1,28,-1,,422,777,0.0
4,1,16,1,1,0,776,394,1,28,-1,,422,777,0.0
5,1,16,1,1,1,776,394,1,28,95, ,422,777,0.0
2,1,17,0,0,0,805,394,1,28,-1,,422,806,0.0
3,1,17,1,0,0,805,394,1,28,-1,,422,806,0.0
4,1,17,1,1,0,805,394,1,28,-1,,422,806,0.0
5,1,17,1,1,1,805,394,1,28,95, ,422,806,0.0
2,1,18,0,0,0,863,394,1,28,-1,,422,864,0.0
3,1,18,1,0,0,863,394,1,28,-1,,422,864,0.0
4,1,18,1,1,0,863,394,1,28,-1,,422,864,0.0
5,1,18,1,1,1,863,394,1,28,95, ,422,864,0.0
2,1,19,0,0,0,892,394,1,28,-1,,422,893,0.0
3,1,19,1,0,0,892,394,1,28,-1,,422,893,0.0
4,1,19,1,1,0,892,394,1,28,-1,,422,893,0.0
5,1,19,1,1,1,892,394,1,28,95, ,422,893,0.0
2,1,20,0,0,0,660,419,576,7,-1,,426,1236,0.0
3,1,20,1,0,0,660,419,576,7,-1,,426,1236,0.0
4,1,20,1,1,0,660,419,576,7,-1,,426,1236,0.0
5,1,20,1,1,1,660,419,576,7,95, ,426,1236,0.0
2,1,21,0,0,0,11,18,1169,540,-1,,558,1180,0.0
3,1,21,1,0,0,11,18,1169,540,-1,,558,1180,0.0
4,1,21,1,1,0,44,18,1136,33,-1,,51,1180,0.0
5,1,21,1,1,1,44,18,126,33,96,STATEMENT,51,170,0.0
5,1,21,1,1,2,312,28,150,15,92,691-53-3104,43,462,0.0
5,1,21,1,1,3,612,29,28,10,93,OMB,39,640,0.0
5,1,21,1,1,4,646,29,14,10,93,No.,39,660,0.0
5,1,21,1,1,5,671,29,57,10,69,1646-0008,39,728,0.0
5,1,21,1,1,6,781,28,44,12,94,FAST!,40,825,0.0
5,1,21,1,1,7,835,28,28,12,94,Use,40,863,0.0
5,1,21,1,1,8,1048,30,12,11,93,at,41,1060,0.0
5,1,21,1,1,9,1069,29,111,15,64,www.irs.goviefile.,44,1180,0.0
4,1,21,1,2,0,12,56,1143,13,-1,,69,1155,0.0
5,1,21,1,2,1,12,56,7,10,79,b,66,19,0.0
5,1,21,1,2,2,29,56,54,13,90,Employer,69,83,0.0
5,1,21,1,2,3,88,56,70,10,95,identification,66,158,0.0
5,1,21,1,2,4,164,56,42,10,96,number,66,206,0.0
5,1,21,1,2,5,681,56,4,10,70,1,66,685,0.0
5,1,21,1,2,6,704,56,40,13,79,"Wages,",69,744,0.0
5,1,21,1,2,7,753,57,24,12,95,"tips,",69,777,0.0
5,1,21,1,2,8,783,56,28,10,96,other,66,811,0.0
5,1,21,1,2,9,819,48,76,26,96,compensation,74,895,0.0
5,1,21,1,2,10,970,56,7,10,31,2,66,977,0.0
5,1,21,1,2,11,995,56,41,10,83,Federal,66,1036,0.0
5,1,21,1,2,12,1042,59,40,7,96,income,66,1082,0.0
5,1,21,1,2,13,1087,57,18,9,96,tax,66,1105,0.0
5,1,21,1,2,14,1109,56,46,10,96,withheld,66,1155,0.0
4,1,21,1,3,0,65,80,1030,15,-1,,95,1095,0.0
5,1,21,1,3,1,65,80,138,15,92,25-0924379,95,203,0.0
5,1,21,1,3,2,724,80,109,15,92,238401.8,95,833,0.0
5,1,21,1,3,3,986,80,109,15,92,32110.03,95,1095,0.0
4,1,21,1,4,0,13,108,1139,13,-1,,121,1152,0.0
5,1,21,1,4,1,13,111,6,7,48,ยข,118,19,0.0
5,1,21,1,4,2,29,108,62,13,94,Employers,121,91,0.0
5,1,21,1,4,3,97,111,30,7,87,"name,",118,127,0.0
5,1,21,1,4,4,137,108,44,10,90,"address,",118,181,0.0
5,1,21,1,4,5,191,108,19,10,96,and,118,210,0.0
5,1,21,1,4,6,215,108,18,10,96,ZIP,118,233,0.0
5,1,21,1,4,7,239,108,26,10,96,code,118,265,0.0
5,1,21,1,4,8,681,108,6,10,69,3,118,687,0.0
5,1,21,1,4,9,705,108,34,10,89,Social,118,739,0.0
5,1,21,1,4,10,745,109,45,12,93,security,121,790,0.0
5,1,21,1,4,11,794,111,36,10,96,wages,121,830,0.0
5,1,21,1,4,12,970,108,7,10,66,4,118,977,0.0
5,1,21,1,4,13,995,108,34,10,71,Social,118,1029,0.0
5,1,21,1,4,14,1036,100,43,25,96,security,125,1079,0.0
5,1,21,1,4,15,1084,109,18,9,96,tax,118,1102,0.0
5,1,21,1,4,16,1106,108,46,10,96,withheld,118,1152,0.0
4,1,21,1,5,0,64,133,1030,15,-1,,148,1094,0.0
5,1,21,1,5,1,64,133,209,15,91,Mcdonald-Harris,148,273,0.0
5,1,21,1,5,2,290,134,39,14,96,Inc,148,329,0.0
5,1,21,1,5,3,724,133,123,15,91,295439.81,148,847,0.0
5,1,21,1,5,4,985,133,109,15,91,22601.15,148,1094,0.0
4,1,21,1,6,0,66,159,1053,23,-1,,182,1119,0.0
5,1,21,1,6,1,66,167,38,15,96,560,182,104,0.0
5,1,21,1,6,2,120,168,68,14,96,Munoz,182,188,0.0
5,1,21,1,6,3,204,167,69,15,96,Mills,182,273,0.0
5,1,21,1,6,4,290,167,67,15,88,Suite,182,357,0.0
5,1,21,1,6,5,374,167,39,15,96,766,182,413,0.0
5,1,21,1,6,6,681,159,6,10,72,5,169,687,0.0
5,1,21,1,6,7,705,159,51,10,78,Medicare,169,756,0.0
5,1,21,1,6,8,761,162,36,10,96,wages,172,797,0.0
5,1,21,1,6,9,803,159,19,10,90,and,169,822,0.0
5,1,21,1,6,10,827,160,20,12,90,tips,172,847,0.0
5,1,21,1,6,11,970,159,6,10,63,6,169,976,0.0
5,1,21,1,6,12,995,159,51,10,73,Medicare,169,1046,0.0
5,1,21,1,6,13,1051,160,18,9,96,tax,169,1069,0.0
5,1,21,1,6,14,1073,159,46,10,92,withheld,169,1119,0.0
4,1,21,1,7,0,724,184,421,15,-1,,199,1145,0.0
5,1,21,1,7,1,724,184,123,15,89,299378.97,199,847,0.0
5,1,21,1,7,2,1050,184,95,15,95,8681.99,199,1145,0.0
4,1,21,1,8,0,66,198,1006,29,-1,,227,1072,0.0
5,1,21,1,8,1,66,201,68,15,93,South,216,134,0.0
5,1,21,1,8,2,149,201,125,15,91,Jamesstad,216,274,0.0
5,1,21,1,8,3,329,198,33,29,95,MN,227,362,0.0
5,1,21,1,8,4,416,201,136,15,95,44881-3192,216,552,0.0
5,1,21,1,8,5,681,210,5,10,33,7,220,686,0.0
5,1,21,1,8,6,705,210,34,10,83,Social,220,739,0.0
5,1,21,1,8,7,747,211,41,12,87,security,223,788,0.0
5,1,21,1,8,8,795,211,19,12,96,tips,223,814,0.0
5,1,21,1,8,9,970,210,6,10,33,@,220,976,0.0
5,1,21,1,8,10,994,210,53,10,70,Allocated,220,1047,0.0
5,1,21,1,8,11,1052,211,20,12,96,tips,223,1072,0.0
4,1,21,1,9,0,724,235,447,15,-1,,250,1171,0.0
5,1,21,1,9,1,724,235,123,15,91,295439.81,250,847,0.0
5,1,21,1,9,2,1049,235,80,15,0,299378,250,1129,0.0
5,1,21,1,9,3,1137,235,34,15,0,.97,250,1171,0.0
4,1,21,1,10,0,11,262,1122,13,-1,,275,1133,0.0
5,1,21,1,10,1,11,262,7,10,0,โd-,272,18,0.0
5,1,21,1,10,2,29,262,39,10,94,Control,272,68,0.0
5,1,21,1,10,3,74,262,42,10,96,number,272,116,0.0
5,1,21,1,10,4,680,262,7,10,69,9,272,687,0.0
5,1,21,1,10,5,704,262,48,10,71,Advance,272,752,0.0
5,1,21,1,10,6,758,262,19,10,92,EIC,272,777,0.0
5,1,21,1,10,7,783,263,48,12,96,payment,275,831,0.0
5,1,21,1,10,8,964,262,13,10,78,10,272,977,0.0
5,1,21,1,10,9,995,262,60,13,75,Dependent,275,1055,0.0
5,1,21,1,10,10,1061,265,23,7,96,care,272,1084,0.0
5,1,21,1,10,11,1090,262,43,10,92,benefits,272,1133,0.0
4,1,21,1,11,0,12,313,1163,13,-1,,326,1175,0.0
5,1,21,1,11,1,29,313,65,13,81,Employee's,326,94,0.0
5,1,21,1,11,2,99,313,20,10,94,first,323,119,0.0
5,1,21,1,11,3,125,316,30,7,94,name,323,155,0.0
5,1,21,1,11,4,161,313,19,10,96,and,323,180,0.0
5,1,21,1,11,5,186,313,28,10,95,initial,323,214,0.0
5,1,21,1,11,6,280,313,23,10,95,Last,323,303,0.0
5,1,21,1,11,7,309,316,30,7,94,name,323,339,0.0
5,1,21,1,11,8,674,313,11,10,56,71,323,685,0.0
5,1,21,1,11,9,705,313,68,13,69,Nonqualified,326,773,0.0
5,1,21,1,11,10,779,313,29,13,65,"plans,",326,808,0.0
5,1,21,1,11,11,966,313,20,10,36,12a,323,986,0.0
5,1,21,1,11,12,1009,313,22,10,64,See,323,1031,0.0
5,1,21,1,11,13,1037,313,71,10,95,instructions,323,1108,0.0
5,1,21,1,11,14,1112,313,17,10,96,for,323,1129,0.0
5,1,21,1,11,15,1134,313,22,10,96,box,323,1156,0.0
5,1,21,1,11,16,1162,313,13,10,91,12,323,1175,0.0
4,1,21,1,12,0,86,344,1016,17,-1,,361,1102,0.0
5,1,21,1,12,1,86,358,3,3,0,z,361,89,0.0
5,1,21,1,12,2,725,344,38,15,95,162,359,763,0.0
5,1,21,1,12,3,1005,345,13,14,93,E,359,1018,0.0
5,1,21,1,12,4,1050,344,52,15,24,[1500,359,1102,0.0
4,1,21,1,13,0,63,358,924,23,-1,,381,987,0.0
5,1,21,1,13,1,63,358,128,17,95,Mitchell,375,191,0.0
5,1,21,1,13,2,255,358,80,17,95,Allen,375,335,0.0
5,1,21,1,13,3,674,370,13,10,84,13,380,687,0.0
5,1,21,1,13,4,693,371,43,10,0,Stuiory,381,736,0.0
5,1,21,1,13,5,780,371,50,8,0,__Relrement,379,830,0.0
5,1,21,1,13,6,866,371,53,10,0,__โThire-pary,381,919,0.0
5,1,21,1,13,7,966,370,21,10,58,1,380,987,0.0
4,1,21,1,14,0,693,385,213,9,-1,,394,906,0.0
5,1,21,1,14,1,693,385,45,9,18,empeyee,394,738,0.0
5,1,21,1,14,2,780,385,18,9,46,plan,394,798,0.0
5,1,21,1,14,3,867,385,18,8,85,sick,393,885,0.0
5,1,21,1,14,4,895,387,11,7,85,pay,394,906,0.0
4,1,21,1,15,0,67,396,1021,17,-1,,413,1088,0.0
5,1,21,1,15,1,67,396,59,17,96,6503,413,126,1.0
5,1,21,1,15,2,146,396,61,17,96,John,413,207,1.0
5,1,21,1,15,3,226,397,94,16,96,Stream,413,320,1.0
5,1,21,1,15,4,786,402,10,11,94,x,413,796,0.0
5,1,21,1,15,5,1006,399,13,14,91,G,413,1019,0.0
5,1,21,1,15,6,1050,398,38,15,44,/522,413,1088,0.0
4,1,21,1,16,0,64,427,922,25,-1,,452,986,0.0
5,1,21,1,16,1,64,436,48,16,93,New,452,112,1.0
5,1,21,1,16,2,127,435,193,17,91,Meredithstad,452,320,1.0
5,1,21,1,16,3,383,436,31,16,92,MI,452,414,1.0
5,1,21,1,16,4,482,435,114,17,84,19628-8:,452,596,0.0
5,1,21,1,16,5,674,427,13,10,49,44,437,687,0.0
5,1,21,1,16,6,705,427,31,10,81,Other,437,736,0.0
5,1,21,1,16,7,741,427,23,13,86,(see,440,764,0.0
5,1,21,1,16,8,770,427,50,10,96,enclosed,437,820,0.0
5,1,21,1,16,9,826,427,35,10,96,Notice,437,861,0.0
5,1,21,1,16,10,866,428,10,9,96,to,437,876,0.0
5,1,21,1,16,11,882,427,61,13,94,Employee),440,943,0.0
5,1,21,1,16,12,949,419,11,25,46,|,444,960,0.0
5,1,21,1,16,13,966,427,20,10,38,12c,437,986,0.0
4,1,21,1,17,0,594,450,494,23,-1,,473,1088,0.0
5,1,21,1,17,1,594,450,2,2,0,:,452,596,0.0
5,1,21,1,17,2,1007,459,12,14,50,p,473,1019,0.0
5,1,21,1,17,3,1050,458,38,15,80,|641,473,1088,0.0
4,1,21,1,18,0,966,484,20,10,-1,,494,986,0.0
5,1,21,1,18,1,966,484,20,10,88,12d,494,986,0.0
4,1,21,1,19,0,1006,515,83,15,-1,,530,1089,0.0
5,1,21,1,19,1,1006,516,13,14,84,H,530,1019,0.0
5,1,21,1,19,2,1050,515,39,15,84,|999,530,1089,0.0
4,1,21,1,20,0,11,545,213,13,-1,,558,224,0.0
5,1,21,1,20,1,11,545,5,10,91,f,555,16,0.0
5,1,21,1,20,2,29,545,65,13,53,Employee's,558,94,0.0
5,1,21,1,20,3,100,545,44,10,91,address,555,144,0.0
5,1,21,1,20,4,150,545,19,10,96,and,555,169,0.0
5,1,21,1,20,5,174,545,18,10,94,ZIP,555,192,0.0
5,1,21,1,20,6,197,545,27,10,96,code,555,224,0.0
2,1,22,0,0,0,689,419,547,7,-1,,426,1236,0.0
3,1,22,1,0,0,689,419,547,7,-1,,426,1236,0.0
4,1,22,1,1,0,689,419,547,7,-1,,426,1236,0.0
5,1,22,1,1,1,689,419,547,7,95, ,426,1236,0.0
2,1,23,0,0,0,689,419,547,7,-1,,426,1236,0.0
3,1,23,1,0,0,689,419,547,7,-1,,426,1236,0.0
4,1,23,1,1,0,689,419,547,7,-1,,426,1236,0.0
5,1,23,1,1,1,689,419,547,7,95, ,426,1236,0.0
2,1,24,0,0,0,689,419,547,7,-1,,426,1236,0.0
3,1,24,1,0,0,689,419,547,7,-1,,426,1236,0.0
4,1,24,1,1,0,689,419,547,7,-1,,426,1236,0.0
5,1,24,1,1,1,689,419,547,7,95, ,426,1236,0.0
2,1,25,0,0,0,950,479,286,3,-1,,482,1236,0.0
3,1,25,1,0,0,950,479,286,3,-1,,482,1236,0.0
4,1,25,1,1,0,950,479,286,3,-1,,482,1236,0.0
5,1,25,1,1,1,950,479,286,3,95, ,482,1236,0.0
2,1,26,0,0,0,1042,326,3,212,-1,,538,1045,0.0
3,1,26,1,0,0,1042,326,3,212,-1,,538,1045,0.0
4,1,26,1,1,0,1042,326,3,212,-1,,538,1045,0.0
5,1,26,1,1,1,1042,326,3,212,95, ,538,1045,0.0
2,1,27,0,0,0,950,536,286,3,-1,,539,1236,0.0
3,1,27,1,0,0,950,536,286,3,-1,,539,1236,0.0
4,1,27,1,1,0,950,536,286,3,-1,,539,1236,0.0
5,1,27,1,1,1,950,536,286,3,95, ,539,1236,0.0
2,1,28,0,0,0,658,105,5,454,-1,,559,663,0.0
3,1,28,1,0,0,658,105,5,454,-1,,559,663,0.0
4,1,28,1,1,0,658,105,5,454,-1,,559,663,0.0
5,1,28,1,1,1,658,105,5,454,95, ,559,663,0.0
2,1,29,0,0,0,948,105,5,454,-1,,559,953,0.0
3,1,29,1,0,0,948,105,5,454,-1,,559,953,0.0
4,1,29,1,1,0,948,105,5,454,-1,,559,953,0.0
5,1,29,1,1,1,948,105,5,454,95, ,559,953,0.0
2,1,30,0,0,0,1,554,1235,9,-1,,563,1236,0.0
3,1,30,1,0,0,1,554,1235,9,-1,,563,1236,0.0
4,1,30,1,1,0,1,554,1235,9,-1,,563,1236,0.0
5,1,30,1,1,1,1,554,1235,9,95, ,563,1236,0.0
2,1,31,0,0,0,6,562,52,40,-1,,602,58,0.0
3,1,31,1,0,0,6,562,52,40,-1,,602,58,0.0
4,1,31,1,1,0,6,562,52,10,-1,,572,58,0.0
5,1,31,1,1,1,6,562,13,10,86,15,572,19,0.0
5,1,31,1,1,2,29,562,29,10,86,State,572,58,0.0
4,1,31,1,2,0,17,588,28,14,-1,,602,45,0.0
5,1,31,1,2,1,17,588,28,14,95,PA,602,45,0.0
2,1,32,0,0,0,88,562,572,13,-1,,575,660,0.0
3,1,32,1,0,0,88,562,572,13,-1,,575,660,0.0
4,1,32,1,1,0,88,562,572,13,-1,,575,660,0.0
5,1,32,1,1,1,88,562,62,13,69,Employer's,575,150,0.0
5,1,32,1,1,2,156,563,27,9,94,state,572,183,0.0
5,1,32,1,1,3,189,562,10,10,84,ID,572,199,0.0
5,1,32,1,1,4,205,562,42,10,96,number,572,247,0.0
5,1,32,1,1,5,541,562,11,10,63,TT,572,552,0.0
5,1,32,1,1,6,562,562,29,10,90,State,572,591,0.0
5,1,32,1,1,7,597,565,40,7,94,income,572,637,0.0
5,1,32,1,1,8,642,563,18,9,96,tax,572,660,0.0
2,1,33,0,0,0,131,587,137,15,-1,,602,268,0.0
3,1,33,1,0,0,131,587,137,15,-1,,602,268,0.0
4,1,33,1,1,0,131,587,137,15,-1,,602,268,0.0
5,1,33,1,1,1,131,587,137,15,86,299-54-060,602,268,0.0
2,1,34,0,0,0,349,562,146,13,-1,,575,495,0.0
3,1,34,1,0,0,349,562,146,13,-1,,575,495,0.0
4,1,34,1,1,0,349,562,146,13,-1,,575,495,0.0
5,1,34,1,1,1,349,562,12,10,57,16,572,361,0.0
5,1,34,1,1,2,370,562,29,10,89,State,572,399,0.0
5,1,34,1,1,3,404,565,36,10,85,"wages,",575,440,0.0
5,1,34,1,1,4,449,563,20,12,94,"tips,",575,469,0.0
5,1,34,1,1,5,479,563,16,9,80,etc,572,495,0.0
2,1,35,0,0,0,347,587,286,15,-1,,602,633,0.0
3,1,35,1,0,0,347,587,286,15,-1,,602,633,0.0
4,1,35,1,1,0,347,587,286,15,-1,,602,633,0.0
5,1,35,1,1,1,347,587,122,15,90,108724.18,602,469,0.0
5,1,35,1,1,2,539,587,94,15,33,9955;95,602,633,0.0
2,1,36,0,0,0,0,605,1236,9,-1,,614,1236,0.0
3,1,36,1,0,0,0,605,1236,9,-1,,614,1236,0.0
4,1,36,1,1,0,0,605,1236,9,-1,,614,1236,0.0
5,1,36,1,1,1,0,605,1236,9,95, ,614,1236,0.0
2,1,37,0,0,0,59,558,1,103,-1,,661,60,0.0
3,1,37,1,0,0,59,558,1,103,-1,,661,60,0.0
4,1,37,1,1,0,59,558,1,103,-1,,661,60,0.0
5,1,37,1,1,1,59,558,1,103,95, ,661,60,0.0
2,1,38,0,0,0,340,558,1,103,-1,,661,341,0.0
3,1,38,1,0,0,340,558,1,103,-1,,661,341,0.0
4,1,38,1,1,0,340,558,1,103,-1,,661,341,0.0
5,1,38,1,1,1,340,558,1,103,95, ,661,341,0.0
2,1,39,0,0,0,532,558,1,103,-1,,661,533,0.0
3,1,39,1,0,0,532,558,1,103,-1,,661,533,0.0
4,1,39,1,1,0,532,558,1,103,-1,,661,533,0.0
5,1,39,1,1,1,532,558,1,103,95, ,661,533,0.0
2,1,40,0,0,0,930,562,119,10,-1,,572,1049,0.0
3,1,40,1,0,0,930,562,119,10,-1,,572,1049,0.0
4,1,40,1,1,0,930,562,119,10,-1,,572,1049,0.0
5,1,40,1,1,1,930,562,11,10,74,19,572,941,0.0
5,1,40,1,1,2,951,562,29,10,87,Local,572,980,0.0
5,1,40,1,1,3,986,565,40,7,89,income,572,1026,0.0
5,1,40,1,1,4,1031,563,18,9,96,tax,572,1049,0.0
2,1,41,0,0,0,928,587,108,15,-1,,602,1036,0.0
3,1,41,1,0,0,928,587,108,15,-1,,602,1036,0.0
4,1,41,1,1,0,928,587,108,15,-1,,602,1036,0.0
5,1,41,1,1,1,928,587,66,15,19,31747,602,994,0.0
5,1,41,1,1,2,1001,587,35,15,19,.52,602,1036,0.0
2,1,42,0,0,0,726,562,147,13,-1,,575,873,0.0
3,1,42,1,0,0,726,562,147,13,-1,,575,873,0.0
4,1,42,1,1,0,726,562,147,13,-1,,575,873,0.0
5,1,42,1,1,1,726,562,12,10,73,78,572,738,0.0
5,1,42,1,1,2,748,562,29,10,94,Local,572,777,0.0
5,1,42,1,1,3,782,565,36,10,74,wages.,575,818,0.0
5,1,42,1,1,4,827,563,20,12,94,"tips,",575,847,0.0
5,1,42,1,1,5,857,563,16,9,70,ete,572,873,0.0
2,1,43,0,0,0,724,587,123,15,-1,,602,847,0.0
3,1,43,1,0,0,724,587,123,15,-1,,602,847,0.0
4,1,43,1,1,0,724,587,123,15,-1,,602,847,0.0
5,1,43,1,1,1,724,587,123,15,90,249135.85,602,847,0.0
2,1,44,0,0,0,1114,562,102,13,-1,,575,1216,0.0
3,1,44,1,0,0,1114,562,102,13,-1,,575,1216,0.0
4,1,44,1,1,0,1114,562,102,13,-1,,575,1216,0.0
5,1,44,1,1,1,1114,562,13,10,82,20,572,1127,0.0
5,1,44,1,1,2,1137,562,44,13,90,Locality,575,1181,0.0
5,1,44,1,1,3,1186,565,30,7,96,name,572,1216,0.0
2,1,45,0,0,0,1116,594,111,10,-1,,604,1227,0.0
3,1,45,1,0,0,1116,594,111,10,-1,,604,1227,0.0
4,1,45,1,1,0,1116,594,111,10,-1,,604,1227,0.0
5,1,45,1,1,1,1116,594,48,8,92,Francis,602,1164,0.0
5,1,45,1,1,2,1172,594,55,10,96,Motorway,604,1227,0.0
2,1,46,0,0,0,1233,1,3,660,-1,,661,1236,0.0
3,1,46,1,0,0,1233,1,3,660,-1,,661,1236,0.0
4,1,46,1,1,0,1233,1,3,660,-1,,661,1236,0.0
5,1,46,1,1,1,1233,1,3,660,95, ,661,1236,0.0
2,1,47,0,0,0,717,394,3,267,-1,,661,720,0.0
3,1,47,1,0,0,717,394,3,267,-1,,661,720,0.0
4,1,47,1,1,0,717,394,3,267,-1,,661,720,0.0
5,1,47,1,1,1,717,394,3,267,95, ,661,720,0.0
2,1,48,0,0,0,921,558,1,103,-1,,661,922,0.0
3,1,48,1,0,0,921,558,1,103,-1,,661,922,0.0
4,1,48,1,1,0,921,558,1,103,-1,,661,922,0.0
5,1,48,1,1,1,921,558,1,103,95, ,661,922,0.0
2,1,49,0,0,0,1107,558,1,103,-1,,661,1108,0.0
3,1,49,1,0,0,1107,558,1,103,-1,,661,1108,0.0
4,1,49,1,1,0,1107,558,1,103,-1,,661,1108,0.0
5,1,49,1,1,1,1107,558,1,103,95, ,661,1108,0.0
2,1,50,0,0,0,1,656,1235,9,-1,,665,1236,0.0
3,1,50,1,0,0,1,656,1235,9,-1,,665,1236,0.0
4,1,50,1,1,0,1,656,1235,9,-1,,665,1236,0.0
5,1,50,1,1,1,1,656,1235,9,95, ,665,1236,0.0
2,1,51,0,0,0,4,638,1227,90,-1,,728,1231,0.0
3,1,51,1,0,0,4,638,1227,82,-1,,720,1231,0.0
4,1,51,1,1,0,16,638,1213,15,-1,,653,1229,0.0
5,1,51,1,1,1,16,639,26,14,52,Wr,653,42,0.0
5,1,51,1,1,2,132,638,136,15,91,690-64-020,653,268,0.0
5,1,51,1,1,3,347,638,122,15,90,109979.48,653,469,0.0
5,1,51,1,1,4,539,638,95,15,94,8178.06,653,634,0.0
5,1,51,1,1,5,724,638,123,15,90,287877.95,653,847,0.0
5,1,51,1,1,6,927,638,109,15,91,42455.87,653,1036,0.0
5,1,51,1,1,7,1112,644,64,9,95,Mueller,653,1176,0.0
5,1,51,1,1,8,1186,644,43,9,96,Forks,653,1229,0.0
4,1,51,1,2,0,139,670,1092,22,-1,,692,1231,0.0
5,1,51,1,2,1,139,670,63,22,96,Wage,692,202,0.0
5,1,51,1,2,2,211,670,41,17,96,and,687,252,0.0
5,1,51,1,2,3,261,670,40,17,96,Tax,687,301,0.0
5,1,51,1,2,4,864,675,81,15,96,Department,690,945,0.0
5,1,51,1,2,5,950,675,12,12,96,of,687,962,0.0
5,1,51,1,2,6,966,675,20,12,93,the,687,986,0.0
5,1,51,1,2,7,991,675,118,15,35,TreasuryโInternal,690,1109,0.0
5,1,51,1,2,8,1115,675,59,12,96,Revenue,687,1174,0.0
5,1,51,1,2,9,1180,675,51,12,97,Service,687,1231,0.0
4,1,51,1,3,0,4,677,689,51,-1,,728,693,0.0
5,1,51,1,3,1,4,709,34,11,93,Form,720,38,0.0
5,1,51,1,3,2,47,709,25,11,91,W-2,720,72,0.0
5,1,51,1,3,3,140,697,114,31,96,Statement,728,254,0.0
5,1,51,1,3,4,549,677,27,42,21,c,719,576,0.0
5,1,51,1,3,5,588,677,27,42,50,0,719,615,0.0
5,1,51,1,3,6,628,677,26,42,59,1,719,654,0.0
5,1,51,1,3,7,666,677,27,42,52,0,719,693,0.0
2,1,52,0,0,0,4,732,482,37,-1,,769,486,0.0
3,1,52,1,0,0,4,732,482,37,-1,,769,486,0.0
4,1,52,1,1,0,5,732,462,15,-1,,747,467,0.0
5,1,52,1,1,1,5,732,40,15,93,Copy,747,45,0.0
5,1,52,1,1,2,51,732,43,12,91,B--To,744,94,0.0
5,1,52,1,1,3,100,732,20,12,96,Be,744,120,0.0
5,1,52,1,1,4,126,732,35,12,95,Filed,744,161,0.0
5,1,52,1,1,5,167,732,32,12,96,with,744,199,0.0
5,1,52,1,1,6,206,732,87,15,85,Employee's,747,293,0.0
5,1,52,1,1,7,300,732,76,12,96,FEDERAL,744,376,0.0
5,1,52,1,1,8,382,732,27,12,95,Tax,744,409,0.0
5,1,52,1,1,9,415,732,52,12,96,Return,744,467,0.0
4,1,52,1,2,0,4,754,482,15,-1,,769,486,0.0
5,1,52,1,2,1,4,754,29,12,96,This,766,33,0.0
5,1,52,1,2,2,40,754,79,12,93,information,766,119,0.0
5,1,52,1,2,3,126,757,10,9,93,is,766,136,0.0
5,1,52,1,2,4,143,754,38,15,94,being,769,181,0.0
5,1,52,1,2,5,187,754,67,12,96,furnished,766,254,0.0
5,1,52,1,2,6,260,754,12,12,96,to,766,272,0.0
5,1,52,1,2,7,278,754,22,12,96,the,766,300,0.0
5,1,52,1,2,8,307,754,52,12,93,Internal,766,359,0.0
5,1,52,1,2,9,365,754,62,12,95,Revenue,766,427,0.0
5,1,52,1,2,10,433,754,53,12,96,Service,766,486,0.0
2,1,53,0,0,0,469,825,294,14,-1,,839,763,0.0
3,1,53,1,0,0,469,825,294,14,-1,,839,763,0.0
4,1,53,1,1,0,469,825,294,14,-1,,839,763,0.0
5,1,53,1,1,1,469,825,55,11,51,Tuthere.,836,524,0.0
5,1,53,1,1,2,537,825,32,14,92,Keep,839,569,0.0
5,1,53,1,1,3,575,825,34,11,94,lower,836,609,0.0
5,1,53,1,1,4,614,826,42,13,96,portion,839,656,0.0
5,1,53,1,1,5,661,825,17,11,72,for,836,678,0.0
5,1,53,1,1,6,682,828,28,11,94,your,839,710,0.0
5,1,53,1,1,7,715,825,48,11,67,records,836,763,0.0
2,1,54,0,0,0,1,870,1235,9,-1,,879,1236,0.0
3,1,54,1,0,0,1,870,1235,9,-1,,879,1236,0.0
4,1,54,1,1,0,1,870,1235,9,-1,,879,1236,0.0
5,1,54,1,1,1,1,870,1235,9,95, ,879,1236,0.0
2,1,55,0,0,0,212,874,1,52,-1,,926,213,0.0
3,1,55,1,0,0,212,874,1,52,-1,,926,213,0.0
4,1,55,1,1,0,212,874,1,52,-1,,926,213,0.0
5,1,55,1,1,1,212,874,1,52,95, ,926,213,0.0
2,1,56,0,0,0,596,874,1,52,-1,,926,597,0.0
3,1,56,1,0,0,596,874,1,52,-1,,926,597,0.0
4,1,56,1,1,0,596,874,1,52,-1,,926,597,0.0
5,1,56,1,1,1,596,874,1,52,95, ,926,597,0.0
2,1,57,0,0,0,1,921,1235,9,-1,,930,1236,0.0
3,1,57,1,0,0,1,921,1235,9,-1,,930,1236,0.0
4,1,57,1,1,0,1,921,1235,9,-1,,930,1236,0.0
5,1,57,1,1,1,1,921,1235,9,95, ,930,1236,0.0
2,1,58,0,0,0,1,972,1235,9,-1,,981,1236,0.0
3,1,58,1,0,0,1,972,1235,9,-1,,981,1236,0.0
4,1,58,1,1,0,1,972,1235,9,-1,,981,1236,0.0
5,1,58,1,1,1,1,972,1235,9,95, ,981,1236,0.0
2,1,59,0,0,0,660,1025,576,5,-1,,1030,1236,0.0
3,1,59,1,0,0,660,1025,576,5,-1,,1030,1236,0.0
4,1,59,1,1,0,660,1025,576,5,-1,,1030,1236,0.0
5,1,59,1,1,1,660,1025,576,5,95, ,1030,1236,0.0
2,1,60,0,0,0,660,1076,576,5,-1,,1081,1236,0.0
3,1,60,1,0,0,660,1076,576,5,-1,,1081,1236,0.0
4,1,60,1,1,0,660,1076,576,5,-1,,1081,1236,0.0
5,1,60,1,1,1,660,1076,576,5,95, ,1081,1236,0.0
2,1,61,0,0,0,1,1125,1235,9,-1,,1134,1236,0.0
3,1,61,1,0,0,1,1125,1235,9,-1,,1134,1236,0.0
4,1,61,1,1,0,1,1125,1235,9,-1,,1134,1236,0.0
5,1,61,1,1,1,1,1125,1235,9,95, ,1134,1236,0.0
2,1,62,0,0,0,1,1176,1235,9,-1,,1185,1236,0.0
3,1,62,1,0,0,1,1176,1235,9,-1,,1185,1236,0.0
4,1,62,1,1,0,1,1176,1235,9,-1,,1185,1236,0.0
5,1,62,1,1,1,1,1176,1235,9,95, ,1185,1236,0.0
2,1,63,0,0,0,660,1235,576,5,-1,,1240,1236,0.0
3,1,63,1,0,0,660,1235,576,5,-1,,1240,1236,0.0
4,1,63,1,1,0,660,1235,576,5,-1,,1240,1236,0.0
5,1,63,1,1,1,660,1235,576,5,95, ,1240,1236,0.0
2,1,64,0,0,0,689,1266,204,3,-1,,1269,893,0.0
3,1,64,1,0,0,689,1266,204,3,-1,,1269,893,0.0
4,1,64,1,1,0,689,1266,204,3,-1,,1269,893,0.0
5,1,64,1,1,1,689,1266,204,3,95, ,1269,893,0.0
2,1,65,0,0,0,689,1267,1,28,-1,,1295,690,0.0
3,1,65,1,0,0,689,1267,1,28,-1,,1295,690,0.0
4,1,65,1,1,0,689,1267,1,28,-1,,1295,690,0.0
5,1,65,1,1,1,689,1267,1,28,95, ,1295,690,0.0
2,1,66,0,0,0,718,1267,1,28,-1,,1295,719,0.0
3,1,66,1,0,0,718,1267,1,28,-1,,1295,719,0.0
4,1,66,1,1,0,718,1267,1,28,-1,,1295,719,0.0
5,1,66,1,1,1,718,1267,1,28,95, ,1295,719,0.0
2,1,67,0,0,0,776,1267,1,28,-1,,1295,777,0.0
3,1,67,1,0,0,776,1267,1,28,-1,,1295,777,0.0
4,1,67,1,1,0,776,1267,1,28,-1,,1295,777,0.0
5,1,67,1,1,1,776,1267,1,28,95, ,1295,777,0.0
2,1,68,0,0,0,805,1266,1,29,-1,,1295,806,0.0
3,1,68,1,0,0,805,1266,1,29,-1,,1295,806,0.0
4,1,68,1,1,0,805,1266,1,29,-1,,1295,806,0.0
5,1,68,1,1,1,805,1266,1,29,95, ,1295,806,0.0
2,1,69,0,0,0,863,1267,1,28,-1,,1295,864,0.0
3,1,69,1,0,0,863,1267,1,28,-1,,1295,864,0.0
4,1,69,1,1,0,863,1267,1,28,-1,,1295,864,0.0
5,1,69,1,1,1,863,1267,1,28,95, ,1295,864,0.0
2,1,70,0,0,0,892,1267,1,28,-1,,1295,893,0.0
3,1,70,1,0,0,892,1267,1,28,-1,,1295,893,0.0
4,1,70,1,1,0,892,1267,1,28,-1,,1295,893,0.0
5,1,70,1,1,1,892,1267,1,28,95, ,1295,893,0.0
2,1,71,0,0,0,660,1292,576,7,-1,,1299,1236,0.0
3,1,71,1,0,0,660,1292,576,7,-1,,1299,1236,0.0
4,1,71,1,1,0,660,1292,576,7,-1,,1299,1236,0.0
5,1,71,1,1,1,660,1292,576,7,95, ,1299,1236,0.0
2,1,72,0,0,0,659,925,3,507,-1,,1432,662,0.0
3,1,72,1,0,0,659,925,3,507,-1,,1432,662,0.0
4,1,72,1,1,0,659,925,3,507,-1,,1432,662,0.0
5,1,72,1,1,1,659,925,3,507,95, ,1432,662,0.0
2,1,73,0,0,0,689,1292,547,7,-1,,1299,1236,0.0
3,1,73,1,0,0,689,1292,547,7,-1,,1299,1236,0.0
4,1,73,1,1,0,689,1292,547,7,-1,,1299,1236,0.0
5,1,73,1,1,1,689,1292,547,7,95, ,1299,1236,0.0
2,1,74,0,0,0,689,1292,547,7,-1,,1299,1236,0.0
3,1,74,1,0,0,689,1292,547,7,-1,,1299,1236,0.0
4,1,74,1,1,0,689,1292,547,7,-1,,1299,1236,0.0
5,1,74,1,1,1,689,1292,547,7,95, ,1299,1236,0.0
2,1,75,0,0,0,689,1292,547,7,-1,,1299,1236,0.0
3,1,75,1,0,0,689,1292,547,7,-1,,1299,1236,0.0
4,1,75,1,1,0,689,1292,547,7,-1,,1299,1236,0.0
5,1,75,1,1,1,689,1292,547,7,95, ,1299,1236,0.0
2,1,76,0,0,0,950,1352,286,3,-1,,1355,1236,0.0
3,1,76,1,0,0,950,1352,286,3,-1,,1355,1236,0.0
4,1,76,1,1,0,950,1352,286,3,-1,,1355,1236,0.0
5,1,76,1,1,1,950,1352,286,3,95, ,1355,1236,0.0
2,1,77,0,0,0,1043,1197,1,214,-1,,1411,1044,0.0
3,1,77,1,0,0,1043,1197,1,214,-1,,1411,1044,0.0
4,1,77,1,1,0,1043,1197,1,214,-1,,1411,1044,0.0
5,1,77,1,1,1,1043,1197,1,214,95, ,1411,1044,0.0
2,1,78,0,0,0,950,1409,286,3,-1,,1412,1236,0.0
3,1,78,1,0,0,950,1409,286,3,-1,,1412,1236,0.0
4,1,78,1,1,0,950,1409,286,3,-1,,1412,1236,0.0
5,1,78,1,1,1,950,1409,286,3,95, ,1412,1236,0.0
2,1,79,0,0,0,949,925,3,507,-1,,1432,952,0.0
3,1,79,1,0,0,949,925,3,507,-1,,1432,952,0.0
4,1,79,1,1,0,949,925,3,507,-1,,1432,952,0.0
5,1,79,1,1,1,949,925,3,507,95, ,1432,952,0.0
2,1,80,0,0,0,1,1427,1235,9,-1,,1436,1236,0.0
3,1,80,1,0,0,1,1427,1235,9,-1,,1436,1236,0.0
4,1,80,1,1,0,1,1427,1235,9,-1,,1436,1236,0.0
5,1,80,1,1,1,1,1427,1235,9,95, ,1436,1236,0.0
2,1,81,0,0,0,0,1478,1236,9,-1,,1487,1236,0.0
3,1,81,1,0,0,0,1478,1236,9,-1,,1487,1236,0.0
4,1,81,1,1,0,0,1478,1236,9,-1,,1487,1236,0.0
5,1,81,1,1,1,0,1478,1236,9,95, ,1487,1236,0.0
2,1,82,0,0,0,58,1431,3,104,-1,,1535,61,0.0
3,1,82,1,0,0,58,1431,3,104,-1,,1535,61,0.0
4,1,82,1,1,0,58,1431,3,104,-1,,1535,61,0.0
5,1,82,1,1,1,58,1431,3,104,95, ,1535,61,0.0
2,1,83,0,0,0,339,1431,3,104,-1,,1535,342,0.0
3,1,83,1,0,0,339,1431,3,104,-1,,1535,342,0.0
4,1,83,1,1,0,339,1431,3,104,-1,,1535,342,0.0
5,1,83,1,1,1,339,1431,3,104,95, ,1535,342,0.0
2,1,84,0,0,0,531,1431,3,104,-1,,1535,534,0.0
3,1,84,1,0,0,531,1431,3,104,-1,,1535,534,0.0
4,1,84,1,1,0,531,1431,3,104,-1,,1535,534,0.0
5,1,84,1,1,1,531,1431,3,104,95, ,1535,534,0.0
2,1,85,0,0,0,1,1530,341,9,-1,,1539,342,0.0
3,1,85,1,0,0,1,1530,341,9,-1,,1539,342,0.0
4,1,85,1,1,0,1,1530,341,9,-1,,1539,342,0.0
5,1,85,1,1,1,1,1530,341,9,95, ,1539,342,0.0
2,1,86,0,0,0,1233,874,3,661,-1,,1535,1236,0.0
3,1,86,1,0,0,1233,874,3,661,-1,,1535,1236,0.0
4,1,86,1,1,0,1233,874,3,661,-1,,1535,1236,0.0
5,1,86,1,1,1,1233,874,3,661,95, ,1535,1236,0.0
2,1,87,0,0,0,717,1267,3,268,-1,,1535,720,0.0
3,1,87,1,0,0,717,1267,3,268,-1,,1535,720,0.0
4,1,87,1,1,0,717,1267,3,268,-1,,1535,720,0.0
5,1,87,1,1,1,717,1267,3,268,95, ,1535,720,0.0
2,1,88,0,0,0,920,1431,3,104,-1,,1535,923,0.0
3,1,88,1,0,0,920,1431,3,104,-1,,1535,923,0.0
4,1,88,1,1,0,920,1431,3,104,-1,,1535,923,0.0
5,1,88,1,1,1,920,1431,3,104,95, ,1535,923,0.0
2,1,89,0,0,0,1106,1431,3,104,-1,,1535,1109,0.0
3,1,89,1,0,0,1106,1431,3,104,-1,,1535,1109,0.0
4,1,89,1,1,0,1106,1431,3,104,-1,,1535,1109,0.0
5,1,89,1,1,1,1106,1431,3,104,95, ,1535,1109,0.0
2,1,90,0,0,0,338,1531,898,7,-1,,1538,1236,0.0
3,1,90,1,0,0,338,1531,898,7,-1,,1538,1236,0.0
4,1,90,1,1,0,338,1531,898,7,-1,,1538,1236,0.0
5,1,90,1,1,1,338,1531,898,7,95, ,1538,1236,0.0
2,1,91,0,0,0,4,878,1227,722,-1,,1600,1231,0.0
3,1,91,1,0,0,4,878,1227,713,-1,,1591,1231,0.0
4,1,91,1,1,0,55,878,1137,16,-1,,894,1192,0.0
5,1,91,1,1,1,55,879,103,15,91,REISSUED,894,158,0.0
5,1,91,1,1,2,216,881,6,7,53,[a,888,222,0.0
5,1,91,1,1,3,236,878,71,13,31,Employee's,891,307,0.0
5,1,91,1,1,4,311,878,36,10,91,social,888,347,0.0
5,1,91,1,1,5,352,878,48,13,94,security,891,400,0.0
5,1,91,1,1,6,406,878,48,10,96,number,888,454,0.0
5,1,91,1,1,7,750,878,23,10,95,This,888,773,0.0
5,1,91,1,1,8,779,878,61,10,96,information,888,840,0.0
5,1,91,1,1,9,846,881,8,7,90,is,888,854,0.0
5,1,91,1,1,10,860,878,29,13,90,being,891,889,0.0
5,1,91,1,1,11,894,878,51,10,93,furnished,888,945,0.0
5,1,91,1,1,12,950,879,10,9,96,to,888,960,0.0
5,1,91,1,1,13,965,878,17,10,96,the,888,982,0.0
5,1,91,1,1,14,988,878,40,10,84,Internal,888,1028,0.0
5,1,91,1,1,15,1034,878,47,10,93,Revenue,888,1081,0.0
5,1,91,1,1,16,1087,878,40,10,74,Senice.,888,1127,0.0
5,1,91,1,1,17,1141,878,6,10,77,If,888,1147,0.0
5,1,91,1,1,18,1150,881,20,10,77,you,891,1170,0.0
5,1,91,1,1,19,1176,881,16,7,94,are,888,1192,0.0
4,1,91,1,2,0,12,929,1143,13,-1,,942,1155,0.0
5,1,91,1,2,1,12,929,7,10,12,'b,939,19,0.0
5,1,91,1,2,2,29,929,54,13,95,Employer,942,83,0.0
5,1,91,1,2,3,88,929,70,10,92,identification,939,158,0.0
5,1,91,1,2,4,164,929,42,10,95,number,939,206,0.0
5,1,91,1,2,5,681,929,4,10,67,1,939,685,0.0
5,1,91,1,2,6,704,929,40,13,73,Wages.,942,744,0.0
5,1,91,1,2,7,753,930,20,12,92,"tips,",942,773,0.0
5,1,91,1,2,8,783,929,28,10,93,other,939,811,0.0
5,1,91,1,2,9,816,930,79,12,93,compensation,942,895,0.0
5,1,91,1,2,10,970,929,7,10,0,2,939,977,0.0
5,1,91,1,2,11,995,929,41,10,80,Federal,939,1036,0.0
5,1,91,1,2,12,1042,932,40,7,96,income,939,1082,0.0
5,1,91,1,2,13,1087,930,17,9,96,tax,939,1104,0.0
5,1,91,1,2,14,1109,929,46,10,86,withheld,939,1155,0.0
4,1,91,1,3,0,65,954,1030,15,-1,,969,1095,0.0
5,1,91,1,3,1,65,954,138,15,92,25-0924379,969,203,0.0
5,1,91,1,3,2,724,954,109,15,87,238401.8,969,833,0.0
5,1,91,1,3,3,986,954,109,15,90,32110.03,969,1095,0.0
4,1,91,1,4,0,13,980,1139,13,-1,,993,1152,0.0
5,1,91,1,4,1,13,983,6,7,33,โยข,990,19,0.0
5,1,91,1,4,2,29,980,62,13,94,Employers,993,91,0.0
5,1,91,1,4,3,97,983,30,7,91,"name,",990,127,0.0
5,1,91,1,4,4,137,980,44,10,92,"address,",990,181,0.0
5,1,91,1,4,5,191,980,19,10,95,and,990,210,0.0
5,1,91,1,4,6,215,980,18,10,95,ZIP,990,233,0.0
5,1,91,1,4,7,239,980,26,10,96,code,990,265,0.0
5,1,91,1,4,8,681,980,6,10,65,3,990,687,0.0
5,1,91,1,4,9,705,980,34,10,89,Social,990,739,0.0
5,1,91,1,4,10,745,981,45,12,96,security,993,790,0.0
5,1,91,1,4,11,794,983,36,10,96,wages,993,830,0.0
5,1,91,1,4,12,970,980,7,10,52,4,990,977,0.0
5,1,91,1,4,13,995,980,34,10,84,Social,990,1029,0.0
5,1,91,1,4,14,1036,972,43,25,96,security,997,1079,0.0
5,1,91,1,4,15,1084,981,18,9,96,tax,990,1102,0.0
5,1,91,1,4,16,1106,980,46,10,96,withheld,990,1152,0.0
4,1,91,1,5,0,64,1005,1030,15,-1,,1020,1094,0.0
5,1,91,1,5,1,64,1005,209,15,92,Mcdonald-Harris,1020,273,0.0
5,1,91,1,5,2,290,1006,39,14,94,Inc,1020,329,0.0
5,1,91,1,5,3,724,1005,123,15,91,295439.81,1020,847,0.0
5,1,91,1,5,4,985,1005,109,15,91,22601.15,1020,1094,0.0
4,1,91,1,6,0,66,1031,1053,23,-1,,1054,1119,0.0
5,1,91,1,6,1,66,1039,38,15,96,560,1054,104,0.0
5,1,91,1,6,2,120,1040,68,14,96,Munoz,1054,188,0.0
5,1,91,1,6,3,204,1039,69,15,96,Mills,1054,273,0.0
5,1,91,1,6,4,290,1039,67,15,91,Suite,1054,357,0.0
5,1,91,1,6,5,374,1039,39,15,96,766,1054,413,0.0
5,1,91,1,6,6,681,1031,6,10,69,5,1041,687,0.0
5,1,91,1,6,7,705,1031,51,10,79,Medicare,1041,756,0.0
5,1,91,1,6,8,761,1034,36,10,96,wages,1044,797,0.0
5,1,91,1,6,9,803,1031,19,10,93,and,1041,822,0.0
5,1,91,1,6,10,827,1032,20,12,93,tips,1044,847,0.0
5,1,91,1,6,11,970,1031,6,10,72,6,1041,976,0.0
5,1,91,1,6,12,995,1031,51,10,73,Medicare,1041,1046,0.0
5,1,91,1,6,13,1051,1032,18,9,96,tax,1041,1069,0.0
5,1,91,1,6,14,1073,1031,46,10,93,withheld,1041,1119,0.0
4,1,91,1,7,0,724,1056,421,15,-1,,1071,1145,0.0
5,1,91,1,7,1,724,1056,80,15,0,299378,1071,804,0.0
5,1,91,1,7,2,812,1056,35,15,0,.97,1071,847,0.0
5,1,91,1,7,3,1050,1056,95,15,95,8681.99,1071,1145,0.0
4,1,91,1,8,0,66,1070,1006,29,-1,,1099,1072,0.0
5,1,91,1,8,1,66,1073,68,15,93,South,1088,134,0.0
5,1,91,1,8,2,149,1073,125,15,92,Jamesstad,1088,274,0.0
5,1,91,1,8,3,329,1070,33,29,94,MN,1099,362,0.0
5,1,91,1,8,4,416,1073,136,15,95,44881-3192,1088,552,0.0
5,1,91,1,8,5,681,1082,5,10,36,7,1092,686,0.0
5,1,91,1,8,6,705,1082,34,10,88,Social,1092,739,0.0
5,1,91,1,8,7,747,1083,41,12,94,security,1095,788,0.0
5,1,91,1,8,8,795,1083,19,12,96,tips,1095,814,0.0
5,1,91,1,8,9,971,1082,5,10,49,@,1092,976,0.0
5,1,91,1,8,10,994,1082,53,10,93,Allocated,1092,1047,0.0
5,1,91,1,8,11,1052,1083,20,12,64,tips,1095,1072,0.0
4,1,91,1,9,0,724,1107,447,15,-1,,1122,1171,0.0
5,1,91,1,9,1,724,1107,123,15,91,295439.81,1122,847,0.0
5,1,91,1,9,2,1049,1107,80,15,0,299378,1122,1129,0.0
5,1,91,1,9,3,1137,1107,34,15,0,.97,1122,1171,0.0
4,1,91,1,10,0,11,1133,1122,13,-1,,1146,1133,0.0
5,1,91,1,10,1,11,1133,57,10,0,โControl,1143,68,0.0
5,1,91,1,10,2,74,1133,42,10,96,number,1143,116,0.0
5,1,91,1,10,3,680,1133,7,10,67,9,1143,687,0.0
5,1,91,1,10,4,704,1133,48,10,67,Advance,1143,752,0.0
5,1,91,1,10,5,758,1133,19,10,92,EIC,1143,777,0.0
5,1,91,1,10,6,783,1134,48,12,96,payment,1146,831,0.0
5,1,91,1,10,7,964,1133,13,10,73,40,1143,977,0.0
5,1,91,1,10,8,995,1133,60,13,72,Dependent,1146,1055,0.0
5,1,91,1,10,9,1061,1136,23,7,93,care,1143,1084,0.0
5,1,91,1,10,10,1090,1133,43,10,92,benefits,1143,1133,0.0
4,1,91,1,11,0,65,1158,1023,15,-1,,1173,1088,0.0
5,1,91,1,11,1,65,1158,95,15,95,2008341,1173,160,0.0
5,1,91,1,11,2,1049,1158,39,15,96,260,1173,1088,0.0
4,1,91,1,12,0,12,1184,1163,13,-1,,1197,1175,0.0
5,1,91,1,12,1,12,1187,6,7,35,@,1194,18,0.0
5,1,91,1,12,2,29,1184,65,13,73,Employee's,1197,94,0.0
5,1,91,1,12,3,99,1184,20,10,95,first,1194,119,0.0
5,1,91,1,12,4,125,1187,30,7,95,name,1194,155,0.0
5,1,91,1,12,5,161,1184,19,10,96,and,1194,180,0.0
5,1,91,1,12,6,186,1184,28,10,95,initial,1194,214,0.0
5,1,91,1,12,7,280,1184,23,10,96,Last,1194,303,0.0
5,1,91,1,12,8,309,1187,30,7,94,name,1194,339,0.0
5,1,91,1,12,9,674,1184,11,10,60,11,1194,685,0.0
5,1,91,1,12,10,705,1184,68,13,79,Nonqualified,1197,773,0.0
5,1,91,1,12,11,779,1184,29,13,76,plans,1197,808,0.0
5,1,91,1,12,12,966,1184,20,10,34,12a,1194,986,0.0
5,1,91,1,12,13,1009,1184,22,10,61,See,1194,1031,0.0
5,1,91,1,12,14,1037,1184,71,10,92,instructions,1194,1108,0.0
5,1,91,1,12,15,1112,1184,17,10,96,for,1194,1129,0.0
5,1,91,1,12,16,1134,1184,22,10,96,box,1194,1156,0.0
5,1,91,1,12,17,1162,1184,13,10,91,12,1194,1175,0.0
4,1,91,1,13,0,86,1215,1016,17,-1,,1232,1102,0.0
5,1,91,1,13,1,86,1229,3,3,0,z,1232,89,0.0
5,1,91,1,13,2,725,1215,38,15,95,162,1230,763,0.0
5,1,91,1,13,3,1005,1216,13,14,93,E,1230,1018,0.0
5,1,91,1,13,4,1050,1215,52,15,21,[1500,1230,1102,0.0
4,1,91,1,14,0,63,1229,924,23,-1,,1252,987,0.0
5,1,91,1,14,1,63,1229,128,17,95,Mitchell,1246,191,0.0
5,1,91,1,14,2,255,1229,80,17,95,Allen,1246,335,0.0
5,1,91,1,14,3,674,1241,13,10,55,13,1251,687,0.0
5,1,91,1,14,4,693,1242,43,10,37,Slatutory,1252,736,0.0
5,1,91,1,14,5,780,1242,50,8,0,___Relrement,1250,830,0.0
5,1,91,1,14,6,866,1242,23,8,0,Thre,1250,889,0.0
5,1,91,1,14,7,895,1230,28,30,0,pariy,1260,923,0.0
5,1,91,1,14,8,966,1241,21,10,51,1,1251,987,0.0
4,1,91,1,15,0,693,1257,213,10,-1,,1267,906,0.0
5,1,91,1,15,1,693,1257,44,10,59,empoyee,1267,737,0.0
5,1,91,1,15,2,780,1257,18,10,31,plan,1267,798,0.0
5,1,91,1,15,3,867,1257,18,8,95,sick,1265,885,0.0
5,1,91,1,15,4,889,1259,17,8,94,pay,1267,906,0.0
4,1,91,1,16,0,67,1269,1021,17,-1,,1286,1088,0.0
5,1,91,1,16,1,67,1269,59,17,96,6503,1286,126,0.0
5,1,91,1,16,2,146,1269,61,17,96,John,1286,207,0.0
5,1,91,1,16,3,226,1270,94,16,96,Stream,1286,320,0.0
5,1,91,1,16,4,786,1275,10,11,93,x,1286,796,0.0
5,1,91,1,16,5,1006,1272,13,14,91,G,1286,1019,0.0
5,1,91,1,16,6,1050,1271,38,15,59,/522,1286,1088,0.0
4,1,91,1,17,0,64,1300,922,25,-1,,1325,986,0.0
5,1,91,1,17,1,64,1309,48,16,93,New,1325,112,0.0
5,1,91,1,17,2,127,1308,193,17,92,Meredithstad,1325,320,0.0
5,1,91,1,17,3,383,1309,31,16,92,MI,1325,414,0.0
5,1,91,1,17,4,482,1308,114,17,74,19628-8:,1325,596,0.0
5,1,91,1,17,5,674,1300,13,10,49,44,1310,687,0.0
5,1,91,1,17,6,705,1300,31,10,84,Other,1310,736,0.0
5,1,91,1,17,7,741,1301,23,12,85,(see,1313,764,0.0
5,1,91,1,17,8,770,1300,50,10,96,enclosed,1310,820,0.0
5,1,91,1,17,9,826,1300,35,10,96,Notice,1310,861,0.0
5,1,91,1,17,10,866,1301,10,9,96,to,1310,876,0.0
5,1,91,1,17,11,882,1300,61,13,96,Employee),1313,943,0.0
5,1,91,1,17,12,949,1292,9,25,49,|,1317,958,0.0
5,1,91,1,17,13,966,1300,20,10,49,12c,1310,986,0.0
4,1,91,1,18,0,594,1323,494,23,-1,,1346,1088,0.0
5,1,91,1,18,1,594,1323,2,2,21,:,1325,596,0.0
5,1,91,1,18,2,1007,1332,12,14,52,Pp,1346,1019,0.0
5,1,91,1,18,3,1050,1331,38,15,79,|641,1346,1088,0.0
4,1,91,1,19,0,966,1357,20,10,-1,,1367,986,0.0
5,1,91,1,19,1,966,1357,20,10,88,12d,1367,986,0.0
4,1,91,1,20,0,1006,1388,83,15,-1,,1403,1089,0.0
5,1,91,1,20,1,1006,1389,13,14,85,H,1403,1019,0.0
5,1,91,1,20,2,1050,1388,39,15,85,|999,1403,1089,0.0
4,1,91,1,21,0,11,1418,213,13,-1,,1431,224,0.0
5,1,91,1,21,1,11,1418,5,10,91,f,1428,16,0.0
5,1,91,1,21,2,29,1418,65,13,46,Employee's,1431,94,0.0
5,1,91,1,21,3,100,1418,44,10,92,address,1428,144,0.0
5,1,91,1,21,4,150,1418,19,10,96,and,1428,169,0.0
5,1,91,1,21,5,174,1418,18,10,94,ZIP,1428,192,0.0
5,1,91,1,21,6,197,1418,27,10,96,code,1428,224,0.0
4,1,91,1,22,0,6,1435,1210,13,-1,,1448,1216,0.0
5,1,91,1,22,1,6,1435,13,10,91,15,1445,19,0.0
5,1,91,1,22,2,29,1435,29,10,58,Statel,1445,58,0.0
5,1,91,1,22,3,88,1435,62,13,47,Employers,1448,150,0.0
5,1,91,1,22,4,156,1436,27,9,94,state,1445,183,0.0
5,1,91,1,22,5,189,1435,10,10,94,ID,1445,199,0.0
5,1,91,1,22,6,205,1435,42,10,93,number,1445,247,0.0
5,1,91,1,22,7,349,1435,11,10,89,16,1445,360,0.0
5,1,91,1,22,8,370,1435,29,10,93,State,1445,399,0.0
5,1,91,1,22,9,404,1438,36,10,85,wages.,1448,440,0.0
5,1,91,1,22,10,449,1436,20,12,92,"tips,",1448,469,0.0
5,1,91,1,22,11,479,1436,16,9,84,etc.,1445,495,0.0
5,1,91,1,22,12,541,1435,12,10,85,17,1445,553,0.0
5,1,91,1,22,13,562,1435,29,10,91,State,1445,591,0.0
5,1,91,1,22,14,597,1438,40,7,95,income,1445,637,0.0
5,1,91,1,22,15,642,1436,18,9,96,tax,1445,660,0.0
5,1,91,1,22,16,727,1435,11,10,91,18,1445,738,0.0
5,1,91,1,22,17,748,1435,29,10,93,Local,1445,777,0.0
5,1,91,1,22,18,782,1438,40,10,90,wages.,1448,822,0.0
5,1,91,1,22,19,827,1436,20,12,95,"tips,",1448,847,0.0
5,1,91,1,22,20,857,1436,16,9,85,etc.,1445,873,0.0
5,1,91,1,22,21,929,1435,12,10,60,19,1445,941,0.0
5,1,91,1,22,22,951,1435,29,10,91,Local,1445,980,0.0
5,1,91,1,22,23,986,1438,40,7,96,income,1445,1026,0.0
5,1,91,1,22,24,1031,1436,18,9,96,tax,1445,1049,0.0
5,1,91,1,22,25,1114,1435,13,10,80,20,1445,1127,0.0
5,1,91,1,22,26,1137,1435,44,13,95,Locality,1448,1181,0.0
5,1,91,1,22,27,1186,1438,30,7,94,name,1445,1216,0.0
4,1,91,1,23,0,17,1460,1019,15,-1,,1475,1036,0.0
5,1,91,1,23,1,17,1461,28,14,96,PA,1475,45,0.0
5,1,91,1,23,2,131,1460,137,15,92,299-54-060,1475,268,0.0
5,1,91,1,23,3,347,1460,122,15,90,108724.18,1475,469,0.0
5,1,91,1,23,4,539,1460,94,15,95,9955.95,1475,633,0.0
5,1,91,1,23,5,724,1460,124,15,92,249135.85,1475,848,0.0
5,1,91,1,23,6,928,1460,108,15,86,31747.52,1475,1036,0.0
4,1,91,1,24,0,16,1512,1213,23,-1,,1535,1229,0.0
5,1,91,1,24,1,16,1513,26,14,52,Wi,1527,42,0.0
5,1,91,1,24,2,132,1512,136,15,92,690-64-020,1527,268,0.0
5,1,91,1,24,3,330,1512,139,23,36,_[109979.48,1535,469,0.0
5,1,91,1,24,4,539,1512,95,15,95,8178.06,1527,634,0.0
5,1,91,1,24,5,724,1512,124,15,90,287877.95,1527,848,0.0
5,1,91,1,24,6,928,1512,108,15,91,42455.87,1527,1036,0.0
5,1,91,1,24,7,1113,1518,63,9,95,Mueller,1527,1176,0.0
5,1,91,1,24,8,1186,1518,43,9,96,Forks,1527,1229,0.0
4,1,91,1,25,0,139,1542,1092,22,-1,,1564,1231,0.0
5,1,91,1,25,1,139,1542,63,22,95,Wage,1564,202,0.0
5,1,91,1,25,2,211,1542,41,17,96,and,1559,252,0.0
5,1,91,1,25,3,261,1542,40,17,95,Tax,1559,301,0.0
5,1,91,1,25,4,864,1547,81,15,96,Department,1562,945,0.0
5,1,91,1,25,5,950,1547,11,12,96,of,1559,961,0.0
5,1,91,1,25,6,966,1547,20,12,93,the,1559,986,0.0
5,1,91,1,25,7,991,1547,118,15,40,TreasuryโInternal,1562,1109,0.0
5,1,91,1,25,8,1115,1547,59,12,96,Revenue,1559,1174,0.0
5,1,91,1,25,9,1180,1547,51,12,96,Service,1559,1231,0.0
4,1,91,1,26,0,4,1545,1032,55,-1,,1600,1036,0.0
5,1,91,1,26,1,4,1579,34,11,93,Form,1590,38,0.0
5,1,91,1,26,2,47,1579,25,11,92,W-2,1590,72,0.0
5,1,91,1,26,3,140,1569,114,31,96,Statement,1600,254,0.0
5,1,91,1,26,4,549,1549,27,42,48,2,1591,576,0.0
5,1,91,1,26,5,588,1549,27,42,57,O,1591,615,0.0
5,1,91,1,26,6,624,1545,30,55,50,AF,1600,654,0.0
5,1,91,1,26,7,666,1549,27,42,42,0,1591,693,0.0
5,1,91,1,26,8,927,1575,35,15,96,"Safe,",1590,962,0.0
5,1,91,1,26,9,967,1575,69,15,90,"accurate,",1590,1036,0.0
2,1,92,0,0,0,5,1602,291,37,-1,,1639,296,0.0
3,1,92,1,0,0,5,1602,291,37,-1,,1639,296,0.0
4,1,92,1,1,0,5,1602,291,15,-1,,1617,296,0.0
5,1,92,1,1,1,5,1602,40,15,93,Copy,1617,45,0.0
5,1,92,1,1,2,51,1602,10,12,91,C,1614,61,0.0
5,1,92,1,1,3,68,1602,26,12,96,For,1614,94,0.0
5,1,92,1,1,4,100,1602,103,12,86,EMPLOYEE'S,1614,203,0.0
5,1,92,1,1,5,210,1602,86,12,96,RECORDS.,1614,296,0.0
4,1,92,1,2,0,5,1624,276,15,-1,,1639,281,0.0
5,1,92,1,2,1,5,1624,33,15,95,(See,1639,38,0.0
5,1,92,1,2,2,44,1624,69,12,96,enclosed,1636,113,0.0
5,1,92,1,2,3,120,1624,49,12,96,Notice,1636,169,0.0
5,1,92,1,2,4,174,1624,16,12,96,to,1636,190,0.0
5,1,92,1,2,5,196,1624,85,15,95,Employee.),1639,281,0.0
2,1,93,0,0,0,926,1596,82,12,-1,,1608,1008,0.0
3,1,93,1,0,0,926,1596,82,12,-1,,1608,1008,0.0
4,1,93,1,1,0,926,1596,82,12,-1,,1608,1008,0.0
5,1,93,1,1,1,926,1596,44,12,95,FAST!,1608,970,0.0
5,1,93,1,1,2,980,1596,28,12,96,Use,1608,1008,0.0
2,1,94,0,0,0,1048,1578,134,33,-1,,1611,1182,0.0
3,1,94,1,0,0,1048,1578,134,33,-1,,1611,1182,0.0
4,1,94,1,1,0,1048,1578,134,33,-1,,1611,1182,0.0
5,1,94,1,1,1,1044,1574,48,52,30,Pe,1626,1092,0.0
5,1,94,1,1,2,1113,1574,48,52,51,file,1626,1161,0.0
5,1,94,1,1,3,1173,1574,10,52,19,|,1626,1183,0.0
1,1,0,0,0,0,0,0,1236,1658,-1,,1658,1236,0.0
2,1,1,0,0,0,596,1,1,50,-1,,51,597,0.0
3,1,1,1,0,0,596,1,1,50,-1,,51,597,0.0
4,1,1,1,1,0,596,1,1,50,-1,,51,597,0.0
5,1,1,1,1,1,596,1,1,50,95, ,51,597,0.0
2,1,2,0,0,0,1,50,658,3,-1,,53,659,0.0
3,1,2,1,0,0,1,50,658,3,-1,,53,659,0.0
4,1,2,1,1,0,1,50,658,3,-1,,53,659,0.0
5,1,2,1,1,1,1,50,658,3,95, ,53,659,0.0
2,1,3,0,0,0,1,102,658,3,-1,,105,659,0.0
3,1,3,1,0,0,1,102,658,3,-1,,105,659,0.0
4,1,3,1,1,0,1,102,658,3,-1,,105,659,0.0
5,1,3,1,1,1,1,102,658,3,95, ,105,659,0.0
2,1,4,0,0,0,660,154,576,3,-1,,157,1236,0.0
3,1,4,1,0,0,660,154,576,3,-1,,157,1236,0.0
4,1,4,1,1,0,660,154,576,3,-1,,157,1236,0.0
5,1,4,1,1,1,660,154,576,3,95, ,157,1236,0.0
2,1,5,0,0,0,660,205,576,3,-1,,208,1236,0.0
3,1,5,1,0,0,660,205,576,3,-1,,208,1236,0.0
4,1,5,1,1,0,660,205,576,3,-1,,208,1236,0.0
5,1,5,1,1,1,660,205,576,3,95, ,208,1236,0.0
2,1,6,0,0,0,1,256,658,3,-1,,259,659,0.0
3,1,6,1,0,0,1,256,658,3,-1,,259,659,0.0
4,1,6,1,1,0,1,256,658,3,-1,,259,659,0.0
5,1,6,1,1,1,1,256,658,3,95, ,259,659,0.0
2,1,7,0,0,0,1,308,658,3,-1,,311,659,0.0
3,1,7,1,0,0,1,308,658,3,-1,,311,659,0.0
4,1,7,1,1,0,1,308,658,3,-1,,311,659,0.0
5,1,7,1,1,1,1,308,658,3,95, ,311,659,0.0
2,1,8,0,0,0,11,3,1182,555,-1,,558,1193,0.0
3,1,8,1,0,0,11,3,1182,555,-1,,558,1193,0.0
4,1,8,1,1,0,55,3,1138,17,-1,,20,1193,0.0
5,1,8,1,1,1,55,5,103,15,91,REISSUED,20,158,0.0
5,1,8,1,1,2,216,7,6,7,32,{a,14,222,0.0
5,1,8,1,1,3,236,0,70,24,67,Employee's,24,306,0.0
5,1,8,1,1,4,312,4,35,10,96,social,14,347,0.0
5,1,8,1,1,5,352,4,48,13,95,security,17,400,0.0
5,1,8,1,1,6,406,4,48,10,95,number,14,454,0.0
5,1,8,1,1,7,782,3,35,14,96,"Safe,",17,817,0.0
5,1,8,1,1,8,822,3,71,14,96,"Accurate,",17,893,0.0
5,1,8,1,1,9,1043,0,35,26,95,Visit,26,1078,0.0
5,1,8,1,1,10,1084,4,18,12,95,the,16,1102,0.0
5,1,8,1,1,11,1108,4,23,12,96,IRS,16,1131,0.0
5,1,8,1,1,12,1136,4,57,12,96,Website,16,1193,0.0
4,1,8,1,2,0,44,6,1136,45,-1,,51,1180,0.0
5,1,8,1,2,1,44,18,126,33,96,STATEMENT,51,170,0.0
5,1,8,1,2,2,312,28,151,15,89,037-07-1416,43,463,0.0
5,1,8,1,2,3,612,29,28,10,93,OMB,39,640,0.0
5,1,8,1,2,4,646,29,14,10,93,No.,39,660,0.0
5,1,8,1,2,5,671,29,57,10,69,1646-0008,39,728,0.0
5,1,8,1,2,6,781,28,44,12,94,FAST!,40,825,0.0
5,1,8,1,2,7,835,28,28,12,94,Use,40,863,0.0
5,1,8,1,2,8,900,6,120,45,0,e-file,51,1020,0.0
5,1,8,1,2,9,1031,6,12,45,0,),51,1043,0.0
5,1,8,1,2,10,1048,30,12,11,93,at,41,1060,0.0
5,1,8,1,2,11,1069,29,111,15,64,www.irs.goviefile.,44,1180,0.0
4,1,8,1,3,0,12,56,1143,13,-1,,69,1155,0.0
5,1,8,1,3,1,12,56,7,10,79,b,66,19,0.0
5,1,8,1,3,2,29,56,54,13,90,Employer,69,83,0.0
5,1,8,1,3,3,88,56,70,10,95,identification,66,158,0.0
5,1,8,1,3,4,164,56,42,10,96,number,66,206,0.0
5,1,8,1,3,5,681,56,4,10,70,1,66,685,0.0
5,1,8,1,3,6,704,56,40,13,79,"Wages,",69,744,0.0
5,1,8,1,3,7,753,57,24,12,95,"tips,",69,777,0.0
5,1,8,1,3,8,783,56,28,10,96,other,66,811,0.0
5,1,8,1,3,9,819,48,76,26,96,compensation,74,895,0.0
5,1,8,1,3,10,970,56,7,10,31,2,66,977,0.0
5,1,8,1,3,11,995,56,41,10,83,Federal,66,1036,0.0
5,1,8,1,3,12,1042,59,40,7,96,income,66,1082,0.0
5,1,8,1,3,13,1087,57,18,9,96,tax,66,1105,0.0
5,1,8,1,3,14,1109,56,46,10,96,withheld,66,1155,0.0
4,1,8,1,4,0,66,80,1028,15,-1,,95,1094,0.0
5,1,8,1,4,1,66,80,136,15,90,71-6374971,95,202,0.0
5,1,8,1,4,2,724,80,123,15,90,249501.21,95,847,0.0
5,1,8,1,4,3,985,80,109,15,86,26149.11,95,1094,0.0
4,1,8,1,5,0,13,108,1139,13,-1,,121,1152,0.0
5,1,8,1,5,1,13,111,6,7,48,ยข,118,19,0.0
5,1,8,1,5,2,29,108,62,13,94,Employers,121,91,0.0
5,1,8,1,5,3,97,111,30,7,87,"name,",118,127,0.0
5,1,8,1,5,4,137,108,44,10,90,"address,",118,181,0.0
5,1,8,1,5,5,191,108,19,10,96,and,118,210,0.0
5,1,8,1,5,6,215,108,18,10,96,ZIP,118,233,0.0
5,1,8,1,5,7,239,108,26,10,96,code,118,265,0.0
5,1,8,1,5,8,681,108,6,10,69,3,118,687,0.0
5,1,8,1,5,9,705,108,34,10,89,Social,118,739,0.0
5,1,8,1,5,10,747,100,43,25,93,security,125,790,0.0
5,1,8,1,5,11,797,111,33,10,96,wages,121,830,0.0
5,1,8,1,5,12,970,108,7,10,66,4,118,977,0.0
5,1,8,1,5,13,995,108,34,10,71,Social,118,1029,0.0
5,1,8,1,5,14,1035,108,117,13,96,security,121,1152,0.0
5,1,8,1,5,15,1084,100,18,25,96,tax,125,1102,0.0
5,1,8,1,5,16,1107,108,45,13,96,withheld,121,1152,0.0
4,1,8,1,6,0,65,133,1029,20,-1,,153,1094,0.0
5,1,8,1,6,1,65,133,264,15,91,Frederick-Hendricks,148,329,0.0
5,1,8,1,6,2,345,134,69,19,96,Group,153,414,0.0
5,1,8,1,6,3,724,133,123,15,91,254242.78,148,847,0.0
5,1,8,1,6,4,986,133,108,15,90,19449.57,148,1094,0.0
4,1,8,1,7,0,66,159,1053,23,-1,,182,1119,0.0
5,1,8,1,7,1,66,167,66,15,96,01670,182,132,0.0
5,1,8,1,7,2,147,167,70,15,96,Adams,182,217,0.0
5,1,8,1,7,3,234,167,95,15,96,Islands,182,329,0.0
5,1,8,1,7,4,681,159,6,10,72,5,169,687,0.0
5,1,8,1,7,5,705,159,51,10,81,Medicare,169,756,0.0
5,1,8,1,7,6,761,162,36,10,96,wages,172,797,0.0
5,1,8,1,7,7,803,159,19,10,89,and,169,822,0.0
5,1,8,1,7,8,827,160,20,12,89,tips,172,847,0.0
5,1,8,1,7,9,970,159,6,10,70,6,169,976,0.0
5,1,8,1,7,10,995,159,51,10,73,Medicare,169,1046,0.0
5,1,8,1,7,11,1051,160,18,9,96,tax,169,1069,0.0
5,1,8,1,7,12,1073,159,46,10,96,withheld,169,1119,0.0
4,1,8,1,8,0,724,184,421,15,-1,,199,1145,0.0
5,1,8,1,8,1,724,184,124,15,91,224061.76,199,848,0.0
5,1,8,1,8,2,1050,184,95,15,94,6497.79,199,1145,0.0
4,1,8,1,9,0,59,197,1013,33,-1,,230,1072,0.0
5,1,8,1,9,1,59,197,145,33,91,Angelatown,230,204,0.0
5,1,8,1,9,2,273,202,28,14,65,AZ,216,301,0.0
5,1,8,1,9,3,324,197,9,33,52,=,230,333,0.0
5,1,8,1,9,4,345,201,137,15,52,21706-7217,216,482,0.0
5,1,8,1,9,5,681,210,5,10,69,7,220,686,0.0
5,1,8,1,9,6,705,210,34,10,69,Social,220,739,0.0
5,1,8,1,9,7,746,211,42,12,55,security,223,788,0.0
5,1,8,1,9,8,795,211,19,12,84,tps,223,814,0.0
5,1,8,1,9,9,970,210,6,10,22,@,220,976,0.0
5,1,8,1,9,10,994,210,53,10,87,Allocated,220,1047,0.0
5,1,8,1,9,11,1052,211,20,12,90,tips,223,1072,0.0
4,1,8,1,10,0,724,235,447,15,-1,,250,1171,0.0
5,1,8,1,10,1,724,235,123,15,90,254242.78,250,847,0.0
5,1,8,1,10,2,1049,235,122,15,92,224061.76,250,1171,0.0
4,1,8,1,11,0,11,262,1122,13,-1,,275,1133,0.0
5,1,8,1,11,1,11,262,57,10,0,โd-Control,272,68,0.0
5,1,8,1,11,2,74,262,42,10,96,number,272,116,0.0
5,1,8,1,11,3,680,262,7,10,65,9,272,687,0.0
5,1,8,1,11,4,704,262,48,10,70,Advance,272,752,0.0
5,1,8,1,11,5,758,262,19,10,92,EIC,272,777,0.0
5,1,8,1,11,6,783,263,48,12,96,payment,275,831,0.0
5,1,8,1,11,7,964,262,13,10,80,10,272,977,0.0
5,1,8,1,11,8,995,262,60,13,75,Dependent,275,1055,0.0
5,1,8,1,11,9,1061,265,23,7,96,care,272,1084,0.0
5,1,8,1,11,10,1090,262,43,10,93,benefits,272,1133,0.0
4,1,8,1,12,0,66,286,1022,15,-1,,301,1088,0.0
5,1,8,1,12,1,66,286,80,15,96,343207,301,146,0.0
5,1,8,1,12,2,1050,286,38,15,96,150,301,1088,0.0
4,1,8,1,13,0,12,313,1163,13,-1,,326,1175,0.0
5,1,8,1,13,1,29,313,65,13,81,Employee's,326,94,0.0
5,1,8,1,13,2,99,313,20,10,94,first,323,119,0.0
5,1,8,1,13,3,125,316,30,7,94,name,323,155,0.0
5,1,8,1,13,4,161,313,19,10,96,and,323,180,0.0
5,1,8,1,13,5,186,313,28,10,95,initial,323,214,0.0
5,1,8,1,13,6,280,313,23,10,95,Last,323,303,0.0
5,1,8,1,13,7,309,316,30,7,94,name,323,339,0.0
5,1,8,1,13,8,674,313,11,10,56,71,323,685,0.0
5,1,8,1,13,9,705,313,68,13,69,Nonqualified,326,773,0.0
5,1,8,1,13,10,779,313,29,13,65,"plans,",326,808,0.0
5,1,8,1,13,11,966,313,20,10,36,12a,323,986,0.0
5,1,8,1,13,12,1009,313,22,10,64,See,323,1031,0.0
5,1,8,1,13,13,1037,313,71,10,95,instructions,323,1108,0.0
5,1,8,1,13,14,1112,313,17,10,96,for,323,1129,0.0
5,1,8,1,13,15,1134,313,22,10,96,box,323,1156,0.0
5,1,8,1,13,16,1162,313,13,10,91,12,323,1175,0.0
4,1,8,1,14,0,214,344,888,17,-1,,361,1102,0.0
5,1,8,1,14,1,214,358,3,3,3,r,361,217,0.0
5,1,8,1,14,2,262,358,3,3,0,r,361,265,0.0
5,1,8,1,14,3,725,344,38,15,96,164,359,763,0.0
5,1,8,1,14,4,1006,345,13,14,86,G,359,1019,0.0
5,1,8,1,14,5,1050,344,52,15,83,|6331,359,1102,0.0
4,1,8,1,15,0,66,354,921,31,-1,,385,987,0.0
5,1,8,1,15,1,66,359,76,16,96,James,375,142,0.0
5,1,8,1,15,2,192,354,126,31,96,Williams,385,318,0.0
5,1,8,1,15,3,674,370,13,10,61,1B,380,687,0.0
5,1,8,1,15,4,693,371,43,10,46,Slatutory,381,736,0.0
5,1,8,1,15,5,780,371,50,8,21,___Retrement,379,830,0.0
5,1,8,1,15,6,866,371,53,10,0,___Threhparky,381,919,0.0
5,1,8,1,15,7,966,370,21,10,58,1,380,987,0.0
4,1,8,1,16,0,693,385,213,9,-1,,394,906,0.0
5,1,8,1,16,1,693,385,45,9,18,empoyee,394,738,0.0
5,1,8,1,16,2,780,385,18,9,40,plan,394,798,0.0
5,1,8,1,16,3,867,385,18,8,85,sick,393,885,0.0
5,1,8,1,16,4,895,387,11,7,85,pay,394,906,0.0
4,1,8,1,17,0,67,396,1021,22,-1,,418,1088,0.0
5,1,8,1,17,1,67,396,75,17,96,95060,413,142,1.0
5,1,8,1,17,2,161,396,109,22,95,Crystal,418,270,1.0
5,1,8,1,17,3,288,397,64,21,96,Burg,418,352,1.0
5,1,8,1,17,4,367,397,59,21,95,Apt.,418,426,1.0
5,1,8,1,17,5,450,396,44,17,96,070,413,494,1.0
5,1,8,1,17,6,699,402,10,11,94,x,413,709,0.0
5,1,8,1,17,7,1005,399,13,14,89,E,413,1018,0.0
5,1,8,1,17,8,1050,398,38,15,91,|120,413,1088,0.0
4,1,8,1,18,0,64,427,922,30,-1,,457,986,0.0
5,1,8,1,18,1,64,435,62,17,96,Davi,452,126,0.0
5,1,8,1,18,2,130,435,94,22,91,sburgh,457,224,0.0
5,1,8,1,18,3,303,436,34,16,95,AR,452,337,1.0
5,1,8,1,18,4,354,435,156,17,96,30937-0798,452,510,0.0
5,1,8,1,18,5,674,427,13,10,49,44,437,687,0.0
5,1,8,1,18,6,705,427,31,10,81,Other,437,736,0.0
5,1,8,1,18,7,741,427,23,13,86,(see,440,764,0.0
5,1,8,1,18,8,770,427,50,10,96,enclosed,437,820,0.0
5,1,8,1,18,9,826,427,35,10,96,Notice,437,861,0.0
5,1,8,1,18,10,866,428,10,9,96,to,437,876,0.0
5,1,8,1,18,11,882,427,61,13,94,Employee),440,943,0.0
5,1,8,1,18,12,949,419,11,25,46,|,444,960,0.0
5,1,8,1,18,13,966,427,20,10,38,12c,437,986,0.0
4,1,8,1,19,0,1050,458,38,15,-1,,473,1088,0.0
5,1,8,1,19,1,1050,458,38,15,94,738,473,1088,0.0
4,1,8,1,20,0,966,484,20,10,-1,,494,986,0.0
5,1,8,1,20,1,966,484,20,10,88,12d,494,986,0.0
4,1,8,1,21,0,1049,515,39,15,-1,,530,1088,0.0
5,1,8,1,21,1,1049,515,39,15,96,278,530,1088,0.0
4,1,8,1,22,0,11,545,213,13,-1,,558,224,0.0
5,1,8,1,22,1,11,545,5,10,91,f,555,16,0.0
5,1,8,1,22,2,29,545,65,13,53,Employee's,558,94,0.0
5,1,8,1,22,3,100,545,44,10,91,address,555,144,0.0
5,1,8,1,22,4,150,545,19,10,96,and,555,169,0.0
5,1,8,1,22,5,174,545,18,10,94,ZIP,555,192,0.0
5,1,8,1,22,6,197,545,27,10,96,code,555,224,0.0
2,1,9,0,0,0,660,365,576,3,-1,,368,1236,0.0
3,1,9,1,0,0,660,365,576,3,-1,,368,1236,0.0
4,1,9,1,1,0,660,365,576,3,-1,,368,1236,0.0
5,1,9,1,1,1,660,365,576,3,95, ,368,1236,0.0
2,1,10,0,0,0,689,394,204,1,-1,,395,893,0.0
3,1,10,1,0,0,689,394,204,1,-1,,395,893,0.0
4,1,10,1,1,0,689,394,204,1,-1,,395,893,0.0
5,1,10,1,1,1,689,394,204,1,95, ,395,893,0.0
2,1,11,0,0,0,689,394,1,28,-1,,422,690,0.0
3,1,11,1,0,0,689,394,1,28,-1,,422,690,0.0
4,1,11,1,1,0,689,394,1,28,-1,,422,690,0.0
5,1,11,1,1,1,689,394,1,28,95, ,422,690,0.0
2,1,12,0,0,0,718,394,1,28,-1,,422,719,0.0
3,1,12,1,0,0,718,394,1,28,-1,,422,719,0.0
4,1,12,1,1,0,718,394,1,28,-1,,422,719,0.0
5,1,12,1,1,1,718,394,1,28,95, ,422,719,0.0
2,1,13,0,0,0,776,394,1,28,-1,,422,777,0.0
3,1,13,1,0,0,776,394,1,28,-1,,422,777,0.0
4,1,13,1,1,0,776,394,1,28,-1,,422,777,0.0
5,1,13,1,1,1,776,394,1,28,95, ,422,777,0.0
2,1,14,0,0,0,805,394,1,28,-1,,422,806,0.0
3,1,14,1,0,0,805,394,1,28,-1,,422,806,0.0
4,1,14,1,1,0,805,394,1,28,-1,,422,806,0.0
5,1,14,1,1,1,805,394,1,28,95, ,422,806,0.0
2,1,15,0,0,0,863,394,1,28,-1,,422,864,0.0
3,1,15,1,0,0,863,394,1,28,-1,,422,864,0.0
4,1,15,1,1,0,863,394,1,28,-1,,422,864,0.0
5,1,15,1,1,1,863,394,1,28,95, ,422,864,0.0
2,1,16,0,0,0,892,394,1,28,-1,,422,893,0.0
3,1,16,1,0,0,892,394,1,28,-1,,422,893,0.0
4,1,16,1,1,0,892,394,1,28,-1,,422,893,0.0
5,1,16,1,1,1,892,394,1,28,95, ,422,893,0.0
2,1,17,0,0,0,660,420,576,5,-1,,425,1236,0.0
3,1,17,1,0,0,660,420,576,5,-1,,425,1236,0.0
4,1,17,1,1,0,660,420,576,5,-1,,425,1236,0.0
5,1,17,1,1,1,660,420,576,5,95, ,425,1236,0.0
2,1,18,0,0,0,689,420,547,5,-1,,425,1236,0.0
3,1,18,1,0,0,689,420,547,5,-1,,425,1236,0.0
4,1,18,1,1,0,689,420,547,5,-1,,425,1236,0.0
5,1,18,1,1,1,689,420,547,5,95, ,425,1236,0.0
2,1,19,0,0,0,689,420,547,5,-1,,425,1236,0.0
3,1,19,1,0,0,689,420,547,5,-1,,425,1236,0.0
4,1,19,1,1,0,689,420,547,5,-1,,425,1236,0.0
5,1,19,1,1,1,689,420,547,5,95, ,425,1236,0.0
2,1,20,0,0,0,689,420,547,5,-1,,425,1236,0.0
3,1,20,1,0,0,689,420,547,5,-1,,425,1236,0.0
4,1,20,1,1,0,689,420,547,5,-1,,425,1236,0.0
5,1,20,1,1,1,689,420,547,5,95, ,425,1236,0.0
2,1,21,0,0,0,950,479,286,3,-1,,482,1236,0.0
3,1,21,1,0,0,950,479,286,3,-1,,482,1236,0.0
4,1,21,1,1,0,950,479,286,3,-1,,482,1236,0.0
5,1,21,1,1,1,950,479,286,3,95, ,482,1236,0.0
2,1,22,0,0,0,1042,326,3,212,-1,,538,1045,0.0
3,1,22,1,0,0,1042,326,3,212,-1,,538,1045,0.0
4,1,22,1,1,0,1042,326,3,212,-1,,538,1045,0.0
5,1,22,1,1,1,1042,326,3,212,95, ,538,1045,0.0
2,1,23,0,0,0,950,536,286,3,-1,,539,1236,0.0
3,1,23,1,0,0,950,536,286,3,-1,,539,1236,0.0
4,1,23,1,1,0,950,536,286,3,-1,,539,1236,0.0
5,1,23,1,1,1,950,536,286,3,95, ,539,1236,0.0
2,1,24,0,0,0,659,105,3,454,-1,,559,662,0.0
3,1,24,1,0,0,659,105,3,454,-1,,559,662,0.0
4,1,24,1,1,0,659,105,3,454,-1,,559,662,0.0
5,1,24,1,1,1,659,105,3,454,95, ,559,662,0.0
2,1,25,0,0,0,949,105,3,454,-1,,559,952,0.0
3,1,25,1,0,0,949,105,3,454,-1,,559,952,0.0
4,1,25,1,1,0,949,105,3,454,-1,,559,952,0.0
5,1,25,1,1,1,949,105,3,454,95, ,559,952,0.0
2,1,26,0,0,0,1,556,1235,5,-1,,561,1236,0.0
3,1,26,1,0,0,1,556,1235,5,-1,,561,1236,0.0
4,1,26,1,1,0,1,556,1235,5,-1,,561,1236,0.0
5,1,26,1,1,1,1,556,1235,5,95, ,561,1236,0.0
2,1,27,0,0,0,6,562,52,40,-1,,602,58,0.0
3,1,27,1,0,0,6,562,52,40,-1,,602,58,0.0
4,1,27,1,1,0,6,562,52,10,-1,,572,58,0.0
5,1,27,1,1,1,6,562,13,10,85,15,572,19,0.0
5,1,27,1,1,2,29,562,29,10,85,State,572,58,0.0
4,1,27,1,2,0,16,588,27,14,-1,,602,43,0.0
5,1,27,1,2,1,16,588,27,14,96,NE,602,43,0.0
2,1,28,0,0,0,88,562,159,13,-1,,575,247,0.0
3,1,28,1,0,0,88,562,159,13,-1,,575,247,0.0
4,1,28,1,1,0,88,562,159,13,-1,,575,247,0.0
5,1,28,1,1,1,88,562,62,13,63,Employer's,575,150,0.0
5,1,28,1,1,2,156,563,27,9,94,state,572,183,0.0
5,1,28,1,1,3,189,562,10,10,85,ID,572,199,0.0
5,1,28,1,1,4,205,562,42,10,96,number,572,247,0.0
2,1,29,0,0,0,132,587,137,15,-1,,602,269,0.0
3,1,29,1,0,0,132,587,137,15,-1,,602,269,0.0
4,1,29,1,1,0,132,587,137,15,-1,,602,269,0.0
5,1,29,1,1,1,132,587,137,15,89,112-76-689,602,269,0.0
2,1,30,0,0,0,349,562,146,13,-1,,575,495,0.0
3,1,30,1,0,0,349,562,146,13,-1,,575,495,0.0
4,1,30,1,1,0,349,562,146,13,-1,,575,495,0.0
5,1,30,1,1,1,349,562,12,10,54,16,572,361,0.0
5,1,30,1,1,2,370,562,29,10,91,State,572,399,0.0
5,1,30,1,1,3,404,565,36,10,85,"wages,",575,440,0.0
5,1,30,1,1,4,449,563,20,12,93,"tips,",575,469,0.0
5,1,30,1,1,5,479,563,16,9,76,etc,572,495,0.0
2,1,31,0,0,0,347,587,122,15,-1,,602,469,0.0
3,1,31,1,0,0,347,587,122,15,-1,,602,469,0.0
4,1,31,1,1,0,347,587,122,15,-1,,602,469,0.0
5,1,31,1,1,1,347,587,122,15,91,124132.88,602,469,0.0
2,1,32,0,0,0,3,608,1233,3,-1,,611,1236,0.0
3,1,32,1,0,0,3,608,1233,3,-1,,611,1236,0.0
4,1,32,1,1,0,3,608,1233,3,-1,,611,1236,0.0
5,1,32,1,1,1,3,608,1233,3,95, ,611,1236,0.0
2,1,33,0,0,0,59,558,1,103,-1,,661,60,0.0
3,1,33,1,0,0,59,558,1,103,-1,,661,60,0.0
4,1,33,1,1,0,59,558,1,103,-1,,661,60,0.0
5,1,33,1,1,1,59,558,1,103,95, ,661,60,0.0
2,1,34,0,0,0,340,558,1,103,-1,,661,341,0.0
3,1,34,1,0,0,340,558,1,103,-1,,661,341,0.0
4,1,34,1,1,0,340,558,1,103,-1,,661,341,0.0
5,1,34,1,1,1,340,558,1,103,95, ,661,341,0.0
2,1,35,0,0,0,532,558,1,103,-1,,661,533,0.0
3,1,35,1,0,0,532,558,1,103,-1,,661,533,0.0
4,1,35,1,1,0,532,558,1,103,-1,,661,533,0.0
5,1,35,1,1,1,532,558,1,103,95, ,661,533,0.0
2,1,36,0,0,0,541,562,119,10,-1,,572,660,0.0
3,1,36,1,0,0,541,562,119,10,-1,,572,660,0.0
4,1,36,1,1,0,541,562,119,10,-1,,572,660,0.0
5,1,36,1,1,1,541,562,11,10,62,TT,572,552,0.0
5,1,36,1,1,2,562,562,29,10,94,State,572,591,0.0
5,1,36,1,1,3,597,565,40,7,90,income,572,637,0.0
5,1,36,1,1,4,642,563,18,9,96,tax,572,660,0.0
2,1,37,0,0,0,539,587,94,15,-1,,602,633,0.0
3,1,37,1,0,0,539,587,94,15,-1,,602,633,0.0
4,1,37,1,1,0,539,587,94,15,-1,,602,633,0.0
5,1,37,1,1,1,539,587,94,15,96,6171.87,602,633,0.0
2,1,38,0,0,0,930,562,119,10,-1,,572,1049,0.0
3,1,38,1,0,0,930,562,119,10,-1,,572,1049,0.0
4,1,38,1,1,0,930,562,119,10,-1,,572,1049,0.0
5,1,38,1,1,1,930,562,11,10,76,19,572,941,0.0
5,1,38,1,1,2,951,562,29,10,90,Local,572,980,0.0
5,1,38,1,1,3,986,565,40,7,88,income,572,1026,0.0
5,1,38,1,1,4,1031,563,18,9,96,tax,572,1049,0.0
2,1,39,0,0,0,927,587,109,15,-1,,602,1036,0.0
3,1,39,1,0,0,927,587,109,15,-1,,602,1036,0.0
4,1,39,1,1,0,927,587,109,15,-1,,602,1036,0.0
5,1,39,1,1,1,927,587,109,15,92,28603.11,602,1036,0.0
2,1,40,0,0,0,726,562,147,13,-1,,575,873,0.0
3,1,40,1,0,0,726,562,147,13,-1,,575,873,0.0
4,1,40,1,1,0,726,562,147,13,-1,,575,873,0.0
5,1,40,1,1,1,726,562,12,10,76,78,572,738,0.0
5,1,40,1,1,2,748,562,29,10,93,Local,572,777,0.0
5,1,40,1,1,3,782,565,36,10,78,wages.,575,818,0.0
5,1,40,1,1,4,827,563,20,12,94,"tips,",575,847,0.0
5,1,40,1,1,5,857,563,16,9,75,ete,572,873,0.0
2,1,41,0,0,0,725,587,122,15,-1,,602,847,0.0
3,1,41,1,0,0,725,587,122,15,-1,,602,847,0.0
4,1,41,1,1,0,725,587,122,15,-1,,602,847,0.0
5,1,41,1,1,1,725,587,122,15,90,186737.87,602,847,0.0
2,1,42,0,0,0,1114,562,102,13,-1,,575,1216,0.0
3,1,42,1,0,0,1114,562,102,13,-1,,575,1216,0.0
4,1,42,1,1,0,1114,562,102,13,-1,,575,1216,0.0
5,1,42,1,1,1,1114,562,13,10,82,20,572,1127,0.0
5,1,42,1,1,2,1137,562,44,13,90,Locality,575,1181,0.0
5,1,42,1,1,3,1186,565,30,7,96,name,572,1216,0.0
2,1,43,0,0,0,1116,593,112,12,-1,,605,1228,0.0
3,1,43,1,0,0,1116,593,112,12,-1,,605,1228,0.0
4,1,43,1,1,0,1116,593,112,12,-1,,605,1228,0.0
5,1,43,1,1,1,1116,593,56,9,93,William,602,1172,0.0
5,1,43,1,1,2,1181,593,47,12,95,Spring,605,1228,0.0
2,1,44,0,0,0,1234,1,2,660,-1,,661,1236,0.0
3,1,44,1,0,0,1234,1,2,660,-1,,661,1236,0.0
4,1,44,1,1,0,1234,1,2,660,-1,,661,1236,0.0
5,1,44,1,1,1,1234,1,2,660,95, ,661,1236,0.0
2,1,45,0,0,0,717,394,3,267,-1,,661,720,0.0
3,1,45,1,0,0,717,394,3,267,-1,,661,720,0.0
4,1,45,1,1,0,717,394,3,267,-1,,661,720,0.0
5,1,45,1,1,1,717,394,3,267,95, ,661,720,0.0
2,1,46,0,0,0,921,558,1,103,-1,,661,922,0.0
3,1,46,1,0,0,921,558,1,103,-1,,661,922,0.0
4,1,46,1,1,0,921,558,1,103,-1,,661,922,0.0
5,1,46,1,1,1,921,558,1,103,95, ,661,922,0.0
2,1,47,0,0,0,1107,558,1,103,-1,,661,1108,0.0
3,1,47,1,0,0,1107,558,1,103,-1,,661,1108,0.0
4,1,47,1,1,0,1107,558,1,103,-1,,661,1108,0.0
5,1,47,1,1,1,1107,558,1,103,95, ,661,1108,0.0
2,1,48,0,0,0,1,658,1235,5,-1,,663,1236,0.0
3,1,48,1,0,0,1,658,1235,5,-1,,663,1236,0.0
4,1,48,1,1,0,1,658,1235,5,-1,,663,1236,0.0
5,1,48,1,1,1,1,658,1235,5,95, ,663,1236,0.0
2,1,49,0,0,0,4,638,1227,90,-1,,728,1231,0.0
3,1,49,1,0,0,4,638,1227,82,-1,,720,1231,0.0
4,1,49,1,1,0,17,638,1214,17,-1,,655,1231,0.0
5,1,49,1,1,1,17,639,28,14,96,PA,653,45,0.0
5,1,49,1,1,2,132,638,137,15,90,349-50-216,653,269,0.0
5,1,49,1,1,3,347,638,123,15,89,129509.36,653,470,0.0
5,1,49,1,1,4,539,638,95,15,96,8944.76,653,634,0.0
5,1,49,1,1,5,725,638,108,15,92,316985.0,653,833,0.0
5,1,49,1,1,6,928,638,108,15,92,38840.21,653,1036,0.0
5,1,49,1,1,7,1112,645,55,8,96,Ramirez,653,1167,0.0
5,1,49,1,1,8,1177,645,54,10,93,Passage,655,1231,0.0
4,1,49,1,2,0,139,670,1092,22,-1,,692,1231,0.0
5,1,49,1,2,1,139,670,63,22,96,Wage,692,202,0.0
5,1,49,1,2,2,211,670,41,17,96,and,687,252,0.0
5,1,49,1,2,3,261,670,40,17,96,Tax,687,301,0.0
5,1,49,1,2,4,864,675,81,15,96,Department,690,945,0.0
5,1,49,1,2,5,950,675,12,12,96,of,687,962,0.0
5,1,49,1,2,6,966,675,20,12,93,the,687,986,0.0
5,1,49,1,2,7,991,675,118,15,35,TreasuryโInternal,690,1109,0.0
5,1,49,1,2,8,1115,675,59,12,96,Revenue,687,1174,0.0
5,1,49,1,2,9,1180,675,51,12,97,Service,687,1231,0.0
4,1,49,1,3,0,4,677,689,51,-1,,728,693,0.0
5,1,49,1,3,1,4,709,34,11,93,Form,720,38,0.0
5,1,49,1,3,2,47,709,25,11,91,W-2,720,72,0.0
5,1,49,1,3,3,140,697,114,31,96,Statement,728,254,0.0
5,1,49,1,3,4,549,677,27,42,21,c,719,576,0.0
5,1,49,1,3,5,588,677,27,42,50,0,719,615,0.0
5,1,49,1,3,6,628,677,26,42,59,1,719,654,0.0
5,1,49,1,3,7,666,677,27,42,52,0,719,693,0.0
2,1,50,0,0,0,4,732,482,37,-1,,769,486,0.0
3,1,50,1,0,0,4,732,482,37,-1,,769,486,0.0
4,1,50,1,1,0,5,732,462,15,-1,,747,467,0.0
5,1,50,1,1,1,5,732,40,15,93,Copy,747,45,0.0
5,1,50,1,1,2,51,732,43,12,91,B--To,744,94,0.0
5,1,50,1,1,3,100,732,20,12,96,Be,744,120,0.0
5,1,50,1,1,4,126,732,35,12,95,Filed,744,161,0.0
5,1,50,1,1,5,167,732,32,12,96,with,744,199,0.0
5,1,50,1,1,6,206,732,87,15,85,Employee's,747,293,0.0
5,1,50,1,1,7,300,732,76,12,96,FEDERAL,744,376,0.0
5,1,50,1,1,8,382,732,27,12,95,Tax,744,409,0.0
5,1,50,1,1,9,415,732,52,12,96,Return,744,467,0.0
4,1,50,1,2,0,4,754,482,15,-1,,769,486,0.0
5,1,50,1,2,1,4,754,29,12,96,This,766,33,0.0
5,1,50,1,2,2,40,754,79,12,93,information,766,119,0.0
5,1,50,1,2,3,126,757,10,9,93,is,766,136,0.0
5,1,50,1,2,4,143,754,38,15,94,being,769,181,0.0
5,1,50,1,2,5,187,754,67,12,96,furnished,766,254,0.0
5,1,50,1,2,6,260,754,12,12,96,to,766,272,0.0
5,1,50,1,2,7,278,754,22,12,96,the,766,300,0.0
5,1,50,1,2,8,307,754,52,12,93,Internal,766,359,0.0
5,1,50,1,2,9,365,754,62,12,95,Revenue,766,427,0.0
5,1,50,1,2,10,433,754,53,12,96,Service,766,486,0.0
2,1,51,0,0,0,469,825,294,14,-1,,839,763,0.0
3,1,51,1,0,0,469,825,294,14,-1,,839,763,0.0
4,1,51,1,1,0,469,825,294,14,-1,,839,763,0.0
5,1,51,1,1,1,469,825,55,11,51,Tuthere.,836,524,0.0
5,1,51,1,1,2,537,825,32,14,92,Keep,839,569,0.0
5,1,51,1,1,3,575,825,34,11,94,lower,836,609,0.0
5,1,51,1,1,4,614,826,42,13,96,portion,839,656,0.0
5,1,51,1,1,5,661,825,17,11,72,for,836,678,0.0
5,1,51,1,1,6,682,828,28,11,94,your,839,710,0.0
5,1,51,1,1,7,715,825,48,11,67,records,836,763,0.0
2,1,52,0,0,0,1,872,1235,5,-1,,877,1236,0.0
3,1,52,1,0,0,1,872,1235,5,-1,,877,1236,0.0
4,1,52,1,1,0,1,872,1235,5,-1,,877,1236,0.0
5,1,52,1,1,1,1,872,1235,5,95, ,877,1236,0.0
2,1,53,0,0,0,212,874,1,52,-1,,926,213,0.0
3,1,53,1,0,0,212,874,1,52,-1,,926,213,0.0
4,1,53,1,1,0,212,874,1,52,-1,,926,213,0.0
5,1,53,1,1,1,212,874,1,52,95, ,926,213,0.0
2,1,54,0,0,0,596,874,1,52,-1,,926,597,0.0
3,1,54,1,0,0,596,874,1,52,-1,,926,597,0.0
4,1,54,1,1,0,596,874,1,52,-1,,926,597,0.0
5,1,54,1,1,1,596,874,1,52,95, ,926,597,0.0
2,1,55,0,0,0,1,923,1235,5,-1,,928,1236,0.0
3,1,55,1,0,0,1,923,1235,5,-1,,928,1236,0.0
4,1,55,1,1,0,1,923,1235,5,-1,,928,1236,0.0
5,1,55,1,1,1,1,923,1235,5,95, ,928,1236,0.0
2,1,56,0,0,0,1,974,1235,5,-1,,979,1236,0.0
3,1,56,1,0,0,1,974,1235,5,-1,,979,1236,0.0
4,1,56,1,1,0,1,974,1235,5,-1,,979,1236,0.0
5,1,56,1,1,1,1,974,1235,5,95, ,979,1236,0.0
2,1,57,0,0,0,660,1026,576,3,-1,,1029,1236,0.0
3,1,57,1,0,0,660,1026,576,3,-1,,1029,1236,0.0
4,1,57,1,1,0,660,1026,576,3,-1,,1029,1236,0.0
5,1,57,1,1,1,660,1026,576,3,95, ,1029,1236,0.0
2,1,58,0,0,0,660,1077,576,3,-1,,1080,1236,0.0
3,1,58,1,0,0,660,1077,576,3,-1,,1080,1236,0.0
4,1,58,1,1,0,660,1077,576,3,-1,,1080,1236,0.0
5,1,58,1,1,1,660,1077,576,3,95, ,1080,1236,0.0
2,1,59,0,0,0,1,1127,1235,5,-1,,1132,1236,0.0
3,1,59,1,0,0,1,1127,1235,5,-1,,1132,1236,0.0
4,1,59,1,1,0,1,1127,1235,5,-1,,1132,1236,0.0
5,1,59,1,1,1,1,1127,1235,5,95, ,1132,1236,0.0
2,1,60,0,0,0,1,1178,1235,5,-1,,1183,1236,0.0
3,1,60,1,0,0,1,1178,1235,5,-1,,1183,1236,0.0
4,1,60,1,1,0,1,1178,1235,5,-1,,1183,1236,0.0
5,1,60,1,1,1,1,1178,1235,5,95, ,1183,1236,0.0
2,1,61,0,0,0,660,1236,576,3,-1,,1239,1236,0.0
3,1,61,1,0,0,660,1236,576,3,-1,,1239,1236,0.0
4,1,61,1,1,0,660,1236,576,3,-1,,1239,1236,0.0
5,1,61,1,1,1,660,1236,576,3,95, ,1239,1236,0.0
2,1,62,0,0,0,689,1267,204,1,-1,,1268,893,0.0
3,1,62,1,0,0,689,1267,204,1,-1,,1268,893,0.0
4,1,62,1,1,0,689,1267,204,1,-1,,1268,893,0.0
5,1,62,1,1,1,689,1267,204,1,95, ,1268,893,0.0
2,1,63,0,0,0,688,1267,3,28,-1,,1295,691,0.0
3,1,63,1,0,0,688,1267,3,28,-1,,1295,691,0.0
4,1,63,1,1,0,688,1267,3,28,-1,,1295,691,0.0
5,1,63,1,1,1,688,1267,3,28,95, ,1295,691,0.0
2,1,64,0,0,0,717,1267,3,28,-1,,1295,720,0.0
3,1,64,1,0,0,717,1267,3,28,-1,,1295,720,0.0
4,1,64,1,1,0,717,1267,3,28,-1,,1295,720,0.0
5,1,64,1,1,1,717,1267,3,28,95, ,1295,720,0.0
2,1,65,0,0,0,775,1267,3,28,-1,,1295,778,0.0
3,1,65,1,0,0,775,1267,3,28,-1,,1295,778,0.0
4,1,65,1,1,0,775,1267,3,28,-1,,1295,778,0.0
5,1,65,1,1,1,775,1267,3,28,95, ,1295,778,0.0
2,1,66,0,0,0,804,1267,3,28,-1,,1295,807,0.0
3,1,66,1,0,0,804,1267,3,28,-1,,1295,807,0.0
4,1,66,1,1,0,804,1267,3,28,-1,,1295,807,0.0
5,1,66,1,1,1,804,1267,3,28,95, ,1295,807,0.0
2,1,67,0,0,0,862,1267,3,28,-1,,1295,865,0.0
3,1,67,1,0,0,862,1267,3,28,-1,,1295,865,0.0
4,1,67,1,1,0,862,1267,3,28,-1,,1295,865,0.0
5,1,67,1,1,1,862,1267,3,28,95, ,1295,865,0.0
2,1,68,0,0,0,891,1267,3,28,-1,,1295,894,0.0
3,1,68,1,0,0,891,1267,3,28,-1,,1295,894,0.0
4,1,68,1,1,0,891,1267,3,28,-1,,1295,894,0.0
5,1,68,1,1,1,891,1267,3,28,95, ,1295,894,0.0
2,1,69,0,0,0,660,1293,576,5,-1,,1298,1236,0.0
3,1,69,1,0,0,660,1293,576,5,-1,,1298,1236,0.0
4,1,69,1,1,0,660,1293,576,5,-1,,1298,1236,0.0
5,1,69,1,1,1,660,1293,576,5,95, ,1298,1236,0.0
2,1,70,0,0,0,659,925,3,507,-1,,1432,662,0.0
3,1,70,1,0,0,659,925,3,507,-1,,1432,662,0.0
4,1,70,1,1,0,659,925,3,507,-1,,1432,662,0.0
5,1,70,1,1,1,659,925,3,507,95, ,1432,662,0.0
2,1,71,0,0,0,689,1293,547,5,-1,,1298,1236,0.0
3,1,71,1,0,0,689,1293,547,5,-1,,1298,1236,0.0
4,1,71,1,1,0,689,1293,547,5,-1,,1298,1236,0.0
5,1,71,1,1,1,689,1293,547,5,95, ,1298,1236,0.0
2,1,72,0,0,0,689,1293,547,5,-1,,1298,1236,0.0
3,1,72,1,0,0,689,1293,547,5,-1,,1298,1236,0.0
4,1,72,1,1,0,689,1293,547,5,-1,,1298,1236,0.0
5,1,72,1,1,1,689,1293,547,5,95, ,1298,1236,0.0
2,1,73,0,0,0,689,1293,547,5,-1,,1298,1236,0.0
3,1,73,1,0,0,689,1293,547,5,-1,,1298,1236,0.0
4,1,73,1,1,0,689,1293,547,5,-1,,1298,1236,0.0
5,1,73,1,1,1,689,1293,547,5,95, ,1298,1236,0.0
2,1,74,0,0,0,950,1352,286,3,-1,,1355,1236,0.0
3,1,74,1,0,0,950,1352,286,3,-1,,1355,1236,0.0
4,1,74,1,1,0,950,1352,286,3,-1,,1355,1236,0.0
5,1,74,1,1,1,950,1352,286,3,95, ,1355,1236,0.0
2,1,75,0,0,0,1042,1197,3,214,-1,,1411,1045,0.0
3,1,75,1,0,0,1042,1197,3,214,-1,,1411,1045,0.0
4,1,75,1,1,0,1042,1197,3,214,-1,,1411,1045,0.0
5,1,75,1,1,1,1042,1197,3,214,95, ,1411,1045,0.0
2,1,76,0,0,0,950,1409,286,3,-1,,1412,1236,0.0
3,1,76,1,0,0,950,1409,286,3,-1,,1412,1236,0.0
4,1,76,1,1,0,950,1409,286,3,-1,,1412,1236,0.0
5,1,76,1,1,1,950,1409,286,3,95, ,1412,1236,0.0
2,1,77,0,0,0,949,925,3,507,-1,,1432,952,0.0
3,1,77,1,0,0,949,925,3,507,-1,,1432,952,0.0
4,1,77,1,1,0,949,925,3,507,-1,,1432,952,0.0
5,1,77,1,1,1,949,925,3,507,95, ,1432,952,0.0
2,1,78,0,0,0,1,1429,1235,5,-1,,1434,1236,0.0
3,1,78,1,0,0,1,1429,1235,5,-1,,1434,1236,0.0
4,1,78,1,1,0,1,1429,1235,5,-1,,1434,1236,0.0
5,1,78,1,1,1,1,1429,1235,5,95, ,1434,1236,0.0
2,1,79,0,0,0,0,1478,1236,9,-1,,1487,1236,0.0
3,1,79,1,0,0,0,1478,1236,9,-1,,1487,1236,0.0
4,1,79,1,1,0,0,1478,1236,9,-1,,1487,1236,0.0
5,1,79,1,1,1,0,1478,1236,9,95, ,1487,1236,0.0
2,1,80,0,0,0,59,1431,1,104,-1,,1535,60,0.0
3,1,80,1,0,0,59,1431,1,104,-1,,1535,60,0.0
4,1,80,1,1,0,59,1431,1,104,-1,,1535,60,0.0
5,1,80,1,1,1,59,1431,1,104,95, ,1535,60,0.0
2,1,81,0,0,0,340,1431,1,104,-1,,1535,341,0.0
3,1,81,1,0,0,340,1431,1,104,-1,,1535,341,0.0
4,1,81,1,1,0,340,1431,1,104,-1,,1535,341,0.0
5,1,81,1,1,1,340,1431,1,104,95, ,1535,341,0.0
2,1,82,0,0,0,1,1530,341,9,-1,,1539,342,0.0
3,1,82,1,0,0,1,1530,341,9,-1,,1539,342,0.0
4,1,82,1,1,0,1,1530,341,9,-1,,1539,342,0.0
5,1,82,1,1,1,1,1530,341,9,95, ,1539,342,0.0
2,1,83,0,0,0,532,1431,1,104,-1,,1535,533,0.0
3,1,83,1,0,0,532,1431,1,104,-1,,1535,533,0.0
4,1,83,1,1,0,532,1431,1,104,-1,,1535,533,0.0
5,1,83,1,1,1,532,1431,1,104,95, ,1535,533,0.0
2,1,84,0,0,0,1234,874,2,661,-1,,1535,1236,0.0
3,1,84,1,0,0,1234,874,2,661,-1,,1535,1236,0.0
4,1,84,1,1,0,1234,874,2,661,-1,,1535,1236,0.0
5,1,84,1,1,1,1234,874,2,661,95, ,1535,1236,0.0
2,1,85,0,0,0,717,1267,3,268,-1,,1535,720,0.0
3,1,85,1,0,0,717,1267,3,268,-1,,1535,720,0.0
4,1,85,1,1,0,717,1267,3,268,-1,,1535,720,0.0
5,1,85,1,1,1,717,1267,3,268,95, ,1535,720,0.0
2,1,86,0,0,0,921,1431,1,104,-1,,1535,922,0.0
3,1,86,1,0,0,921,1431,1,104,-1,,1535,922,0.0
4,1,86,1,1,0,921,1431,1,104,-1,,1535,922,0.0
5,1,86,1,1,1,921,1431,1,104,95, ,1535,922,0.0
2,1,87,0,0,0,1107,1431,1,104,-1,,1535,1108,0.0
3,1,87,1,0,0,1107,1431,1,104,-1,,1535,1108,0.0
4,1,87,1,1,0,1107,1431,1,104,-1,,1535,1108,0.0
5,1,87,1,1,1,1107,1431,1,104,95, ,1535,1108,0.0
2,1,88,0,0,0,338,1532,898,5,-1,,1537,1236,0.0
3,1,88,1,0,0,338,1532,898,5,-1,,1537,1236,0.0
4,1,88,1,1,0,338,1532,898,5,-1,,1537,1236,0.0
5,1,88,1,1,1,338,1532,898,5,95, ,1537,1236,0.0
2,1,89,0,0,0,4,878,1228,717,-1,,1595,1232,0.0
3,1,89,1,0,0,4,878,1228,713,-1,,1591,1232,0.0
4,1,89,1,1,0,55,878,1137,16,-1,,894,1192,0.0
5,1,89,1,1,1,55,879,103,15,91,REISSUED,894,158,0.0
5,1,89,1,1,2,216,881,6,7,57,[a,888,222,0.0
5,1,89,1,1,3,236,878,71,13,32,Employee's,891,307,0.0
5,1,89,1,1,4,311,878,36,10,95,social,888,347,0.0
5,1,89,1,1,5,352,878,48,13,95,security,891,400,0.0
5,1,89,1,1,6,406,878,48,10,96,number,888,454,0.0
5,1,89,1,1,7,750,878,23,10,95,This,888,773,0.0
5,1,89,1,1,8,779,878,61,10,96,information,888,840,0.0
5,1,89,1,1,9,846,881,8,7,90,is,888,854,0.0
5,1,89,1,1,10,860,878,29,13,90,being,891,889,0.0
5,1,89,1,1,11,894,878,51,10,93,furnished,888,945,0.0
5,1,89,1,1,12,950,879,10,9,96,to,888,960,0.0
5,1,89,1,1,13,965,878,17,10,96,the,888,982,0.0
5,1,89,1,1,14,988,878,40,10,84,Internal,888,1028,0.0
5,1,89,1,1,15,1034,878,47,10,93,Revenue,888,1081,0.0
5,1,89,1,1,16,1087,878,40,10,74,Senice.,888,1127,0.0
5,1,89,1,1,17,1141,878,6,10,77,If,888,1147,0.0
5,1,89,1,1,18,1150,881,20,10,77,you,891,1170,0.0
5,1,89,1,1,19,1176,881,16,7,94,are,888,1192,0.0
4,1,89,1,2,0,12,929,1143,13,-1,,942,1155,0.0
5,1,89,1,2,1,12,929,7,10,4,'b,939,19,0.0
5,1,89,1,2,2,29,929,54,13,95,Employer,942,83,0.0
5,1,89,1,2,3,88,929,70,10,95,identification,939,158,0.0
5,1,89,1,2,4,164,929,42,10,93,number,939,206,0.0
5,1,89,1,2,5,681,929,4,10,62,1,939,685,0.0
5,1,89,1,2,6,704,929,40,13,68,Wages.,942,744,0.0
5,1,89,1,2,7,753,930,20,12,93,"tips,",942,773,0.0
5,1,89,1,2,8,783,929,28,10,92,other,939,811,0.0
5,1,89,1,2,9,816,930,79,12,92,compensation,942,895,0.0
5,1,89,1,2,10,970,929,7,10,0,2,939,977,0.0
5,1,89,1,2,11,995,929,41,10,82,Federal,939,1036,0.0
5,1,89,1,2,12,1042,932,40,7,96,income,939,1082,0.0
5,1,89,1,2,13,1087,930,17,9,96,tax,939,1104,0.0
5,1,89,1,2,14,1109,929,46,10,85,withheld,939,1155,0.0
4,1,89,1,3,0,66,954,1028,15,-1,,969,1094,0.0
5,1,89,1,3,1,66,954,136,15,90,71-6374971,969,202,0.0
5,1,89,1,3,2,724,954,123,15,91,249501.21,969,847,0.0
5,1,89,1,3,3,985,954,109,15,88,26149.11,969,1094,0.0
4,1,89,1,4,0,13,980,1139,13,-1,,993,1152,0.0
5,1,89,1,4,1,13,983,6,7,29,โยข,990,19,0.0
5,1,89,1,4,2,29,980,62,13,94,Employers,993,91,0.0
5,1,89,1,4,3,97,983,30,7,92,"name,",990,127,0.0
5,1,89,1,4,4,137,980,44,10,91,"address,",990,181,0.0
5,1,89,1,4,5,191,980,19,10,96,and,990,210,0.0
5,1,89,1,4,6,215,980,18,10,95,ZIP,990,233,0.0
5,1,89,1,4,7,239,980,26,10,96,code,990,265,0.0
5,1,89,1,4,8,681,980,6,10,65,3,990,687,0.0
5,1,89,1,4,9,705,980,34,10,87,Social,990,739,0.0
5,1,89,1,4,10,745,972,45,25,95,security,997,790,0.0
5,1,89,1,4,11,797,983,33,10,96,wages,993,830,0.0
5,1,89,1,4,12,970,980,7,10,53,4,990,977,0.0
5,1,89,1,4,13,995,980,34,10,80,Social,990,1029,0.0
5,1,89,1,4,14,1035,980,117,13,96,security,993,1152,0.0
5,1,89,1,4,15,1084,972,18,25,96,tax,997,1102,0.0
5,1,89,1,4,16,1107,980,45,13,96,withheld,993,1152,0.0
4,1,89,1,5,0,65,1005,1029,20,-1,,1025,1094,0.0
5,1,89,1,5,1,65,1005,264,15,91,Frederick-Hendricks,1020,329,0.0
5,1,89,1,5,2,345,1006,69,19,96,Group,1025,414,0.0
5,1,89,1,5,3,724,1005,123,15,91,254242.78,1020,847,0.0
5,1,89,1,5,4,986,1005,108,15,87,19449.57,1020,1094,0.0
4,1,89,1,6,0,66,1031,1053,23,-1,,1054,1119,0.0
5,1,89,1,6,1,66,1039,66,15,96,01670,1054,132,0.0
5,1,89,1,6,2,147,1039,29,15,51,Ad:,1054,176,0.0
5,1,89,1,6,3,234,1039,95,15,0,catends,1054,329,0.0
5,1,89,1,6,4,681,1031,6,10,68,5,1041,687,0.0
5,1,89,1,6,5,705,1031,51,10,82,Medicare,1041,756,0.0
5,1,89,1,6,6,761,1034,36,10,96,wages,1044,797,0.0
5,1,89,1,6,7,803,1031,19,10,91,and,1041,822,0.0
5,1,89,1,6,8,827,1032,20,12,91,tips,1044,847,0.0
5,1,89,1,6,9,970,1031,6,10,66,6,1041,976,0.0
5,1,89,1,6,10,995,1031,51,10,70,Medicare,1041,1046,0.0
5,1,89,1,6,11,1051,1032,18,9,96,tax,1041,1069,0.0
5,1,89,1,6,12,1073,1031,46,10,93,withheld,1041,1119,0.0
4,1,89,1,7,0,724,1056,421,15,-1,,1071,1145,0.0
5,1,89,1,7,1,724,1056,124,15,91,224061.76,1071,848,0.0
5,1,89,1,7,2,1050,1056,95,15,96,6497.79,1071,1145,0.0
4,1,89,1,8,0,59,1069,1013,33,-1,,1102,1072,0.0
5,1,89,1,8,1,59,1069,145,33,91,Angelatown,1102,204,0.0
5,1,89,1,8,2,273,1074,28,14,67,AZ,1088,301,0.0
5,1,89,1,8,3,324,1069,14,33,33,=,1102,338,0.0
5,1,89,1,8,4,345,1073,137,15,33,21706-7217,1088,482,0.0
5,1,89,1,8,5,681,1082,5,10,68,7,1092,686,0.0
5,1,89,1,8,6,705,1082,34,10,68,Social,1092,739,0.0
5,1,89,1,8,7,746,1083,42,12,48,security,1095,788,0.0
5,1,89,1,8,8,795,1083,19,12,82,tps,1095,814,0.0
5,1,89,1,8,9,971,1082,5,10,51,8,1092,976,0.0
5,1,89,1,8,10,994,1082,53,10,83,Allocated,1092,1047,0.0
5,1,89,1,8,11,1052,1083,20,12,90,tips,1095,1072,0.0
4,1,89,1,9,0,724,1107,447,15,-1,,1122,1171,0.0
5,1,89,1,9,1,724,1107,123,15,91,254242.78,1122,847,0.0
5,1,89,1,9,2,1049,1107,122,15,91,224061.76,1122,1171,0.0
4,1,89,1,10,0,11,1133,1122,13,-1,,1146,1133,0.0
5,1,89,1,10,1,11,1133,57,10,0,โControl,1143,68,0.0
5,1,89,1,10,2,74,1133,42,10,96,number,1143,116,0.0
5,1,89,1,10,3,680,1133,7,10,70,9,1143,687,0.0
5,1,89,1,10,4,704,1133,48,10,73,Advance,1143,752,0.0
5,1,89,1,10,5,758,1133,19,10,92,EIC,1143,777,0.0
5,1,89,1,10,6,783,1134,48,12,96,payment,1146,831,0.0
5,1,89,1,10,7,964,1133,13,10,77,40,1143,977,0.0
5,1,89,1,10,8,995,1133,60,13,71,Dependent,1146,1055,0.0
5,1,89,1,10,9,1061,1136,23,7,93,care,1143,1084,0.0
5,1,89,1,10,10,1090,1133,43,10,93,benefits,1143,1133,0.0
4,1,89,1,11,0,66,1158,1022,15,-1,,1173,1088,0.0
5,1,89,1,11,1,66,1158,80,15,96,343207,1173,146,0.0
5,1,89,1,11,2,1050,1158,38,15,96,150,1173,1088,0.0
4,1,89,1,12,0,12,1184,1163,13,-1,,1197,1175,0.0
5,1,89,1,12,1,12,1187,6,7,52,@,1194,18,0.0
5,1,89,1,12,2,29,1184,65,13,75,Employee's,1197,94,0.0
5,1,89,1,12,3,99,1184,20,10,95,first,1194,119,0.0
5,1,89,1,12,4,125,1187,30,7,95,name,1194,155,0.0
5,1,89,1,12,5,161,1184,19,10,96,and,1194,180,0.0
5,1,89,1,12,6,186,1184,28,10,91,initial,1194,214,0.0
5,1,89,1,12,7,280,1184,23,10,96,Last,1194,303,0.0
5,1,89,1,12,8,309,1187,30,7,94,name,1194,339,0.0
5,1,89,1,12,9,674,1184,11,10,60,11,1194,685,0.0
5,1,89,1,12,10,705,1184,68,13,79,Nonqualified,1197,773,0.0
5,1,89,1,12,11,779,1184,29,13,76,plans,1197,808,0.0
5,1,89,1,12,12,966,1184,20,10,33,12a,1194,986,0.0
5,1,89,1,12,13,1009,1184,22,10,64,See,1194,1031,0.0
5,1,89,1,12,14,1037,1184,92,10,95,instructions,1194,1129,0.0
5,1,89,1,12,15,1112,1176,19,25,96,for,1201,1131,0.0
5,1,89,1,12,16,1134,1184,22,10,96,box,1194,1156,0.0
5,1,89,1,12,17,1162,1184,13,10,93,12,1194,1175,0.0
4,1,89,1,13,0,214,1215,888,17,-1,,1232,1102,0.0
5,1,89,1,13,1,214,1229,3,3,35,2,1232,217,0.0
5,1,89,1,13,2,262,1229,3,3,0,-,1232,265,0.0
5,1,89,1,13,3,725,1215,38,15,96,164,1230,763,0.0
5,1,89,1,13,4,1006,1216,13,14,86,G,1230,1019,0.0
5,1,89,1,13,5,1050,1215,52,15,88,|6331,1230,1102,0.0
4,1,89,1,14,0,66,1225,921,31,-1,,1256,987,0.0
5,1,89,1,14,1,66,1230,76,16,96,James,1246,142,0.0
5,1,89,1,14,2,192,1225,126,31,96,Williams,1256,318,0.0
5,1,89,1,14,3,674,1241,13,10,60,1B,1251,687,0.0
5,1,89,1,14,4,693,1242,43,10,44,Slatutory,1252,736,0.0
5,1,89,1,14,5,780,1242,50,8,0,___Relrement,1250,830,0.0
5,1,89,1,14,6,866,1242,23,8,0,Thre,1250,889,0.0
5,1,89,1,14,7,895,1230,24,30,0,pary,1260,919,0.0
5,1,89,1,14,8,966,1241,21,10,51,1,1251,987,0.0
4,1,89,1,15,0,693,1257,213,10,-1,,1267,906,0.0
5,1,89,1,15,1,693,1257,44,10,50,empoyee,1267,737,0.0
5,1,89,1,15,2,780,1257,18,10,40,plan,1267,798,0.0
5,1,89,1,15,3,867,1257,18,8,95,sick,1265,885,0.0
5,1,89,1,15,4,889,1259,17,8,94,pay,1267,906,0.0
4,1,89,1,16,0,67,1269,1021,22,-1,,1291,1088,0.0
5,1,89,1,16,1,67,1269,75,17,96,95060,1286,142,0.0
5,1,89,1,16,2,161,1269,110,22,96,Crystal,1291,271,0.0
5,1,89,1,16,3,288,1270,64,21,96,Burg,1291,352,0.0
5,1,89,1,16,4,367,1270,59,21,95,Apt.,1291,426,0.0
5,1,89,1,16,5,450,1269,44,17,96,070,1286,494,0.0
5,1,89,1,16,6,699,1275,10,11,94,x,1286,709,0.0
5,1,89,1,16,7,1005,1272,13,14,89,E,1286,1018,0.0
5,1,89,1,16,8,1050,1271,38,15,91,|120,1286,1088,0.0
4,1,89,1,17,0,64,1300,922,30,-1,,1330,986,0.0
5,1,89,1,17,1,64,1308,62,17,96,Davi,1325,126,0.0
5,1,89,1,17,2,130,1308,93,22,91,sburgh,1330,223,0.0
5,1,89,1,17,3,303,1309,34,16,96,AR,1325,337,0.0
5,1,89,1,17,4,354,1308,156,17,96,30937-0798,1325,510,0.0
5,1,89,1,17,5,674,1300,13,10,42,44,1310,687,0.0
5,1,89,1,17,6,705,1300,31,10,82,Other,1310,736,0.0
5,1,89,1,17,7,741,1301,23,12,88,(see,1313,764,0.0
5,1,89,1,17,8,770,1300,50,10,96,enclosed,1310,820,0.0
5,1,89,1,17,9,826,1300,35,10,96,Notice,1310,861,0.0
5,1,89,1,17,10,866,1301,10,9,96,to,1310,876,0.0
5,1,89,1,17,11,882,1300,61,13,96,Employee),1313,943,0.0
5,1,89,1,17,12,949,1292,9,25,52,|,1317,958,0.0
5,1,89,1,17,13,966,1300,20,10,38,12c,1310,986,0.0
4,1,89,1,18,0,1050,1331,38,15,-1,,1346,1088,0.0
5,1,89,1,18,1,1050,1331,38,15,94,738,1346,1088,0.0
4,1,89,1,19,0,966,1357,20,10,-1,,1367,986,0.0
5,1,89,1,19,1,966,1357,20,10,88,12d,1367,986,0.0
4,1,89,1,20,0,1049,1388,39,15,-1,,1403,1088,0.0
5,1,89,1,20,1,1049,1388,39,15,96,278,1403,1088,0.0
4,1,89,1,21,0,11,1418,213,13,-1,,1431,224,0.0
5,1,89,1,21,1,11,1418,5,10,91,f,1428,16,0.0
5,1,89,1,21,2,29,1418,65,13,46,Employee's,1431,94,0.0
5,1,89,1,21,3,100,1418,44,10,92,address,1428,144,0.0
5,1,89,1,21,4,150,1418,19,10,96,and,1428,169,0.0
5,1,89,1,21,5,174,1418,18,10,94,ZIP,1428,192,0.0
5,1,89,1,21,6,197,1418,27,10,96,code,1428,224,0.0
4,1,89,1,22,0,6,1435,1210,13,-1,,1448,1216,0.0
5,1,89,1,22,1,6,1435,13,10,91,15,1445,19,0.0
5,1,89,1,22,2,29,1435,29,10,58,Statel,1445,58,0.0
5,1,89,1,22,3,88,1435,62,13,47,Employers,1448,150,0.0
5,1,89,1,22,4,156,1436,27,9,94,state,1445,183,0.0
5,1,89,1,22,5,189,1435,10,10,94,ID,1445,199,0.0
5,1,89,1,22,6,205,1435,42,10,93,number,1445,247,0.0
5,1,89,1,22,7,349,1435,11,10,89,16,1445,360,0.0
5,1,89,1,22,8,370,1435,29,10,93,State,1445,399,0.0
5,1,89,1,22,9,404,1438,36,10,85,wages.,1448,440,0.0
5,1,89,1,22,10,449,1436,20,12,92,"tips,",1448,469,0.0
5,1,89,1,22,11,479,1436,16,9,84,etc.,1445,495,0.0
5,1,89,1,22,12,541,1435,12,10,85,17,1445,553,0.0
5,1,89,1,22,13,562,1435,29,10,91,State,1445,591,0.0
5,1,89,1,22,14,597,1438,40,7,95,income,1445,637,0.0
5,1,89,1,22,15,642,1436,18,9,96,tax,1445,660,0.0
5,1,89,1,22,16,727,1435,11,10,91,18,1445,738,0.0
5,1,89,1,22,17,748,1435,29,10,93,Local,1445,777,0.0
5,1,89,1,22,18,782,1438,40,10,90,wages.,1448,822,0.0
5,1,89,1,22,19,827,1436,20,12,95,"tips,",1448,847,0.0
5,1,89,1,22,20,857,1436,16,9,85,etc.,1445,873,0.0
5,1,89,1,22,21,929,1435,12,10,60,19,1445,941,0.0
5,1,89,1,22,22,951,1435,29,10,91,Local,1445,980,0.0
5,1,89,1,22,23,986,1438,40,7,96,income,1445,1026,0.0
5,1,89,1,22,24,1031,1436,18,9,96,tax,1445,1049,0.0
5,1,89,1,22,25,1114,1435,13,10,80,20,1445,1127,0.0
5,1,89,1,22,26,1137,1435,44,13,95,Locality,1448,1181,0.0
5,1,89,1,22,27,1186,1438,30,7,94,name,1445,1216,0.0
4,1,89,1,23,0,12,1456,1024,28,-1,,1484,1036,0.0
5,1,89,1,23,1,12,1456,31,28,96,NE,1484,43,0.0
5,1,89,1,23,2,132,1460,137,15,91,112-76-689,1475,269,0.0
5,1,89,1,23,3,347,1460,122,15,90,124132.88,1475,469,0.0
5,1,89,1,23,4,539,1460,94,15,95,6171.87,1475,633,0.0
5,1,89,1,23,5,725,1460,122,15,88,186737.87,1475,847,0.0
5,1,89,1,23,6,927,1460,109,15,90,28603.11,1475,1036,0.0
4,1,89,1,24,0,17,1512,1215,23,-1,,1535,1232,0.0
5,1,89,1,24,1,17,1513,28,14,84,PA,1527,45,0.0
5,1,89,1,24,2,62,1534,7,1,77,|,1535,69,0.0
5,1,89,1,24,3,132,1512,137,15,90,349-50-216,1527,269,0.0
5,1,89,1,24,4,330,1512,140,23,53,_[129509.36,1535,470,0.0
5,1,89,1,24,5,539,1512,95,15,96,8944.76,1527,634,0.0
5,1,89,1,24,6,725,1512,108,15,92,316985.0,1527,833,0.0
5,1,89,1,24,7,928,1512,108,15,92,38840.21,1527,1036,0.0
5,1,89,1,24,8,1112,1519,55,8,93,Ramirez,1527,1167,0.0
5,1,89,1,24,9,1177,1519,55,10,90,Passage|,1529,1232,0.0
4,1,89,1,25,0,139,1538,1092,57,-1,,1595,1231,0.0
5,1,89,1,25,1,139,1542,63,22,95,Wage,1564,202,0.0
5,1,89,1,25,2,211,1542,41,17,96,and,1559,252,0.0
5,1,89,1,25,3,261,1542,40,17,95,Tax,1559,301,0.0
5,1,89,1,25,4,549,1549,27,42,92,2,1591,576,0.0
5,1,89,1,25,5,584,1538,31,57,52,Oo,1595,615,0.0
5,1,89,1,25,6,624,1538,30,57,32,"i""",1595,654,0.0
5,1,89,1,25,7,662,1538,31,57,46,Oo,1595,693,0.0
5,1,89,1,25,8,864,1547,81,15,96,Department,1562,945,0.0
5,1,89,1,25,9,950,1547,11,12,96,of,1559,961,0.0
5,1,89,1,25,10,966,1547,20,12,93,the,1559,986,0.0
5,1,89,1,25,11,991,1547,118,15,40,TreasuryโInternal,1562,1109,0.0
5,1,89,1,25,12,1115,1547,59,12,96,Revenue,1559,1174,0.0
5,1,89,1,25,13,1180,1547,51,12,96,Service,1559,1231,0.0
4,1,89,1,26,0,4,1573,1032,17,-1,,1590,1036,0.0
5,1,89,1,26,1,4,1579,34,11,93,Form,1590,38,0.0
5,1,89,1,26,2,47,1579,25,11,92,W-2,1590,72,0.0
5,1,89,1,26,3,140,1573,114,17,96,Statement,1590,254,0.0
5,1,89,1,26,4,927,1575,35,15,94,"Safe,",1590,962,0.0
5,1,89,1,26,5,967,1575,69,15,94,"accurate,",1590,1036,0.0
2,1,90,0,0,0,5,1602,291,37,-1,,1639,296,0.0
3,1,90,1,0,0,5,1602,291,37,-1,,1639,296,0.0
4,1,90,1,1,0,5,1602,291,15,-1,,1617,296,0.0
5,1,90,1,1,1,5,1602,40,15,93,Copy,1617,45,0.0
5,1,90,1,1,2,51,1602,10,12,91,C,1614,61,0.0
5,1,90,1,1,3,68,1602,26,12,96,For,1614,94,0.0
5,1,90,1,1,4,100,1602,103,12,86,EMPLOYEE'S,1614,203,0.0
5,1,90,1,1,5,210,1602,86,12,96,RECORDS.,1614,296,0.0
4,1,90,1,2,0,5,1624,276,15,-1,,1639,281,0.0
5,1,90,1,2,1,5,1624,33,15,95,(See,1639,38,0.0
5,1,90,1,2,2,44,1624,69,12,96,enclosed,1636,113,0.0
5,1,90,1,2,3,120,1624,49,12,96,Notice,1636,169,0.0
5,1,90,1,2,4,174,1624,16,12,96,to,1636,190,0.0
5,1,90,1,2,5,196,1624,85,15,95,Employee.),1639,281,0.0
2,1,91,0,0,0,926,1596,82,12,-1,,1608,1008,0.0
3,1,91,1,0,0,926,1596,82,12,-1,,1608,1008,0.0
4,1,91,1,1,0,926,1596,82,12,-1,,1608,1008,0.0
5,1,91,1,1,1,926,1596,44,12,95,FAST!,1608,970,0.0
5,1,91,1,1,2,980,1596,28,12,96,Use,1608,1008,0.0
2,1,92,0,0,0,1048,1578,134,33,-1,,1611,1182,0.0
3,1,92,1,0,0,1048,1578,134,33,-1,,1611,1182,0.0
4,1,92,1,1,0,1048,1578,134,33,-1,,1611,1182,0.0
5,1,92,1,1,1,1044,1574,48,52,30,Pe,1626,1092,0.0
5,1,92,1,1,2,1113,1574,48,52,51,file,1626,1161,0.0
5,1,92,1,1,3,1173,1574,10,52,19,|,1626,1183,0.0
1,1,0,0,0,0,0,0,1236,1658,-1,,1658,1236,0.0
2,1,1,0,0,0,596,1,1,50,-1,,51,597,0.0
3,1,1,1,0,0,596,1,1,50,-1,,51,597,0.0
4,1,1,1,1,0,596,1,1,50,-1,,51,597,0.0
5,1,1,1,1,1,596,1,1,50,95, ,51,597,0.0
2,1,2,0,0,0,1,50,658,3,-1,,53,659,0.0
3,1,2,1,0,0,1,50,658,3,-1,,53,659,0.0
4,1,2,1,1,0,1,50,658,3,-1,,53,659,0.0
5,1,2,1,1,1,1,50,658,3,95, ,53,659,0.0
2,1,3,0,0,0,1,102,658,3,-1,,105,659,0.0
3,1,3,1,0,0,1,102,658,3,-1,,105,659,0.0
4,1,3,1,1,0,1,102,658,3,-1,,105,659,0.0
5,1,3,1,1,1,1,102,658,3,95, ,105,659,0.0
2,1,4,0,0,0,1,256,658,3,-1,,259,659,0.0
3,1,4,1,0,0,1,256,658,3,-1,,259,659,0.0
4,1,4,1,1,0,1,256,658,3,-1,,259,659,0.0
5,1,4,1,1,1,1,256,658,3,95, ,259,659,0.0
2,1,5,0,0,0,1,308,658,3,-1,,311,659,0.0
3,1,5,1,0,0,1,308,658,3,-1,,311,659,0.0
4,1,5,1,1,0,1,308,658,3,-1,,311,659,0.0
5,1,5,1,1,1,1,308,658,3,95, ,311,659,0.0
2,1,6,0,0,0,660,154,576,3,-1,,157,1236,0.0
3,1,6,1,0,0,660,154,576,3,-1,,157,1236,0.0
4,1,6,1,1,0,660,154,576,3,-1,,157,1236,0.0
5,1,6,1,1,1,660,154,576,3,95, ,157,1236,0.0
2,1,7,0,0,0,660,205,576,3,-1,,208,1236,0.0
3,1,7,1,0,0,660,205,576,3,-1,,208,1236,0.0
4,1,7,1,1,0,660,205,576,3,-1,,208,1236,0.0
5,1,7,1,1,1,660,205,576,3,95, ,208,1236,0.0
2,1,8,0,0,0,660,365,576,3,-1,,368,1236,0.0
3,1,8,1,0,0,660,365,576,3,-1,,368,1236,0.0
4,1,8,1,1,0,660,365,576,3,-1,,368,1236,0.0
5,1,8,1,1,1,660,365,576,3,95, ,368,1236,0.0
2,1,9,0,0,0,689,393,204,3,-1,,396,893,0.0
3,1,9,1,0,0,689,393,204,3,-1,,396,893,0.0
4,1,9,1,1,0,689,393,204,3,-1,,396,893,0.0
5,1,9,1,1,1,689,393,204,3,95, ,396,893,0.0
2,1,10,0,0,0,689,394,1,28,-1,,422,690,0.0
3,1,10,1,0,0,689,394,1,28,-1,,422,690,0.0
4,1,10,1,1,0,689,394,1,28,-1,,422,690,0.0
5,1,10,1,1,1,689,394,1,28,95, ,422,690,0.0
2,1,11,0,0,0,718,394,1,28,-1,,422,719,0.0
3,1,11,1,0,0,718,394,1,28,-1,,422,719,0.0
4,1,11,1,1,0,718,394,1,28,-1,,422,719,0.0
5,1,11,1,1,1,718,394,1,28,95, ,422,719,0.0
2,1,12,0,0,0,776,394,1,28,-1,,422,777,0.0
3,1,12,1,0,0,776,394,1,28,-1,,422,777,0.0
4,1,12,1,1,0,776,394,1,28,-1,,422,777,0.0
5,1,12,1,1,1,776,394,1,28,95, ,422,777,0.0
2,1,13,0,0,0,805,394,1,28,-1,,422,806,0.0
3,1,13,1,0,0,805,394,1,28,-1,,422,806,0.0
4,1,13,1,1,0,805,394,1,28,-1,,422,806,0.0
5,1,13,1,1,1,805,394,1,28,95, ,422,806,0.0
2,1,14,0,0,0,863,394,1,28,-1,,422,864,0.0
3,1,14,1,0,0,863,394,1,28,-1,,422,864,0.0
4,1,14,1,1,0,863,394,1,28,-1,,422,864,0.0
5,1,14,1,1,1,863,394,1,28,95, ,422,864,0.0
2,1,15,0,0,0,892,394,1,28,-1,,422,893,0.0
3,1,15,1,0,0,892,394,1,28,-1,,422,893,0.0
4,1,15,1,1,0,892,394,1,28,-1,,422,893,0.0
5,1,15,1,1,1,892,394,1,28,95, ,422,893,0.0
2,1,16,0,0,0,660,420,576,5,-1,,425,1236,0.0
3,1,16,1,0,0,660,420,576,5,-1,,425,1236,0.0
4,1,16,1,1,0,660,420,576,5,-1,,425,1236,0.0
5,1,16,1,1,1,660,420,576,5,95, ,425,1236,0.0
2,1,17,0,0,0,689,420,547,5,-1,,425,1236,0.0
3,1,17,1,0,0,689,420,547,5,-1,,425,1236,0.0
4,1,17,1,1,0,689,420,547,5,-1,,425,1236,0.0
5,1,17,1,1,1,689,420,547,5,95, ,425,1236,0.0
2,1,18,0,0,0,689,420,547,5,-1,,425,1236,0.0
3,1,18,1,0,0,689,420,547,5,-1,,425,1236,0.0
4,1,18,1,1,0,689,420,547,5,-1,,425,1236,0.0
5,1,18,1,1,1,689,420,547,5,95, ,425,1236,0.0
2,1,19,0,0,0,689,420,547,5,-1,,425,1236,0.0
3,1,19,1,0,0,689,420,547,5,-1,,425,1236,0.0
4,1,19,1,1,0,689,420,547,5,-1,,425,1236,0.0
5,1,19,1,1,1,689,420,547,5,95, ,425,1236,0.0
2,1,20,0,0,0,950,480,286,1,-1,,481,1236,0.0
3,1,20,1,0,0,950,480,286,1,-1,,481,1236,0.0
4,1,20,1,1,0,950,480,286,1,-1,,481,1236,0.0
5,1,20,1,1,1,950,480,286,1,95, ,481,1236,0.0
2,1,21,0,0,0,1043,326,1,212,-1,,538,1044,0.0
3,1,21,1,0,0,1043,326,1,212,-1,,538,1044,0.0
4,1,21,1,1,0,1043,326,1,212,-1,,538,1044,0.0
5,1,21,1,1,1,1043,326,1,212,95, ,538,1044,0.0
2,1,22,0,0,0,950,537,286,1,-1,,538,1236,0.0
3,1,22,1,0,0,950,537,286,1,-1,,538,1236,0.0
4,1,22,1,1,0,950,537,286,1,-1,,538,1236,0.0
5,1,22,1,1,1,950,537,286,1,95, ,538,1236,0.0
2,1,23,0,0,0,11,3,1182,555,-1,,558,1193,0.0
3,1,23,1,0,0,11,3,1182,555,-1,,558,1193,0.0
4,1,23,1,1,0,55,3,1138,17,-1,,20,1193,0.0
5,1,23,1,1,1,55,5,103,15,91,REISSUED,20,158,0.0
5,1,23,1,1,2,216,7,6,7,30,{a,14,222,0.0
5,1,23,1,1,3,236,0,70,24,71,Employee's,24,306,0.0
5,1,23,1,1,4,312,4,35,10,96,social,14,347,0.0
5,1,23,1,1,5,352,4,48,13,96,security,17,400,0.0
5,1,23,1,1,6,406,4,48,10,95,number,14,454,0.0
5,1,23,1,1,7,782,3,35,14,96,"Safe,",17,817,0.0
5,1,23,1,1,8,822,3,71,14,96,"Accurate,",17,893,0.0
5,1,23,1,1,9,1043,0,35,26,95,Visit,26,1078,0.0
5,1,23,1,1,10,1084,4,18,12,95,the,16,1102,0.0
5,1,23,1,1,11,1108,4,23,12,96,IRS,16,1131,0.0
5,1,23,1,1,12,1136,4,57,12,96,Website,16,1193,0.0
4,1,23,1,2,0,44,6,1136,48,-1,,54,1180,0.0
5,1,23,1,2,1,44,19,126,32,96,STATEMENT,51,170,0.0
5,1,23,1,2,2,312,28,150,15,89,768-05-9800,43,462,0.0
5,1,23,1,2,3,612,29,28,10,87,OMB,39,640,0.0
5,1,23,1,2,4,646,29,14,10,93,No.,39,660,0.0
5,1,23,1,2,5,671,29,57,10,74,1548-0008,39,728,0.0
5,1,23,1,2,6,781,28,44,12,92,FAST!,40,825,0.0
5,1,23,1,2,7,835,28,28,12,96,Use,40,863,0.0
5,1,23,1,2,8,900,6,56,48,12,e~,54,956,0.0
5,1,23,1,2,9,972,6,72,48,78,tile),54,1044,0.0
5,1,23,1,2,10,1048,30,12,11,96,at,41,1060,0.0
5,1,23,1,2,11,1069,21,25,31,14,www,52,1094,0.0
5,1,23,1,2,12,1102,21,20,31,14,irs.,52,1122,0.0
5,1,23,1,2,13,1122,29,58,15,61,goviefile.,44,1180,0.0
4,1,23,1,3,0,12,56,1143,13,-1,,69,1155,0.0
5,1,23,1,3,1,12,56,7,10,79,b,66,19,0.0
5,1,23,1,3,2,29,56,54,13,90,Employer,69,83,0.0
5,1,23,1,3,3,88,56,70,10,95,identification,66,158,0.0
5,1,23,1,3,4,164,56,42,10,96,number,66,206,0.0
5,1,23,1,3,5,681,56,4,10,70,1,66,685,0.0
5,1,23,1,3,6,704,56,40,13,79,"Wages,",69,744,0.0
5,1,23,1,3,7,753,57,24,12,95,"tips,",69,777,0.0
5,1,23,1,3,8,783,56,28,10,96,other,66,811,0.0
5,1,23,1,3,9,819,48,76,26,96,compensation,74,895,0.0
5,1,23,1,3,10,970,56,7,10,31,2,66,977,0.0
5,1,23,1,3,11,995,56,41,10,83,Federal,66,1036,0.0
5,1,23,1,3,12,1042,59,40,7,96,income,66,1082,0.0
5,1,23,1,3,13,1087,57,16,9,96,tax,66,1103,0.0
5,1,23,1,3,14,1109,56,46,10,96,withheld,66,1155,0.0
4,1,23,1,4,0,66,80,1028,15,-1,,95,1094,0.0
5,1,23,1,4,1,66,80,136,15,92,83-1015714,95,202,0.0
5,1,23,1,4,2,725,80,108,15,89,168250.2,95,833,0.0
5,1,23,1,4,3,986,80,108,15,91,53860.77,95,1094,0.0
4,1,23,1,5,0,13,108,1139,13,-1,,121,1152,0.0
5,1,23,1,5,1,13,111,6,7,48,ยข,118,19,0.0
5,1,23,1,5,2,29,108,62,13,94,Employers,121,91,0.0
5,1,23,1,5,3,97,111,30,7,87,"name,",118,127,0.0
5,1,23,1,5,4,137,108,44,10,90,"address,",118,181,0.0
5,1,23,1,5,5,191,108,19,10,96,and,118,210,0.0
5,1,23,1,5,6,215,108,18,10,96,ZIP,118,233,0.0
5,1,23,1,5,7,239,108,26,10,96,code,118,265,0.0
5,1,23,1,5,8,681,108,6,10,69,3,118,687,0.0
5,1,23,1,5,9,705,108,34,10,89,Social,118,739,0.0
5,1,23,1,5,10,747,100,43,25,93,security,125,790,0.0
5,1,23,1,5,11,797,111,33,10,96,wages,121,830,0.0
5,1,23,1,5,12,970,108,7,10,66,4,118,977,0.0
5,1,23,1,5,13,995,108,34,10,71,Social,118,1029,0.0
5,1,23,1,5,14,1035,108,117,13,96,security,121,1152,0.0
5,1,23,1,5,15,1084,100,18,25,96,tax,125,1102,0.0
5,1,23,1,5,16,1107,108,45,13,96,withheld,121,1152,0.0
4,1,23,1,6,0,64,133,1030,15,-1,,148,1094,0.0
5,1,23,1,6,1,64,133,69,15,96,White,148,133,0.0
5,1,23,1,6,2,149,134,40,14,96,PLC,148,189,0.0
5,1,23,1,6,3,206,134,39,14,96,Inc,148,245,0.0
5,1,23,1,6,4,725,133,122,15,84,159372.62,148,847,0.0
5,1,23,1,6,5,986,133,108,15,90,12192.01,148,1094,0.0
4,1,23,1,7,0,65,159,1054,28,-1,,187,1119,0.0
5,1,23,1,7,1,65,167,68,15,96,21769,182,133,0.0
5,1,23,1,7,2,148,167,83,15,96,Walker,182,231,0.0
5,1,23,1,7,3,247,167,97,20,96,Landing,187,344,0.0
5,1,23,1,7,4,681,159,6,10,72,5,169,687,0.0
5,1,23,1,7,5,705,159,51,10,81,Medicare,169,756,0.0
5,1,23,1,7,6,761,162,36,10,96,wages,172,797,0.0
5,1,23,1,7,7,803,159,19,10,91,and,169,822,0.0
5,1,23,1,7,8,827,160,20,12,91,tips,172,847,0.0
5,1,23,1,7,9,970,159,6,10,69,6,169,976,0.0
5,1,23,1,7,10,995,159,51,10,73,Medicare,169,1046,0.0
5,1,23,1,7,11,1051,160,18,9,96,tax,169,1069,0.0
5,1,23,1,7,12,1073,159,46,10,96,withheld,169,1119,0.0
4,1,23,1,8,0,724,184,420,15,-1,,199,1144,0.0
5,1,23,1,8,1,724,184,124,15,92,206499.26,199,848,0.0
5,1,23,1,8,2,1050,184,94,15,94,5988.48,199,1144,0.0
4,1,23,1,9,0,64,201,1008,22,-1,,223,1072,0.0
5,1,23,1,9,1,64,201,125,15,91,Bakerfurt,216,189,0.0
5,1,23,1,9,2,246,202,28,14,87,NJ,216,274,0.0
5,1,23,1,9,3,304,201,137,15,95,06199-9819,216,441,0.0
5,1,23,1,9,4,681,210,5,10,33,7,220,686,0.0
5,1,23,1,9,5,705,210,34,10,85,Social,220,739,0.0
5,1,23,1,9,6,747,198,41,29,94,security,227,788,0.0
5,1,23,1,9,7,795,211,19,12,96,tips,223,814,0.0
5,1,23,1,9,8,970,210,6,10,20,@,220,976,0.0
5,1,23,1,9,9,994,210,53,10,70,Allocated,220,1047,0.0
5,1,23,1,9,10,1052,211,20,12,96,tips,223,1072,0.0
4,1,23,1,10,0,725,235,446,15,-1,,250,1171,0.0
5,1,23,1,10,1,725,235,122,15,87,159372.62,250,847,0.0
5,1,23,1,10,2,1049,235,122,15,89,206499.26,250,1171,0.0
4,1,23,1,11,0,11,262,1122,13,-1,,275,1133,0.0
5,1,23,1,11,1,11,262,7,10,29,โd,272,18,0.0
5,1,23,1,11,2,29,262,39,10,94,Control,272,68,0.0
5,1,23,1,11,3,74,262,42,10,96,number,272,116,0.0
5,1,23,1,11,4,680,262,7,10,67,9,272,687,0.0
5,1,23,1,11,5,704,262,48,10,75,Advance,272,752,0.0
5,1,23,1,11,6,758,262,19,10,92,EIC,272,777,0.0
5,1,23,1,11,7,783,263,48,12,96,payment,275,831,0.0
5,1,23,1,11,8,964,262,13,10,81,10,272,977,0.0
5,1,23,1,11,9,995,262,60,13,73,Dependent,275,1055,0.0
5,1,23,1,11,10,1061,265,23,7,96,care,272,1084,0.0
5,1,23,1,11,11,1090,262,43,10,93,benefits,272,1133,0.0
4,1,23,1,12,0,66,286,1022,15,-1,,301,1088,0.0
5,1,23,1,12,1,66,286,95,15,95,7480956,301,161,0.0
5,1,23,1,12,2,1050,286,38,15,95,164,301,1088,0.0
4,1,23,1,13,0,12,313,1163,13,-1,,326,1175,0.0
5,1,23,1,13,1,29,313,65,13,81,Employee's,326,94,0.0
5,1,23,1,13,2,99,313,20,10,94,first,323,119,0.0
5,1,23,1,13,3,125,316,30,7,94,name,323,155,0.0
5,1,23,1,13,4,161,313,19,10,96,and,323,180,0.0
5,1,23,1,13,5,186,313,28,10,95,initial,323,214,0.0
5,1,23,1,13,6,280,313,23,10,95,Last,323,303,0.0
5,1,23,1,13,7,309,316,30,7,94,name,323,339,0.0
5,1,23,1,13,8,674,313,11,10,56,71,323,685,0.0
5,1,23,1,13,9,705,313,68,13,69,Nonqualified,326,773,0.0
5,1,23,1,13,10,779,313,29,13,65,"plans,",326,808,0.0
5,1,23,1,13,11,966,313,20,10,36,12a,323,986,0.0
5,1,23,1,13,12,1009,313,22,10,64,See,323,1031,0.0
5,1,23,1,13,13,1037,313,92,10,95,instructions,323,1129,0.0
5,1,23,1,13,14,1112,305,19,25,96,for,330,1131,0.0
5,1,23,1,13,15,1134,313,22,10,96,box,323,1156,0.0
5,1,23,1,13,16,1162,313,13,10,91,12,323,1175,0.0
4,1,23,1,14,0,725,344,377,15,-1,,359,1102,0.0
5,1,23,1,14,1,725,344,39,15,96,149,359,764,0.0
5,1,23,1,14,2,1050,344,52,15,96,6335,359,1102,0.0
4,1,23,1,15,0,65,359,922,22,-1,,381,987,0.0
5,1,23,1,15,1,65,359,94,16,96,Trevor,375,159,0.0
5,1,23,1,15,2,192,359,95,16,96,Duncan,375,287,0.0
5,1,23,1,15,3,674,370,13,10,58,13,380,687,0.0
5,1,23,1,15,4,693,371,43,10,53,Siatutory,381,736,0.0
5,1,23,1,15,5,780,371,50,8,60,Relvement,379,830,0.0
5,1,23,1,15,6,866,371,53,10,65,Third-party,381,919,0.0
5,1,23,1,15,7,966,370,21,10,63,1b,380,987,0.0
4,1,23,1,16,0,693,385,213,9,-1,,394,906,0.0
5,1,23,1,16,1,693,385,44,9,12,empoyee,394,737,0.0
5,1,23,1,16,2,780,385,18,9,39,plan,394,798,0.0
5,1,23,1,16,3,867,385,18,8,85,sick,393,885,0.0
5,1,23,1,16,4,895,387,11,7,85,pay,394,906,0.0
4,1,23,1,17,0,66,396,1023,22,-1,,418,1089,0.0
5,1,23,1,17,1,66,396,76,17,96,41435,413,142,1.0
5,1,23,1,17,2,161,396,93,22,96,Hughes,418,254,1.0
5,1,23,1,17,3,272,396,79,17,96,Drive,413,351,1.0
5,1,23,1,17,4,1050,398,39,15,96,663,413,1089,0.0
4,1,23,1,18,0,64,427,922,30,-1,,457,986,0.0
5,1,23,1,18,1,64,436,48,16,93,New,452,112,1.0
5,1,23,1,18,2,129,435,159,22,91,Teresaberg,457,288,1.0
5,1,23,1,18,3,352,436,30,16,93,KS,452,382,1.0
5,1,23,1,18,4,403,435,155,17,93,99528-9775,452,558,0.0
5,1,23,1,18,5,674,427,13,10,49,44,437,687,0.0
5,1,23,1,18,6,705,427,31,10,81,Other,437,736,0.0
5,1,23,1,18,7,741,427,23,13,86,(see,440,764,0.0
5,1,23,1,18,8,770,427,50,10,96,enclosed,437,820,0.0
5,1,23,1,18,9,826,427,35,10,96,Notice,437,861,0.0
5,1,23,1,18,10,866,428,10,9,96,to,437,876,0.0
5,1,23,1,18,11,882,427,61,13,94,Employee),440,943,0.0
5,1,23,1,18,12,949,419,11,25,46,|,444,960,0.0
5,1,23,1,18,13,966,427,20,10,38,12c,437,986,0.0
4,1,23,1,19,0,1007,458,82,15,-1,,473,1089,0.0
5,1,23,1,19,1,1007,459,12,14,66,P,473,1019,0.0
5,1,23,1,19,2,1050,458,39,15,63,/136,473,1089,0.0
4,1,23,1,20,0,966,484,20,10,-1,,494,986,0.0
5,1,23,1,20,1,966,484,20,10,88,12d,494,986,0.0
4,1,23,1,21,0,1050,515,39,15,-1,,530,1089,0.0
5,1,23,1,21,1,1050,515,39,15,95,986,530,1089,0.0
4,1,23,1,22,0,11,545,213,13,-1,,558,224,0.0
5,1,23,1,22,1,11,545,5,10,91,f,555,16,0.0
5,1,23,1,22,2,29,545,65,13,53,Employee's,558,94,0.0
5,1,23,1,22,3,100,545,44,10,91,address,555,144,0.0
5,1,23,1,22,4,150,545,19,10,96,and,555,169,0.0
5,1,23,1,22,5,174,545,18,10,94,ZIP,555,192,0.0
5,1,23,1,22,6,197,545,27,10,96,code,555,224,0.0
2,1,24,0,0,0,659,105,3,454,-1,,559,662,0.0
3,1,24,1,0,0,659,105,3,454,-1,,559,662,0.0
4,1,24,1,1,0,659,105,3,454,-1,,559,662,0.0
5,1,24,1,1,1,659,105,3,454,95, ,559,662,0.0
2,1,25,0,0,0,949,105,3,454,-1,,559,952,0.0
3,1,25,1,0,0,949,105,3,454,-1,,559,952,0.0
4,1,25,1,1,0,949,105,3,454,-1,,559,952,0.0
5,1,25,1,1,1,949,105,3,454,95, ,559,952,0.0
2,1,26,0,0,0,1,556,1235,5,-1,,561,1236,0.0
3,1,26,1,0,0,1,556,1235,5,-1,,561,1236,0.0
4,1,26,1,1,0,1,556,1235,5,-1,,561,1236,0.0
5,1,26,1,1,1,1,556,1235,5,95, ,561,1236,0.0
2,1,27,0,0,0,6,562,52,40,-1,,602,58,0.0
3,1,27,1,0,0,6,562,52,40,-1,,602,58,0.0
4,1,27,1,1,0,6,562,52,10,-1,,572,58,0.0
5,1,27,1,1,1,6,562,13,10,86,15,572,19,0.0
5,1,27,1,1,2,29,562,29,10,86,State,572,58,0.0
4,1,27,1,2,0,15,588,28,14,-1,,602,43,0.0
5,1,27,1,2,1,15,588,28,14,96,AL,602,43,0.0
2,1,28,0,0,0,88,562,159,13,-1,,575,247,0.0
3,1,28,1,0,0,88,562,159,13,-1,,575,247,0.0
4,1,28,1,1,0,88,562,159,13,-1,,575,247,0.0
5,1,28,1,1,1,88,562,62,13,67,Employer's,575,150,0.0
5,1,28,1,1,2,156,563,27,9,95,state,572,183,0.0
5,1,28,1,1,3,189,562,10,10,81,ID,572,199,0.0
5,1,28,1,1,4,205,562,42,10,96,number,572,247,0.0
2,1,29,0,0,0,132,587,136,15,-1,,602,268,0.0
3,1,29,1,0,0,132,587,136,15,-1,,602,268,0.0
4,1,29,1,1,0,132,587,136,15,-1,,602,268,0.0
5,1,29,1,1,1,132,587,136,15,88,703-50-377,602,268,0.0
2,1,30,0,0,0,541,562,119,10,-1,,572,660,0.0
3,1,30,1,0,0,541,562,119,10,-1,,572,660,0.0
4,1,30,1,1,0,541,562,119,10,-1,,572,660,0.0
5,1,30,1,1,1,541,562,11,10,64,TT,572,552,0.0
5,1,30,1,1,2,562,562,29,10,95,State,572,591,0.0
5,1,30,1,1,3,597,565,40,7,93,income,572,637,0.0
5,1,30,1,1,4,642,563,18,9,96,tax,572,660,0.0
2,1,31,0,0,0,538,587,96,15,-1,,602,634,0.0
3,1,31,1,0,0,538,587,96,15,-1,,602,634,0.0
4,1,31,1,1,0,538,587,96,15,-1,,602,634,0.0
5,1,31,1,1,1,538,587,96,15,96,4802.83,602,634,0.0
2,1,32,0,0,0,349,562,146,13,-1,,575,495,0.0
3,1,32,1,0,0,349,562,146,13,-1,,575,495,0.0
4,1,32,1,1,0,349,562,146,13,-1,,575,495,0.0
5,1,32,1,1,1,349,562,12,10,63,16,572,361,0.0
5,1,32,1,1,2,370,562,29,10,92,State,572,399,0.0
5,1,32,1,1,3,404,565,36,10,80,"wages,",575,440,0.0
5,1,32,1,1,4,449,563,20,12,93,"tips,",575,469,0.0
5,1,32,1,1,5,479,563,16,9,73,etc,572,495,0.0
2,1,33,0,0,0,347,587,109,15,-1,,602,456,0.0
3,1,33,1,0,0,347,587,109,15,-1,,602,456,0.0
4,1,33,1,1,0,347,587,109,15,-1,,602,456,0.0
5,1,33,1,1,1,347,587,109,15,83,76475.69,602,456,0.0
2,1,34,0,0,0,3,608,1109,3,-1,,611,1112,0.0
3,1,34,1,0,0,3,608,1109,3,-1,,611,1112,0.0
4,1,34,1,1,0,3,608,1109,3,-1,,611,1112,0.0
5,1,34,1,1,1,3,608,1109,3,95, ,611,1112,0.0
2,1,35,0,0,0,59,558,1,103,-1,,661,60,0.0
3,1,35,1,0,0,59,558,1,103,-1,,661,60,0.0
4,1,35,1,1,0,59,558,1,103,-1,,661,60,0.0
5,1,35,1,1,1,59,558,1,103,95, ,661,60,0.0
2,1,36,0,0,0,340,558,1,103,-1,,661,341,0.0
3,1,36,1,0,0,340,558,1,103,-1,,661,341,0.0
4,1,36,1,1,0,340,558,1,103,-1,,661,341,0.0
5,1,36,1,1,1,340,558,1,103,95, ,661,341,0.0
2,1,37,0,0,0,532,558,1,103,-1,,661,533,0.0
3,1,37,1,0,0,532,558,1,103,-1,,661,533,0.0
4,1,37,1,1,0,532,558,1,103,-1,,661,533,0.0
5,1,37,1,1,1,532,558,1,103,95, ,661,533,0.0
2,1,38,0,0,0,726,562,323,13,-1,,575,1049,0.0
3,1,38,1,0,0,726,562,323,13,-1,,575,1049,0.0
4,1,38,1,1,0,726,562,323,13,-1,,575,1049,0.0
5,1,38,1,1,1,726,562,12,10,77,78,572,738,0.0
5,1,38,1,1,2,748,562,29,10,93,Local,572,777,0.0
5,1,38,1,1,3,782,565,36,10,70,wages.,575,818,0.0
5,1,38,1,1,4,827,563,20,12,94,"tips,",575,847,0.0
5,1,38,1,1,5,857,563,16,9,75,ete,572,873,0.0
5,1,38,1,1,6,930,562,11,10,81,19,572,941,0.0
5,1,38,1,1,7,951,562,29,10,81,Local,572,980,0.0
5,1,38,1,1,8,986,565,40,7,92,income,572,1026,0.0
5,1,38,1,1,9,1031,563,18,9,96,tax,572,1049,0.0
2,1,39,0,0,0,927,587,109,15,-1,,602,1036,0.0
3,1,39,1,0,0,927,587,109,15,-1,,602,1036,0.0
4,1,39,1,1,0,927,587,109,15,-1,,602,1036,0.0
5,1,39,1,1,1,927,587,109,15,91,29884.95,602,1036,0.0
2,1,40,0,0,0,1114,562,102,13,-1,,575,1216,0.0
3,1,40,1,0,0,1114,562,102,13,-1,,575,1216,0.0
4,1,40,1,1,0,1114,562,102,13,-1,,575,1216,0.0
5,1,40,1,1,1,1114,562,13,10,78,20,572,1127,0.0
5,1,40,1,1,2,1137,562,44,13,90,Locality,575,1181,0.0
5,1,40,1,1,3,1186,565,30,7,96,name,572,1216,0.0
2,1,41,0,0,0,1112,591,119,11,-1,,602,1231,0.0
3,1,41,1,0,0,1112,591,119,11,-1,,602,1231,0.0
4,1,41,1,1,0,1112,591,119,11,-1,,602,1231,0.0
5,1,41,1,1,1,1112,591,43,11,95,John,602,1155,0.0
5,1,41,1,1,2,1166,591,65,11,96,Manors,602,1231,0.0
2,1,42,0,0,0,725,587,122,15,-1,,602,847,0.0
3,1,42,1,0,0,725,587,122,15,-1,,602,847,0.0
4,1,42,1,1,0,725,587,122,15,-1,,602,847,0.0
5,1,42,1,1,1,725,587,122,15,90,124601.64,602,847,0.0
2,1,43,0,0,0,1234,1,2,660,-1,,661,1236,0.0
3,1,43,1,0,0,1234,1,2,660,-1,,661,1236,0.0
4,1,43,1,1,0,1234,1,2,660,-1,,661,1236,0.0
5,1,43,1,1,1,1234,1,2,660,95, ,661,1236,0.0
2,1,44,0,0,0,718,394,1,267,-1,,661,719,0.0
3,1,44,1,0,0,718,394,1,267,-1,,661,719,0.0
4,1,44,1,1,0,718,394,1,267,-1,,661,719,0.0
5,1,44,1,1,1,718,394,1,267,95, ,661,719,0.0
2,1,45,0,0,0,921,558,1,103,-1,,661,922,0.0
3,1,45,1,0,0,921,558,1,103,-1,,661,922,0.0
4,1,45,1,1,0,921,558,1,103,-1,,661,922,0.0
5,1,45,1,1,1,921,558,1,103,95, ,661,922,0.0
2,1,46,0,0,0,1107,558,1,103,-1,,661,1108,0.0
3,1,46,1,0,0,1107,558,1,103,-1,,661,1108,0.0
4,1,46,1,1,0,1107,558,1,103,-1,,661,1108,0.0
5,1,46,1,1,1,1107,558,1,103,95, ,661,1108,0.0
2,1,47,0,0,0,1,658,1235,5,-1,,663,1236,0.0
3,1,47,1,0,0,1,658,1235,5,-1,,663,1236,0.0
4,1,47,1,1,0,1,658,1235,5,-1,,663,1236,0.0
5,1,47,1,1,1,1,658,1235,5,95, ,663,1236,0.0
2,1,48,0,0,0,4,638,1227,90,-1,,728,1231,0.0
3,1,48,1,0,0,4,638,1227,82,-1,,720,1231,0.0
4,1,48,1,1,0,18,638,1212,19,-1,,657,1230,0.0
5,1,48,1,1,1,18,639,27,14,82,TA,653,45,0.0
5,1,48,1,1,2,132,638,136,15,91,882-63-902,653,268,0.0
5,1,48,1,1,3,347,638,108,15,89,89324.57,653,455,0.0
5,1,48,1,1,4,539,638,94,15,94,4795.84,653,633,0.0
5,1,48,1,1,5,725,638,122,15,91,137013.88,653,847,0.0
5,1,48,1,1,6,927,638,110,15,91,24146.13,653,1037,0.0
5,1,48,1,1,7,1114,640,51,17,96,Gary,657,1165,0.0
5,1,48,1,1,8,1179,640,51,17,96,Loop,657,1230,0.0
4,1,48,1,2,0,139,670,1092,22,-1,,692,1231,0.0
5,1,48,1,2,1,139,670,63,22,96,Wage,692,202,0.0
5,1,48,1,2,2,211,670,41,17,96,and,687,252,0.0
5,1,48,1,2,3,261,670,40,17,96,Tax,687,301,0.0
5,1,48,1,2,4,864,675,81,15,96,Department,690,945,0.0
5,1,48,1,2,5,950,675,12,12,96,of,687,962,0.0
5,1,48,1,2,6,966,675,20,12,93,the,687,986,0.0
5,1,48,1,2,7,991,675,118,15,35,TreasuryโInternal,690,1109,0.0
5,1,48,1,2,8,1115,675,59,12,96,Revenue,687,1174,0.0
5,1,48,1,2,9,1180,675,51,12,96,Service,687,1231,0.0
4,1,48,1,3,0,4,677,689,51,-1,,728,693,0.0
5,1,48,1,3,1,4,709,34,11,93,Form,720,38,0.0
5,1,48,1,3,2,47,709,25,11,91,W-2,720,72,0.0
5,1,48,1,3,3,140,697,114,31,96,Statement,728,254,0.0
5,1,48,1,3,4,549,677,27,42,21,c,719,576,0.0
5,1,48,1,3,5,588,677,27,42,50,0,719,615,0.0
5,1,48,1,3,6,628,677,26,42,59,1,719,654,0.0
5,1,48,1,3,7,666,677,27,42,52,0,719,693,0.0
2,1,49,0,0,0,4,732,482,37,-1,,769,486,0.0
3,1,49,1,0,0,4,732,482,37,-1,,769,486,0.0
4,1,49,1,1,0,5,732,462,15,-1,,747,467,0.0
5,1,49,1,1,1,5,732,40,15,93,Copy,747,45,0.0
5,1,49,1,1,2,51,732,43,12,91,B--To,744,94,0.0
5,1,49,1,1,3,100,732,19,12,96,Be,744,119,0.0
5,1,49,1,1,4,126,732,35,12,95,Filed,744,161,0.0
5,1,49,1,1,5,167,732,32,12,96,with,744,199,0.0
5,1,49,1,1,6,206,732,87,15,85,Employee's,747,293,0.0
5,1,49,1,1,7,300,732,76,12,96,FEDERAL,744,376,0.0
5,1,49,1,1,8,382,732,27,12,95,Tax,744,409,0.0
5,1,49,1,1,9,415,732,52,12,96,Return,744,467,0.0
4,1,49,1,2,0,4,754,482,15,-1,,769,486,0.0
5,1,49,1,2,1,4,754,29,12,96,This,766,33,0.0
5,1,49,1,2,2,40,754,79,12,93,information,766,119,0.0
5,1,49,1,2,3,126,757,10,9,93,is,766,136,0.0
5,1,49,1,2,4,143,754,38,15,94,being,769,181,0.0
5,1,49,1,2,5,187,754,67,12,96,furnished,766,254,0.0
5,1,49,1,2,6,260,754,12,12,96,to,766,272,0.0
5,1,49,1,2,7,278,754,22,12,96,the,766,300,0.0
5,1,49,1,2,8,307,754,52,12,93,Internal,766,359,0.0
5,1,49,1,2,9,365,754,62,12,95,Revenue,766,427,0.0
5,1,49,1,2,10,433,754,53,12,96,Service,766,486,0.0
2,1,50,0,0,0,469,825,187,14,-1,,839,656,0.0
3,1,50,1,0,0,469,825,187,14,-1,,839,656,0.0
4,1,50,1,1,0,469,825,187,14,-1,,839,656,0.0
5,1,50,1,1,1,469,825,55,11,40,Tuthere.,836,524,0.0
5,1,50,1,1,2,537,825,32,14,92,Keep,839,569,0.0
5,1,50,1,1,3,575,825,34,11,91,lower,836,609,0.0
5,1,50,1,1,4,614,826,42,13,88,portion,839,656,0.0
2,1,51,0,0,0,661,825,102,14,-1,,839,763,0.0
3,1,51,1,0,0,661,825,102,14,-1,,839,763,0.0
4,1,51,1,1,0,661,825,102,14,-1,,839,763,0.0
5,1,51,1,1,1,661,825,17,11,83,Tor,836,678,0.0
5,1,51,1,1,2,682,828,28,11,95,your,839,710,0.0
5,1,51,1,1,3,715,825,48,11,95,records,836,763,0.0
2,1,52,0,0,0,1,872,1235,5,-1,,877,1236,0.0
3,1,52,1,0,0,1,872,1235,5,-1,,877,1236,0.0
4,1,52,1,1,0,1,872,1235,5,-1,,877,1236,0.0
5,1,52,1,1,1,1,872,1235,5,95, ,877,1236,0.0
2,1,53,0,0,0,212,874,1,52,-1,,926,213,0.0
3,1,53,1,0,0,212,874,1,52,-1,,926,213,0.0
4,1,53,1,1,0,212,874,1,52,-1,,926,213,0.0
5,1,53,1,1,1,212,874,1,52,95, ,926,213,0.0
2,1,54,0,0,0,596,874,1,52,-1,,926,597,0.0
3,1,54,1,0,0,596,874,1,52,-1,,926,597,0.0
4,1,54,1,1,0,596,874,1,52,-1,,926,597,0.0
5,1,54,1,1,1,596,874,1,52,95, ,926,597,0.0
2,1,55,0,0,0,1,923,1235,5,-1,,928,1236,0.0
3,1,55,1,0,0,1,923,1235,5,-1,,928,1236,0.0
4,1,55,1,1,0,1,923,1235,5,-1,,928,1236,0.0
5,1,55,1,1,1,1,923,1235,5,95, ,928,1236,0.0
2,1,56,0,0,0,1,974,1235,5,-1,,979,1236,0.0
3,1,56,1,0,0,1,974,1235,5,-1,,979,1236,0.0
4,1,56,1,1,0,1,974,1235,5,-1,,979,1236,0.0
5,1,56,1,1,1,1,974,1235,5,95, ,979,1236,0.0
2,1,57,0,0,0,660,1026,576,3,-1,,1029,1236,0.0
3,1,57,1,0,0,660,1026,576,3,-1,,1029,1236,0.0
4,1,57,1,1,0,660,1026,576,3,-1,,1029,1236,0.0
5,1,57,1,1,1,660,1026,576,3,95, ,1029,1236,0.0
2,1,58,0,0,0,660,1077,576,3,-1,,1080,1236,0.0
3,1,58,1,0,0,660,1077,576,3,-1,,1080,1236,0.0
4,1,58,1,1,0,660,1077,576,3,-1,,1080,1236,0.0
5,1,58,1,1,1,660,1077,576,3,95, ,1080,1236,0.0
2,1,59,0,0,0,1,1127,1235,5,-1,,1132,1236,0.0
3,1,59,1,0,0,1,1127,1235,5,-1,,1132,1236,0.0
4,1,59,1,1,0,1,1127,1235,5,-1,,1132,1236,0.0
5,1,59,1,1,1,1,1127,1235,5,95, ,1132,1236,0.0
2,1,60,0,0,0,1,1178,1235,5,-1,,1183,1236,0.0
3,1,60,1,0,0,1,1178,1235,5,-1,,1183,1236,0.0
4,1,60,1,1,0,1,1178,1235,5,-1,,1183,1236,0.0
5,1,60,1,1,1,1,1178,1235,5,95, ,1183,1236,0.0
2,1,61,0,0,0,660,1236,576,3,-1,,1239,1236,0.0
3,1,61,1,0,0,660,1236,576,3,-1,,1239,1236,0.0
4,1,61,1,1,0,660,1236,576,3,-1,,1239,1236,0.0
5,1,61,1,1,1,660,1236,576,3,95, ,1239,1236,0.0
2,1,62,0,0,0,689,1266,204,3,-1,,1269,893,0.0
3,1,62,1,0,0,689,1266,204,3,-1,,1269,893,0.0
4,1,62,1,1,0,689,1266,204,3,-1,,1269,893,0.0
5,1,62,1,1,1,689,1266,204,3,95, ,1269,893,0.0
2,1,63,0,0,0,689,1267,1,28,-1,,1295,690,0.0
3,1,63,1,0,0,689,1267,1,28,-1,,1295,690,0.0
4,1,63,1,1,0,689,1267,1,28,-1,,1295,690,0.0
5,1,63,1,1,1,689,1267,1,28,95, ,1295,690,0.0
2,1,64,0,0,0,718,1267,1,28,-1,,1295,719,0.0
3,1,64,1,0,0,718,1267,1,28,-1,,1295,719,0.0
4,1,64,1,1,0,718,1267,1,28,-1,,1295,719,0.0
5,1,64,1,1,1,718,1267,1,28,95, ,1295,719,0.0
2,1,65,0,0,0,776,1267,1,28,-1,,1295,777,0.0
3,1,65,1,0,0,776,1267,1,28,-1,,1295,777,0.0
4,1,65,1,1,0,776,1267,1,28,-1,,1295,777,0.0
5,1,65,1,1,1,776,1267,1,28,95, ,1295,777,0.0
2,1,66,0,0,0,805,1267,1,28,-1,,1295,806,0.0
3,1,66,1,0,0,805,1267,1,28,-1,,1295,806,0.0
4,1,66,1,1,0,805,1267,1,28,-1,,1295,806,0.0
5,1,66,1,1,1,805,1267,1,28,95, ,1295,806,0.0
2,1,67,0,0,0,863,1267,1,28,-1,,1295,864,0.0
3,1,67,1,0,0,863,1267,1,28,-1,,1295,864,0.0
4,1,67,1,1,0,863,1267,1,28,-1,,1295,864,0.0
5,1,67,1,1,1,863,1267,1,28,95, ,1295,864,0.0
2,1,68,0,0,0,892,1267,1,28,-1,,1295,893,0.0
3,1,68,1,0,0,892,1267,1,28,-1,,1295,893,0.0
4,1,68,1,1,0,892,1267,1,28,-1,,1295,893,0.0
5,1,68,1,1,1,892,1267,1,28,95, ,1295,893,0.0
2,1,69,0,0,0,660,1293,576,5,-1,,1298,1236,0.0
3,1,69,1,0,0,660,1293,576,5,-1,,1298,1236,0.0
4,1,69,1,1,0,660,1293,576,5,-1,,1298,1236,0.0
5,1,69,1,1,1,660,1293,576,5,95, ,1298,1236,0.0
2,1,70,0,0,0,11,878,1217,553,-1,,1431,1228,0.0
3,1,70,1,0,0,11,878,1217,553,-1,,1431,1228,0.0
4,1,70,1,1,0,55,878,1137,16,-1,,894,1192,0.0
5,1,70,1,1,1,55,879,103,15,91,REISSUED,894,158,0.0
5,1,70,1,1,2,216,881,6,7,60,[a,888,222,0.0
5,1,70,1,1,3,236,878,71,13,30,Employee's,891,307,0.0
5,1,70,1,1,4,311,878,36,10,96,social,888,347,0.0
5,1,70,1,1,5,352,878,48,13,96,security,891,400,0.0
5,1,70,1,1,6,406,878,48,10,96,number,888,454,0.0
5,1,70,1,1,7,750,878,23,10,95,This,888,773,0.0
5,1,70,1,1,8,779,878,61,10,96,information,888,840,0.0
5,1,70,1,1,9,846,881,8,7,90,is,888,854,0.0
5,1,70,1,1,10,860,878,29,13,90,being,891,889,0.0
5,1,70,1,1,11,894,878,51,10,93,furnished,888,945,0.0
5,1,70,1,1,12,950,879,10,9,96,to,888,960,0.0
5,1,70,1,1,13,965,878,17,10,96,the,888,982,0.0
5,1,70,1,1,14,988,878,40,10,84,Internal,888,1028,0.0
5,1,70,1,1,15,1034,878,47,10,93,Revenue,888,1081,0.0
5,1,70,1,1,16,1087,878,40,10,74,Senice.,888,1127,0.0
5,1,70,1,1,17,1141,878,6,10,77,If,888,1147,0.0
5,1,70,1,1,18,1150,881,20,10,77,you,891,1170,0.0
5,1,70,1,1,19,1176,881,16,7,94,are,888,1192,0.0
4,1,70,1,2,0,751,895,477,13,-1,,908,1228,0.0
5,1,70,1,2,1,751,895,44,13,95,required,908,795,0.0
5,1,70,1,2,2,800,887,8,26,96,to,913,808,0.0
5,1,70,1,2,3,805,895,25,10,96,file,905,830,0.0
5,1,70,1,2,4,836,898,5,7,78,a,905,841,0.0
5,1,70,1,2,5,846,896,18,9,78,tax,905,864,0.0
5,1,70,1,2,6,869,896,35,10,65,"return,",906,904,0.0
5,1,70,1,2,7,910,898,5,7,95,a,905,915,0.0
5,1,70,1,2,8,921,895,60,13,96,negligence,908,981,0.0
5,1,70,1,2,9,987,895,41,13,96,penalty,908,1028,0.0
5,1,70,1,2,10,1033,898,10,7,95,or,905,1043,0.0
5,1,70,1,2,11,1048,895,28,10,96,other,905,1076,0.0
5,1,70,1,2,12,1081,896,47,9,96,sanction,905,1128,0.0
5,1,70,1,2,13,1134,898,24,10,97,may,908,1158,0.0
5,1,70,1,2,14,1163,895,12,10,96,be,905,1175,0.0
5,1,70,1,2,15,1181,895,47,13,88,imposed,908,1228,0.0
4,1,70,1,3,0,44,903,1018,22,-1,,925,1062,0.0
5,1,70,1,3,1,44,906,126,15,96,STATEMENT,921,170,0.0
5,1,70,1,3,2,312,903,150,15,58,768-05-9800,918,462,0.0
5,1,70,1,3,3,612,903,28,10,96,OMB,913,640,0.0
5,1,70,1,3,4,646,903,14,10,79,No.,913,660,0.0
5,1,70,1,3,5,671,903,57,10,80,1645-0008,913,728,0.0
5,1,70,1,3,6,751,915,12,7,50,on,922,763,0.0
5,1,70,1,3,7,776,915,12,7,38,you,922,788,0.0
5,1,70,1,3,8,794,912,6,10,38,if,922,800,0.0
5,1,70,1,3,9,803,912,20,10,79,this,922,823,0.0
5,1,70,1,3,10,829,915,40,7,55,income,922,869,0.0
5,1,70,1,3,11,875,915,8,7,92,is,922,883,0.0
5,1,70,1,3,12,888,912,41,10,92,taxable,922,929,0.0
5,1,70,1,3,13,935,912,19,10,96,and,922,954,0.0
5,1,70,1,3,14,967,915,12,7,75,you,922,979,0.0
5,1,70,1,3,15,984,912,15,10,75,fail,922,999,0.0
5,1,70,1,3,16,1004,913,10,9,86,to,922,1014,0.0
5,1,70,1,3,17,1020,913,31,12,52,report,925,1051,0.0
5,1,70,1,3,18,1057,913,5,9,52,it,922,1062,0.0
4,1,70,1,4,0,12,929,1143,13,-1,,942,1155,0.0
5,1,70,1,4,1,12,929,7,10,81,b,939,19,0.0
5,1,70,1,4,2,29,929,54,13,93,Employer,942,83,0.0
5,1,70,1,4,3,88,929,70,10,95,identification,939,158,0.0
5,1,70,1,4,4,164,929,42,10,96,number,939,206,0.0
5,1,70,1,4,5,681,929,4,10,59,1,939,685,0.0
5,1,70,1,4,6,704,929,40,13,85,"Wages,",942,744,0.0
5,1,70,1,4,7,753,930,20,12,95,"tips,",942,773,0.0
5,1,70,1,4,8,783,929,28,10,96,other,939,811,0.0
5,1,70,1,4,9,816,930,79,12,95,compensation,942,895,0.0
5,1,70,1,4,10,970,929,7,10,0,2,939,977,0.0
5,1,70,1,4,11,995,929,41,10,68,Federal,939,1036,0.0
5,1,70,1,4,12,1042,932,40,7,95,income,939,1082,0.0
5,1,70,1,4,13,1087,930,18,9,96,tax,939,1105,0.0
5,1,70,1,4,14,1109,929,46,10,96,withheld,939,1155,0.0
4,1,70,1,5,0,66,954,1028,15,-1,,969,1094,0.0
5,1,70,1,5,1,66,954,136,15,92,83-1015714,969,202,0.0
5,1,70,1,5,2,725,954,108,15,90,168250.2,969,833,0.0
5,1,70,1,5,3,986,954,108,15,90,53860.77,969,1094,0.0
4,1,70,1,6,0,13,980,1139,13,-1,,993,1152,0.0
5,1,70,1,6,1,13,983,6,7,33,ยข,990,19,0.0
5,1,70,1,6,2,29,980,62,13,93,Employers,993,91,0.0
5,1,70,1,6,3,97,983,30,7,93,"name,",990,127,0.0
5,1,70,1,6,4,137,980,44,10,92,"address,",990,181,0.0
5,1,70,1,6,5,191,980,19,10,94,and,990,210,0.0
5,1,70,1,6,6,215,980,18,10,95,ZIP,990,233,0.0
5,1,70,1,6,7,239,980,26,10,96,code,990,265,0.0
5,1,70,1,6,8,681,980,6,10,65,3,990,687,0.0
5,1,70,1,6,9,705,980,34,10,89,Social,990,739,0.0
5,1,70,1,6,10,745,972,45,25,94,security,997,790,0.0
5,1,70,1,6,11,797,983,33,10,96,wages,993,830,0.0
5,1,70,1,6,12,970,980,7,10,46,4,990,977,0.0
5,1,70,1,6,13,995,980,34,10,81,Social,990,1029,0.0
5,1,70,1,6,14,1035,980,117,13,96,security,993,1152,0.0
5,1,70,1,6,15,1084,972,18,25,96,tax,997,1102,0.0
5,1,70,1,6,16,1107,980,45,13,96,withheld,993,1152,0.0
4,1,70,1,7,0,64,1005,1030,15,-1,,1020,1094,0.0
5,1,70,1,7,1,64,1005,69,15,96,White,1020,133,0.0
5,1,70,1,7,2,149,1006,40,14,96,PLC,1020,189,0.0
5,1,70,1,7,3,206,1006,39,14,96,Inc,1020,245,0.0
5,1,70,1,7,4,725,1005,80,15,0,159372,1020,805,0.0
5,1,70,1,7,5,812,1005,35,15,0,.62,1020,847,0.0
5,1,70,1,7,6,986,1005,108,15,90,12192.01,1020,1094,0.0
4,1,70,1,8,0,65,1031,1054,28,-1,,1059,1119,0.0
5,1,70,1,8,1,65,1039,68,15,96,21769,1054,133,0.0
5,1,70,1,8,2,148,1039,83,15,96,Walker,1054,231,0.0
5,1,70,1,8,3,247,1039,97,20,96,Landing,1059,344,0.0
5,1,70,1,8,4,681,1031,6,10,68,5,1041,687,0.0
5,1,70,1,8,5,705,1031,51,10,78,Medicare,1041,756,0.0
5,1,70,1,8,6,761,1034,36,10,96,wages,1044,797,0.0
5,1,70,1,8,7,803,1031,19,10,89,and,1041,822,0.0
5,1,70,1,8,8,827,1032,20,12,89,tips,1044,847,0.0
5,1,70,1,8,9,970,1031,6,10,64,6,1041,976,0.0
5,1,70,1,8,10,995,1031,51,10,71,Medicare,1041,1046,0.0
5,1,70,1,8,11,1051,1032,18,9,96,tax,1041,1069,0.0
5,1,70,1,8,12,1073,1031,46,10,94,withheld,1041,1119,0.0
4,1,70,1,9,0,724,1056,420,15,-1,,1071,1144,0.0
5,1,70,1,9,1,724,1056,124,15,92,206499.26,1071,848,0.0
5,1,70,1,9,2,1050,1056,94,15,94,5988.48,1071,1144,0.0
4,1,70,1,10,0,64,1073,1008,22,-1,,1095,1072,0.0
5,1,70,1,10,1,64,1073,125,15,91,Bakerfurt,1088,189,0.0
5,1,70,1,10,2,246,1074,28,14,88,NJ,1088,274,0.0
5,1,70,1,10,3,304,1073,137,15,95,06199-9819,1088,441,0.0
5,1,70,1,10,4,681,1082,5,10,80,T,1092,686,0.0
5,1,70,1,10,5,705,1082,34,10,96,Social,1092,739,0.0
5,1,70,1,10,6,747,1070,41,29,95,security,1099,788,0.0
5,1,70,1,10,7,795,1083,19,12,96,tips,1095,814,0.0
5,1,70,1,10,8,971,1082,5,10,46,@,1092,976,0.0
5,1,70,1,10,9,994,1082,53,10,91,Allocated,1092,1047,0.0
5,1,70,1,10,10,1052,1083,20,12,71,tips,1095,1072,0.0
4,1,70,1,11,0,725,1107,446,15,-1,,1122,1171,0.0
5,1,70,1,11,1,725,1107,122,15,86,159372.62,1122,847,0.0
5,1,70,1,11,2,1049,1107,122,15,89,206499.26,1122,1171,0.0
4,1,70,1,12,0,11,1133,1122,13,-1,,1146,1133,0.0
5,1,70,1,12,1,11,1133,57,10,0,โControl,1143,68,0.0
5,1,70,1,12,2,74,1133,42,10,96,number,1143,116,0.0
5,1,70,1,12,3,680,1133,7,10,66,9,1143,687,0.0
5,1,70,1,12,4,704,1133,48,10,66,Advance,1143,752,0.0
5,1,70,1,12,5,758,1133,19,10,92,EIC,1143,777,0.0
5,1,70,1,12,6,783,1134,48,12,96,payment,1146,831,0.0
5,1,70,1,12,7,964,1133,13,10,79,40,1143,977,0.0
5,1,70,1,12,8,995,1133,60,13,71,Dependent,1146,1055,0.0
5,1,70,1,12,9,1061,1136,23,7,92,care,1143,1084,0.0
5,1,70,1,12,10,1090,1133,43,10,92,benefits,1143,1133,0.0
4,1,70,1,13,0,66,1158,1022,15,-1,,1173,1088,0.0
5,1,70,1,13,1,66,1158,95,15,95,7480956,1173,161,0.0
5,1,70,1,13,2,1050,1158,38,15,96,164,1173,1088,0.0
4,1,70,1,14,0,12,1184,1163,13,-1,,1197,1175,0.0
5,1,70,1,14,1,12,1187,6,7,28,@,1194,18,0.0
5,1,70,1,14,2,29,1184,65,13,74,Employee's,1197,94,0.0
5,1,70,1,14,3,99,1184,20,10,96,first,1194,119,0.0
5,1,70,1,14,4,125,1187,30,7,96,name,1194,155,0.0
5,1,70,1,14,5,161,1184,19,10,96,and,1194,180,0.0
5,1,70,1,14,6,186,1184,28,10,94,initial,1194,214,0.0
5,1,70,1,14,7,280,1184,23,10,96,Last,1194,303,0.0
5,1,70,1,14,8,309,1187,30,7,94,name,1194,339,0.0
5,1,70,1,14,9,674,1184,11,10,60,11,1194,685,0.0
5,1,70,1,14,10,705,1184,68,13,79,Nonqualified,1197,773,0.0
5,1,70,1,14,11,779,1184,29,13,76,plans,1197,808,0.0
5,1,70,1,14,12,966,1184,20,10,32,12a,1194,986,0.0
5,1,70,1,14,13,1009,1184,22,10,62,See,1194,1031,0.0
5,1,70,1,14,14,1037,1184,92,10,95,instructions,1194,1129,0.0
5,1,70,1,14,15,1112,1176,19,25,96,for,1201,1131,0.0
5,1,70,1,14,16,1134,1184,22,10,96,box,1194,1156,0.0
5,1,70,1,14,17,1162,1184,13,10,90,12,1194,1175,0.0
4,1,70,1,15,0,725,1215,377,15,-1,,1230,1102,0.0
5,1,70,1,15,1,725,1215,39,15,95,149,1230,764,0.0
5,1,70,1,15,2,1050,1215,52,15,96,6335,1230,1102,0.0
4,1,70,1,16,0,65,1230,922,28,-1,,1258,987,0.0
5,1,70,1,16,1,65,1230,94,16,96,Trevor,1246,159,0.0
5,1,70,1,16,2,192,1230,95,16,96,Duncan,1246,287,0.0
5,1,70,1,16,3,674,1241,13,10,87,13,1251,687,0.0
5,1,70,1,16,4,693,1242,43,10,75,Statutory,1252,736,0.0
5,1,70,1,16,5,776,1237,53,21,61,Retirement,1258,829,0.0
5,1,70,1,16,6,866,1237,58,21,48,Third-party.,1258,924,0.0
5,1,70,1,16,7,966,1241,21,10,84,12b,1251,987,0.0
4,1,70,1,17,0,693,1257,213,10,-1,,1267,906,0.0
5,1,70,1,17,1,693,1257,44,10,56,empoyee,1267,737,0.0
5,1,70,1,17,2,780,1257,18,10,40,plan,1267,798,0.0
5,1,70,1,17,3,867,1257,18,8,95,sick,1265,885,0.0
5,1,70,1,17,4,889,1259,17,8,94,pay,1267,906,0.0
4,1,70,1,18,0,66,1269,1023,22,-1,,1291,1089,0.0
5,1,70,1,18,1,66,1269,76,17,96,41435,1286,142,0.0
5,1,70,1,18,2,161,1269,93,22,96,Hughes,1291,254,0.0
5,1,70,1,18,3,272,1270,79,16,96,Drive,1286,351,0.0
5,1,70,1,18,4,1050,1271,39,15,95,663,1286,1089,0.0
4,1,70,1,19,0,674,1300,312,13,-1,,1313,986,0.0
5,1,70,1,19,1,674,1300,13,10,51,44,1310,687,0.0
5,1,70,1,19,2,705,1300,31,10,82,Other,1310,736,0.0
5,1,70,1,19,3,741,1301,23,12,87,(see,1313,764,0.0
5,1,70,1,19,4,770,1300,50,10,96,enclosed,1310,820,0.0
5,1,70,1,19,5,826,1300,35,10,94,Notice,1310,861,0.0
5,1,70,1,19,6,866,1301,10,9,96,to,1310,876,0.0
5,1,70,1,19,7,882,1300,61,13,96,Employee),1313,943,0.0
5,1,70,1,19,8,949,1292,9,25,48,|,1317,958,0.0
5,1,70,1,19,9,966,1300,20,10,39,12c,1310,986,0.0
4,1,70,1,20,0,64,1308,494,22,-1,,1330,558,0.0
5,1,70,1,20,1,64,1309,48,16,93,New,1325,112,0.0
5,1,70,1,20,2,129,1308,159,22,91,Teresaberg,1330,288,0.0
5,1,70,1,20,3,352,1309,30,16,95,KS,1325,382,0.0
5,1,70,1,20,4,403,1308,155,17,95,99528-9775,1325,558,0.0
4,1,70,1,21,0,1007,1331,82,15,-1,,1346,1089,0.0
5,1,70,1,21,1,1007,1332,12,14,53,P,1346,1019,0.0
5,1,70,1,21,2,1050,1331,39,15,33,/136,1346,1089,0.0
4,1,70,1,22,0,966,1357,20,10,-1,,1367,986,0.0
5,1,70,1,22,1,966,1357,20,10,88,12d,1367,986,0.0
4,1,70,1,23,0,1050,1388,39,15,-1,,1403,1089,0.0
5,1,70,1,23,1,1050,1388,39,15,95,986,1403,1089,0.0
4,1,70,1,24,0,11,1418,213,13,-1,,1431,224,0.0
5,1,70,1,24,1,11,1418,5,10,91,f,1428,16,0.0
5,1,70,1,24,2,29,1418,65,13,46,Employee's,1431,94,0.0
5,1,70,1,24,3,100,1418,44,10,92,address,1428,144,0.0
5,1,70,1,24,4,150,1418,19,10,96,and,1428,169,0.0
5,1,70,1,24,5,174,1418,18,10,94,ZIP,1428,192,0.0
5,1,70,1,24,6,197,1418,27,10,96,code,1428,224,0.0
2,1,71,0,0,0,659,925,3,507,-1,,1432,662,0.0
3,1,71,1,0,0,659,925,3,507,-1,,1432,662,0.0
4,1,71,1,1,0,659,925,3,507,-1,,1432,662,0.0
5,1,71,1,1,1,659,925,3,507,95, ,1432,662,0.0
2,1,72,0,0,0,689,1293,547,5,-1,,1298,1236,0.0
3,1,72,1,0,0,689,1293,547,5,-1,,1298,1236,0.0
4,1,72,1,1,0,689,1293,547,5,-1,,1298,1236,0.0
5,1,72,1,1,1,689,1293,547,5,95, ,1298,1236,0.0
2,1,73,0,0,0,689,1293,547,5,-1,,1298,1236,0.0
3,1,73,1,0,0,689,1293,547,5,-1,,1298,1236,0.0
4,1,73,1,1,0,689,1293,547,5,-1,,1298,1236,0.0
5,1,73,1,1,1,689,1293,547,5,95, ,1298,1236,0.0
2,1,74,0,0,0,689,1293,547,5,-1,,1298,1236,0.0
3,1,74,1,0,0,689,1293,547,5,-1,,1298,1236,0.0
4,1,74,1,1,0,689,1293,547,5,-1,,1298,1236,0.0
5,1,74,1,1,1,689,1293,547,5,95, ,1298,1236,0.0
2,1,75,0,0,0,950,1353,286,1,-1,,1354,1236,0.0
3,1,75,1,0,0,950,1353,286,1,-1,,1354,1236,0.0
4,1,75,1,1,0,950,1353,286,1,-1,,1354,1236,0.0
5,1,75,1,1,1,950,1353,286,1,95, ,1354,1236,0.0
2,1,76,0,0,0,1042,1197,3,214,-1,,1411,1045,0.0
3,1,76,1,0,0,1042,1197,3,214,-1,,1411,1045,0.0
4,1,76,1,1,0,1042,1197,3,214,-1,,1411,1045,0.0
5,1,76,1,1,1,1042,1197,3,214,95, ,1411,1045,0.0
2,1,77,0,0,0,950,1410,286,1,-1,,1411,1236,0.0
3,1,77,1,0,0,950,1410,286,1,-1,,1411,1236,0.0
4,1,77,1,1,0,950,1410,286,1,-1,,1411,1236,0.0
5,1,77,1,1,1,950,1410,286,1,95, ,1411,1236,0.0
2,1,78,0,0,0,949,925,3,507,-1,,1432,952,0.0
3,1,78,1,0,0,949,925,3,507,-1,,1432,952,0.0
4,1,78,1,1,0,949,925,3,507,-1,,1432,952,0.0
5,1,78,1,1,1,949,925,3,507,95, ,1432,952,0.0
2,1,79,0,0,0,1,1429,1235,5,-1,,1434,1236,0.0
3,1,79,1,0,0,1,1429,1235,5,-1,,1434,1236,0.0
4,1,79,1,1,0,1,1429,1235,5,-1,,1434,1236,0.0
5,1,79,1,1,1,1,1429,1235,5,95, ,1434,1236,0.0
2,1,80,0,0,0,6,1435,654,13,-1,,1448,660,0.0
3,1,80,1,0,0,6,1435,654,13,-1,,1448,660,0.0
4,1,80,1,1,0,6,1435,654,13,-1,,1448,660,0.0
5,1,80,1,1,1,6,1435,13,10,88,15,1445,19,0.0
5,1,80,1,1,2,29,1435,29,10,58,State!,1445,58,0.0
5,1,80,1,1,3,88,1435,62,13,54,Employer's,1448,150,0.0
5,1,80,1,1,4,156,1436,27,9,86,state,1445,183,0.0
5,1,80,1,1,5,189,1435,10,10,86,ID,1445,199,0.0
5,1,80,1,1,6,205,1435,42,10,95,number,1445,247,0.0
5,1,80,1,1,7,349,1435,11,10,53,16,1445,360,0.0
5,1,80,1,1,8,370,1435,29,10,93,State,1445,399,0.0
5,1,80,1,1,9,404,1438,36,10,90,"wages,",1448,440,0.0
5,1,80,1,1,10,449,1436,20,12,90,"tips,",1448,469,0.0
5,1,80,1,1,11,479,1436,16,9,77,etc,1445,495,0.0
5,1,80,1,1,12,541,1435,12,10,59,TT,1445,553,0.0
5,1,80,1,1,13,562,1435,29,10,90,State,1445,591,0.0
5,1,80,1,1,14,597,1438,40,7,92,income,1445,637,0.0
5,1,80,1,1,15,642,1436,18,9,96,tax,1445,660,0.0
2,1,81,0,0,0,0,1456,1236,31,-1,,1487,1236,0.0
3,1,81,1,0,0,0,1456,1236,31,-1,,1487,1236,0.0
4,1,81,1,1,0,0,1456,1236,31,-1,,1487,1236,0.0
5,1,81,1,1,1,0,1456,1236,31,95, ,1487,1236,0.0
2,1,82,0,0,0,59,1431,1,104,-1,,1535,60,0.0
3,1,82,1,0,0,59,1431,1,104,-1,,1535,60,0.0
4,1,82,1,1,0,59,1431,1,104,-1,,1535,60,0.0
5,1,82,1,1,1,59,1431,1,104,95, ,1535,60,0.0
2,1,83,0,0,0,340,1431,1,104,-1,,1535,341,0.0
3,1,83,1,0,0,340,1431,1,104,-1,,1535,341,0.0
4,1,83,1,1,0,340,1431,1,104,-1,,1535,341,0.0
5,1,83,1,1,1,340,1431,1,104,95, ,1535,341,0.0
2,1,84,0,0,0,532,1431,1,104,-1,,1535,533,0.0
3,1,84,1,0,0,532,1431,1,104,-1,,1535,533,0.0
4,1,84,1,1,0,532,1431,1,104,-1,,1535,533,0.0
5,1,84,1,1,1,532,1431,1,104,95, ,1535,533,0.0
2,1,85,0,0,0,0,1530,341,9,-1,,1539,341,0.0
3,1,85,1,0,0,0,1530,341,9,-1,,1539,341,0.0
4,1,85,1,1,0,0,1530,341,9,-1,,1539,341,0.0
5,1,85,1,1,1,0,1530,341,9,95, ,1539,341,0.0
2,1,86,0,0,0,727,1435,146,13,-1,,1448,873,0.0
3,1,86,1,0,0,727,1435,146,13,-1,,1448,873,0.0
4,1,86,1,1,0,727,1435,146,13,-1,,1448,873,0.0
5,1,86,1,1,1,727,1435,11,10,69,78,1445,738,0.0
5,1,86,1,1,2,748,1435,29,10,94,Local,1445,777,0.0
5,1,86,1,1,3,782,1438,40,10,94,"wages,",1448,822,0.0
5,1,86,1,1,4,827,1436,20,12,94,"tips,",1448,847,0.0
5,1,86,1,1,5,857,1436,16,9,75,etc,1445,873,0.0
2,1,87,0,0,0,929,1435,287,13,-1,,1448,1216,0.0
3,1,87,1,0,0,929,1435,287,13,-1,,1448,1216,0.0
4,1,87,1,1,0,929,1435,287,13,-1,,1448,1216,0.0
5,1,87,1,1,1,929,1435,12,10,63,49,1445,941,0.0
5,1,87,1,1,2,951,1435,29,10,86,Local,1445,980,0.0
5,1,87,1,1,3,986,1438,40,7,96,income,1445,1026,0.0
5,1,87,1,1,4,1031,1436,18,9,95,tax,1445,1049,0.0
5,1,87,1,1,5,1114,1435,13,10,88,20,1445,1127,0.0
5,1,87,1,1,6,1137,1435,44,13,92,Locality,1448,1181,0.0
5,1,87,1,1,7,1186,1438,30,7,91,name,1445,1216,0.0
2,1,88,0,0,0,725,1512,312,15,-1,,1527,1037,0.0
3,1,88,1,0,0,725,1512,312,15,-1,,1527,1037,0.0
4,1,88,1,1,0,725,1512,312,15,-1,,1527,1037,0.0
5,1,88,1,1,1,725,1512,79,15,0,137013,1527,804,0.0
5,1,88,1,1,2,812,1512,35,15,0,.88,1527,847,0.0
5,1,88,1,1,3,927,1512,110,15,90,24146.13,1527,1037,0.0
2,1,89,0,0,0,1234,874,2,661,-1,,1535,1236,0.0
3,1,89,1,0,0,1234,874,2,661,-1,,1535,1236,0.0
4,1,89,1,1,0,1234,874,2,661,-1,,1535,1236,0.0
5,1,89,1,1,1,1234,874,2,661,95, ,1535,1236,0.0
2,1,90,0,0,0,717,1267,3,268,-1,,1535,720,0.0
3,1,90,1,0,0,717,1267,3,268,-1,,1535,720,0.0
4,1,90,1,1,0,717,1267,3,268,-1,,1535,720,0.0
5,1,90,1,1,1,717,1267,3,268,95, ,1535,720,0.0
2,1,91,0,0,0,921,1431,1,104,-1,,1535,922,0.0
3,1,91,1,0,0,921,1431,1,104,-1,,1535,922,0.0
4,1,91,1,1,0,921,1431,1,104,-1,,1535,922,0.0
5,1,91,1,1,1,921,1431,1,104,95, ,1535,922,0.0
2,1,92,0,0,0,1107,1431,1,104,-1,,1535,1108,0.0
3,1,92,1,0,0,1107,1431,1,104,-1,,1535,1108,0.0
4,1,92,1,1,0,1107,1431,1,104,-1,,1535,1108,0.0
5,1,92,1,1,1,1107,1431,1,104,95, ,1535,1108,0.0
2,1,93,0,0,0,1114,1514,116,17,-1,,1531,1230,0.0
3,1,93,1,0,0,1114,1514,116,17,-1,,1531,1230,0.0
4,1,93,1,1,0,1114,1514,116,17,-1,,1531,1230,0.0
5,1,93,1,1,1,1114,1514,50,17,96,Gary,1531,1164,0.0
5,1,93,1,1,2,1179,1514,51,17,96,Loop,1531,1230,0.0
2,1,94,0,0,0,338,1533,898,3,-1,,1536,1236,0.0
3,1,94,1,0,0,338,1533,898,3,-1,,1536,1236,0.0
4,1,94,1,1,0,338,1533,898,3,-1,,1536,1236,0.0
5,1,94,1,1,1,338,1533,898,3,95, ,1536,1236,0.0
2,1,95,0,0,0,4,1512,650,88,-1,,1600,654,0.0
3,1,95,1,0,0,4,1512,650,79,-1,,1591,654,0.0
4,1,95,1,1,0,18,1512,615,15,-1,,1527,633,0.0
5,1,95,1,1,1,18,1513,27,14,90,TA,1527,45,0.0
5,1,95,1,1,2,132,1512,136,15,91,882-63-902,1527,268,0.0
5,1,95,1,1,3,347,1512,108,15,91,89324.57,1527,455,0.0
5,1,95,1,1,4,539,1512,94,15,94,4795.84,1527,633,0.0
4,1,95,1,2,0,139,1542,162,22,-1,,1564,301,0.0
5,1,95,1,2,1,139,1542,63,22,95,Wage,1564,202,0.0
5,1,95,1,2,2,211,1542,41,17,96,and,1559,252,0.0
5,1,95,1,2,3,261,1542,40,17,95,Tax,1559,301,0.0
4,1,95,1,3,0,4,1549,650,51,-1,,1600,654,0.0
5,1,95,1,3,1,4,1579,34,11,93,Form,1590,38,0.0
5,1,95,1,3,2,47,1579,25,11,89,W-2,1590,72,0.0
5,1,95,1,3,3,140,1569,114,31,96,Statement,1600,254,0.0
5,1,95,1,3,4,549,1549,27,42,18,c,1591,576,0.0
5,1,95,1,3,5,588,1549,27,42,58,0,1591,615,0.0
5,1,95,1,3,6,628,1549,26,42,59,1,1591,654,0.0
2,1,96,0,0,0,5,1602,291,37,-1,,1639,296,0.0
3,1,96,1,0,0,5,1602,291,37,-1,,1639,296,0.0
4,1,96,1,1,0,5,1602,291,15,-1,,1617,296,0.0
5,1,96,1,1,1,5,1602,40,15,93,Copy,1617,45,0.0
5,1,96,1,1,2,51,1602,10,12,91,C,1614,61,0.0
5,1,96,1,1,3,68,1602,26,12,96,For,1614,94,0.0
5,1,96,1,1,4,100,1602,103,12,86,EMPLOYEE'S,1614,203,0.0
5,1,96,1,1,5,210,1602,86,12,96,RECORDS.,1614,296,0.0
4,1,96,1,2,0,5,1624,276,15,-1,,1639,281,0.0
5,1,96,1,2,1,5,1624,33,15,95,(See,1639,38,0.0
5,1,96,1,2,2,44,1624,69,12,96,enclosed,1636,113,0.0
5,1,96,1,2,3,120,1624,49,12,96,Notice,1636,169,0.0
5,1,96,1,2,4,174,1624,16,12,96,to,1636,190,0.0
5,1,96,1,2,5,196,1624,85,15,95,Employee.),1639,281,0.0
2,1,97,0,0,0,864,1547,367,15,-1,,1562,1231,0.0
3,1,97,1,0,0,864,1547,367,15,-1,,1562,1231,0.0
4,1,97,1,1,0,864,1547,367,15,-1,,1562,1231,0.0
5,1,97,1,1,1,864,1547,81,15,95,Department,1562,945,0.0
5,1,97,1,1,2,950,1547,12,12,95,of,1559,962,0.0
5,1,97,1,1,3,966,1547,20,12,93,the,1559,986,0.0
5,1,97,1,1,4,991,1547,118,15,64,Treasury-Internal,1562,1109,0.0
5,1,97,1,1,5,1115,1547,59,12,94,Revenue,1559,1174,0.0
5,1,97,1,1,6,1180,1547,51,12,96,Service,1559,1231,0.0
2,1,98,0,0,0,666,1549,519,76,-1,,1625,1185,0.0
3,1,98,1,0,0,666,1549,519,76,-1,,1625,1185,0.0
4,1,98,1,1,0,666,1549,519,76,-1,,1625,1185,0.0
5,1,98,1,1,1,666,1549,27,42,64,0,1591,693,0.0
5,1,98,1,1,2,1044,1574,141,51,0,<2zT>,1625,1185,0.0
2,1,99,0,0,0,926,1575,110,33,-1,,1608,1036,0.0
3,1,99,1,0,0,926,1575,110,33,-1,,1608,1036,0.0
4,1,99,1,1,0,927,1575,109,15,-1,,1590,1036,0.0
5,1,99,1,1,1,927,1575,35,15,92,"Safe,",1590,962,0.0
5,1,99,1,1,2,967,1575,69,15,92,"accurate,",1590,1036,0.0
4,1,99,1,2,0,926,1596,82,12,-1,,1608,1008,0.0
5,1,99,1,2,1,926,1596,44,12,94,FAST!,1608,970,0.0
5,1,99,1,2,2,980,1596,28,12,94,Use,1608,1008,0.0
1,1,0,0,0,0,0,0,1236,1658,-1,,1658,1236,0.0
2,1,1,0,0,0,596,1,1,50,-1,,51,597,0.0
3,1,1,1,0,0,596,1,1,50,-1,,51,597,0.0
4,1,1,1,1,0,596,1,1,50,-1,,51,597,0.0
5,1,1,1,1,1,596,1,1,50,95, ,51,597,0.0
2,1,2,0,0,0,1,50,658,3,-1,,53,659,0.0
3,1,2,1,0,0,1,50,658,3,-1,,53,659,0.0
4,1,2,1,1,0,1,50,658,3,-1,,53,659,0.0
5,1,2,1,1,1,1,50,658,3,95, ,53,659,0.0
2,1,3,0,0,0,1,102,658,3,-1,,105,659,0.0
3,1,3,1,0,0,1,102,658,3,-1,,105,659,0.0
4,1,3,1,1,0,1,102,658,3,-1,,105,659,0.0
5,1,3,1,1,1,1,102,658,3,95, ,105,659,0.0
2,1,4,0,0,0,1,256,658,3,-1,,259,659,0.0
3,1,4,1,0,0,1,256,658,3,-1,,259,659,0.0
4,1,4,1,1,0,1,256,658,3,-1,,259,659,0.0
5,1,4,1,1,1,1,256,658,3,95, ,259,659,0.0
2,1,5,0,0,0,1,308,658,3,-1,,311,659,0.0
3,1,5,1,0,0,1,308,658,3,-1,,311,659,0.0
4,1,5,1,1,0,1,308,658,3,-1,,311,659,0.0
5,1,5,1,1,1,1,308,658,3,95, ,311,659,0.0
2,1,6,0,0,0,660,155,576,1,-1,,156,1236,0.0
3,1,6,1,0,0,660,155,576,1,-1,,156,1236,0.0
4,1,6,1,1,0,660,155,576,1,-1,,156,1236,0.0
5,1,6,1,1,1,660,155,576,1,95, ,156,1236,0.0
2,1,7,0,0,0,660,206,576,1,-1,,207,1236,0.0
3,1,7,1,0,0,660,206,576,1,-1,,207,1236,0.0
4,1,7,1,1,0,660,206,576,1,-1,,207,1236,0.0
5,1,7,1,1,1,660,206,576,1,95, ,207,1236,0.0
2,1,8,0,0,0,660,366,576,1,-1,,367,1236,0.0
3,1,8,1,0,0,660,366,576,1,-1,,367,1236,0.0
4,1,8,1,1,0,660,366,576,1,-1,,367,1236,0.0
5,1,8,1,1,1,660,366,576,1,95, ,367,1236,0.0
2,1,9,0,0,0,689,394,204,1,-1,,395,893,0.0
3,1,9,1,0,0,689,394,204,1,-1,,395,893,0.0
4,1,9,1,1,0,689,394,204,1,-1,,395,893,0.0
5,1,9,1,1,1,689,394,204,1,95, ,395,893,0.0
2,1,10,0,0,0,689,394,1,28,-1,,422,690,0.0
3,1,10,1,0,0,689,394,1,28,-1,,422,690,0.0
4,1,10,1,1,0,689,394,1,28,-1,,422,690,0.0
5,1,10,1,1,1,689,394,1,28,95, ,422,690,0.0
2,1,11,0,0,0,718,394,1,28,-1,,422,719,0.0
3,1,11,1,0,0,718,394,1,28,-1,,422,719,0.0
4,1,11,1,1,0,718,394,1,28,-1,,422,719,0.0
5,1,11,1,1,1,718,394,1,28,95, ,422,719,0.0
2,1,12,0,0,0,776,394,1,28,-1,,422,777,0.0
3,1,12,1,0,0,776,394,1,28,-1,,422,777,0.0
4,1,12,1,1,0,776,394,1,28,-1,,422,777,0.0
5,1,12,1,1,1,776,394,1,28,95, ,422,777,0.0
2,1,13,0,0,0,805,394,1,28,-1,,422,806,0.0
3,1,13,1,0,0,805,394,1,28,-1,,422,806,0.0
4,1,13,1,1,0,805,394,1,28,-1,,422,806,0.0
5,1,13,1,1,1,805,394,1,28,95, ,422,806,0.0
2,1,14,0,0,0,863,394,1,28,-1,,422,864,0.0
3,1,14,1,0,0,863,394,1,28,-1,,422,864,0.0
4,1,14,1,1,0,863,394,1,28,-1,,422,864,0.0
5,1,14,1,1,1,863,394,1,28,95, ,422,864,0.0
2,1,15,0,0,0,892,394,1,28,-1,,422,893,0.0
3,1,15,1,0,0,892,394,1,28,-1,,422,893,0.0
4,1,15,1,1,0,892,394,1,28,-1,,422,893,0.0
5,1,15,1,1,1,892,394,1,28,95, ,422,893,0.0
2,1,16,0,0,0,660,421,576,3,-1,,424,1236,0.0
3,1,16,1,0,0,660,421,576,3,-1,,424,1236,0.0
4,1,16,1,1,0,660,421,576,3,-1,,424,1236,0.0
5,1,16,1,1,1,660,421,576,3,95, ,424,1236,0.0
2,1,17,0,0,0,689,421,547,3,-1,,424,1236,0.0
3,1,17,1,0,0,689,421,547,3,-1,,424,1236,0.0
4,1,17,1,1,0,689,421,547,3,-1,,424,1236,0.0
5,1,17,1,1,1,689,421,547,3,95, ,424,1236,0.0
2,1,18,0,0,0,689,421,547,3,-1,,424,1236,0.0
3,1,18,1,0,0,689,421,547,3,-1,,424,1236,0.0
4,1,18,1,1,0,689,421,547,3,-1,,424,1236,0.0
5,1,18,1,1,1,689,421,547,3,95, ,424,1236,0.0
2,1,19,0,0,0,689,421,547,3,-1,,424,1236,0.0
3,1,19,1,0,0,689,421,547,3,-1,,424,1236,0.0
4,1,19,1,1,0,689,421,547,3,-1,,424,1236,0.0
5,1,19,1,1,1,689,421,547,3,95, ,424,1236,0.0
2,1,20,0,0,0,950,480,286,1,-1,,481,1236,0.0
3,1,20,1,0,0,950,480,286,1,-1,,481,1236,0.0
4,1,20,1,1,0,950,480,286,1,-1,,481,1236,0.0
5,1,20,1,1,1,950,480,286,1,95, ,481,1236,0.0
2,1,21,0,0,0,1043,326,1,212,-1,,538,1044,0.0
3,1,21,1,0,0,1043,326,1,212,-1,,538,1044,0.0
4,1,21,1,1,0,1043,326,1,212,-1,,538,1044,0.0
5,1,21,1,1,1,1043,326,1,212,95, ,538,1044,0.0
2,1,22,0,0,0,950,537,286,1,-1,,538,1236,0.0
3,1,22,1,0,0,950,537,286,1,-1,,538,1236,0.0
4,1,22,1,1,0,950,537,286,1,-1,,538,1236,0.0
5,1,22,1,1,1,950,537,286,1,95, ,538,1236,0.0
2,1,23,0,0,0,659,105,3,454,-1,,559,662,0.0
3,1,23,1,0,0,659,105,3,454,-1,,559,662,0.0
4,1,23,1,1,0,659,105,3,454,-1,,559,662,0.0
5,1,23,1,1,1,659,105,3,454,95, ,559,662,0.0
2,1,24,0,0,0,949,105,3,454,-1,,559,952,0.0
3,1,24,1,0,0,949,105,3,454,-1,,559,952,0.0
4,1,24,1,1,0,949,105,3,454,-1,,559,952,0.0
5,1,24,1,1,1,949,105,3,454,95, ,559,952,0.0
2,1,25,0,0,0,1,557,1235,3,-1,,560,1236,0.0
3,1,25,1,0,0,1,557,1235,3,-1,,560,1236,0.0
4,1,25,1,1,0,1,557,1235,3,-1,,560,1236,0.0
5,1,25,1,1,1,1,557,1235,3,95, ,560,1236,0.0
2,1,26,0,0,0,3,609,1113,1,-1,,610,1116,0.0
3,1,26,1,0,0,3,609,1113,1,-1,,610,1116,0.0
4,1,26,1,1,0,3,609,1113,1,-1,,610,1116,0.0
5,1,26,1,1,1,3,609,1113,1,95, ,610,1116,0.0
2,1,27,0,0,0,59,558,1,103,-1,,661,60,0.0
3,1,27,1,0,0,59,558,1,103,-1,,661,60,0.0
4,1,27,1,1,0,59,558,1,103,-1,,661,60,0.0
5,1,27,1,1,1,59,558,1,103,95, ,661,60,0.0
2,1,28,0,0,0,340,558,1,103,-1,,661,341,0.0
3,1,28,1,0,0,340,558,1,103,-1,,661,341,0.0
4,1,28,1,1,0,340,558,1,103,-1,,661,341,0.0
5,1,28,1,1,1,340,558,1,103,95, ,661,341,0.0
2,1,29,0,0,0,532,558,1,103,-1,,661,533,0.0
3,1,29,1,0,0,532,558,1,103,-1,,661,533,0.0
4,1,29,1,1,0,532,558,1,103,-1,,661,533,0.0
5,1,29,1,1,1,532,558,1,103,95, ,661,533,0.0
2,1,30,0,0,0,1234,1,2,660,-1,,661,1236,0.0
3,1,30,1,0,0,1234,1,2,660,-1,,661,1236,0.0
4,1,30,1,1,0,1234,1,2,660,-1,,661,1236,0.0
5,1,30,1,1,1,1234,1,2,660,95, ,661,1236,0.0
2,1,31,0,0,0,718,394,1,267,-1,,661,719,0.0
3,1,31,1,0,0,718,394,1,267,-1,,661,719,0.0
4,1,31,1,1,0,718,394,1,267,-1,,661,719,0.0
5,1,31,1,1,1,718,394,1,267,95, ,661,719,0.0
2,1,32,0,0,0,921,558,1,103,-1,,661,922,0.0
3,1,32,1,0,0,921,558,1,103,-1,,661,922,0.0
4,1,32,1,1,0,921,558,1,103,-1,,661,922,0.0
5,1,32,1,1,1,921,558,1,103,95, ,661,922,0.0
2,1,33,0,0,0,1107,558,1,103,-1,,661,1108,0.0
3,1,33,1,0,0,1107,558,1,103,-1,,661,1108,0.0
4,1,33,1,1,0,1107,558,1,103,-1,,661,1108,0.0
5,1,33,1,1,1,1107,558,1,103,95, ,661,1108,0.0
2,1,34,0,0,0,1,659,1235,3,-1,,662,1236,0.0
3,1,34,1,0,0,1,659,1235,3,-1,,662,1236,0.0
4,1,34,1,1,0,1,659,1235,3,-1,,662,1236,0.0
5,1,34,1,1,1,1,659,1235,3,95, ,662,1236,0.0
2,1,35,0,0,0,4,3,1230,717,-1,,720,1234,0.0
3,1,35,1,0,0,4,3,1230,717,-1,,720,1234,0.0
4,1,35,1,1,0,55,3,1138,17,-1,,20,1193,0.0
5,1,35,1,1,1,55,5,103,15,91,REISSUED,20,158,0.0
5,1,35,1,1,2,216,7,6,7,27,{a,14,222,0.0
5,1,35,1,1,3,236,0,70,24,70,Employee's,24,306,0.0
5,1,35,1,1,4,312,4,35,10,96,social,14,347,0.0
5,1,35,1,1,5,352,4,48,13,96,security,17,400,0.0
5,1,35,1,1,6,406,4,48,10,95,number,14,454,0.0
5,1,35,1,1,7,782,3,35,14,96,"Safe,",17,817,0.0
5,1,35,1,1,8,822,3,71,14,96,"Accurate,",17,893,0.0
5,1,35,1,1,9,1043,0,35,26,95,Visit,26,1078,0.0
5,1,35,1,1,10,1084,4,18,12,95,the,16,1102,0.0
5,1,35,1,1,11,1108,4,23,12,96,IRS,16,1131,0.0
5,1,35,1,1,12,1136,4,57,12,96,Website,16,1193,0.0
4,1,35,1,2,0,44,6,1136,45,-1,,51,1180,0.0
5,1,35,1,2,1,44,19,126,32,96,STATEMENT,51,170,0.0
5,1,35,1,2,2,312,28,150,15,89,036-91-4705,43,462,0.0
5,1,35,1,2,3,612,29,28,10,93,OMB,39,640,0.0
5,1,35,1,2,4,646,29,14,10,96,No.,39,660,0.0
5,1,35,1,2,5,671,29,57,10,87,1545-0008,39,728,0.0
5,1,35,1,2,6,781,28,44,12,95,FAST!,40,825,0.0
5,1,35,1,2,7,835,28,28,12,96,Use,40,863,0.0
5,1,35,1,2,8,900,6,120,45,0,e-file,51,1020,0.0
5,1,35,1,2,9,1031,6,12,45,0,),51,1043,0.0
5,1,35,1,2,10,1048,30,12,11,96,at,41,1060,0.0
5,1,35,1,2,11,1068,22,25,29,88,www,51,1093,0.0
5,1,35,1,2,12,1102,29,78,15,58,irs.goviefile.,44,1180,0.0
4,1,35,1,3,0,12,56,1143,13,-1,,69,1155,0.0
5,1,35,1,3,1,12,56,7,10,79,b,66,19,0.0
5,1,35,1,3,2,29,56,54,13,90,Employer,69,83,0.0
5,1,35,1,3,3,88,56,70,10,95,identification,66,158,0.0
5,1,35,1,3,4,164,56,42,10,96,number,66,206,0.0
5,1,35,1,3,5,681,56,4,10,70,1,66,685,0.0
5,1,35,1,3,6,704,56,40,13,79,"Wages,",69,744,0.0
5,1,35,1,3,7,753,57,24,12,95,"tips,",69,777,0.0
5,1,35,1,3,8,783,56,28,10,96,other,66,811,0.0
5,1,35,1,3,9,819,48,76,26,96,compensation,74,895,0.0
5,1,35,1,3,10,970,56,7,10,31,2,66,977,0.0
5,1,35,1,3,11,995,56,41,10,83,Federal,66,1036,0.0
5,1,35,1,3,12,1042,59,40,7,96,income,66,1082,0.0
5,1,35,1,3,13,1087,57,18,9,96,tax,66,1105,0.0
5,1,35,1,3,14,1109,56,46,10,96,withheld,66,1155,0.0
4,1,35,1,4,0,65,80,1029,15,-1,,95,1094,0.0
5,1,35,1,4,1,65,80,137,15,89,22-3437795,95,202,0.0
5,1,35,1,4,2,724,80,123,15,90,237575.44,95,847,0.0
5,1,35,1,4,3,986,80,108,15,90,85837.08,95,1094,0.0
4,1,35,1,5,0,13,108,1139,13,-1,,121,1152,0.0
5,1,35,1,5,1,13,111,6,7,48,ยข,118,19,0.0
5,1,35,1,5,2,29,108,62,13,94,Employers,121,91,0.0
5,1,35,1,5,3,97,111,30,7,87,"name,",118,127,0.0
5,1,35,1,5,4,137,108,44,10,90,"address,",118,181,0.0
5,1,35,1,5,5,191,108,19,10,96,and,118,210,0.0
5,1,35,1,5,6,215,108,18,10,96,ZIP,118,233,0.0
5,1,35,1,5,7,239,108,26,10,96,code,118,265,0.0
5,1,35,1,5,8,681,108,6,10,69,3,118,687,0.0
5,1,35,1,5,9,705,108,34,10,89,Social,118,739,0.0
5,1,35,1,5,10,745,109,45,12,93,security,121,790,0.0
5,1,35,1,5,11,794,111,36,10,96,wages,121,830,0.0
5,1,35,1,5,12,970,108,7,10,66,4,118,977,0.0
5,1,35,1,5,13,995,108,34,10,71,Social,118,1029,0.0
5,1,35,1,5,14,1036,100,43,25,96,security,125,1079,0.0
5,1,35,1,5,15,1084,109,18,9,96,tax,118,1102,0.0
5,1,35,1,5,16,1106,108,46,10,96,withheld,118,1152,0.0
4,1,35,1,6,0,64,133,1030,20,-1,,153,1094,0.0
5,1,35,1,6,1,64,134,84,19,96,Morgan,153,148,0.0
5,1,35,1,6,2,163,133,41,15,96,Ltd,148,204,0.0
5,1,35,1,6,3,219,133,41,15,96,and,148,260,0.0
5,1,35,1,6,4,276,134,53,14,96,Sons,148,329,0.0
5,1,35,1,6,5,724,133,123,15,90,278526.87,148,847,0.0
5,1,35,1,6,6,985,133,109,15,91,21307.31,148,1094,0.0
4,1,35,1,7,0,66,159,1053,28,-1,,187,1119,0.0
5,1,35,1,7,1,66,167,38,15,96,147,182,104,0.0
5,1,35,1,7,2,121,167,82,20,96,Taylor,187,203,0.0
5,1,35,1,7,3,218,167,55,15,96,Wall,182,273,0.0
5,1,35,1,7,4,681,159,6,10,70,5,169,687,0.0
5,1,35,1,7,5,705,159,51,10,79,Medicare,169,756,0.0
5,1,35,1,7,6,761,162,36,10,96,wages,172,797,0.0
5,1,35,1,7,7,803,159,19,10,89,and,169,822,0.0
5,1,35,1,7,8,827,160,20,12,89,tips,172,847,0.0
5,1,35,1,7,9,970,159,6,10,65,6,169,976,0.0
5,1,35,1,7,10,995,159,51,10,73,Medicare,169,1046,0.0
5,1,35,1,7,11,1051,160,18,9,96,tax,169,1069,0.0
5,1,35,1,7,12,1073,159,46,10,93,withheld,169,1119,0.0
4,1,35,1,8,0,725,184,420,15,-1,,199,1145,0.0
5,1,35,1,8,1,725,184,123,15,90,182944.39,199,848,0.0
5,1,35,1,8,2,1050,184,95,15,95,5305.39,199,1145,0.0
4,1,35,1,9,0,64,201,1008,22,-1,,223,1072,0.0
5,1,35,1,9,1,64,202,42,14,96,New,216,106,0.0
5,1,35,1,9,2,121,201,82,15,96,Joshua,216,203,0.0
5,1,35,1,9,3,274,202,27,14,93,NE,216,301,0.0
5,1,35,1,9,4,332,201,137,15,93,07877-3716,216,469,0.0
5,1,35,1,9,5,681,210,5,10,36,7,220,686,0.0
5,1,35,1,9,6,705,210,34,10,85,Social,220,739,0.0
5,1,35,1,9,7,747,198,41,29,81,security,227,788,0.0
5,1,35,1,9,8,793,211,21,12,96,tips,223,814,0.0
5,1,35,1,9,9,970,210,6,10,21,@,220,976,0.0
5,1,35,1,9,10,994,210,53,10,71,Allocated,220,1047,0.0
5,1,35,1,9,11,1052,211,20,12,96,tips,223,1072,0.0
4,1,35,1,10,0,724,235,447,15,-1,,250,1171,0.0
5,1,35,1,10,1,724,235,123,15,92,278526.87,250,847,0.0
5,1,35,1,10,2,1050,235,121,15,84,182944.39,250,1171,0.0
4,1,35,1,11,0,11,262,1122,13,-1,,275,1133,0.0
5,1,35,1,11,1,11,262,7,10,25,โd,272,18,0.0
5,1,35,1,11,2,29,262,39,10,93,Control,272,68,0.0
5,1,35,1,11,3,74,262,42,10,96,number,272,116,0.0
5,1,35,1,11,4,680,262,7,10,69,9,272,687,0.0
5,1,35,1,11,5,704,262,48,10,69,Advance,272,752,0.0
5,1,35,1,11,6,758,262,19,10,92,EIC,272,777,0.0
5,1,35,1,11,7,783,263,48,12,96,payment,275,831,0.0
5,1,35,1,11,8,964,262,13,10,80,10,272,977,0.0
5,1,35,1,11,9,995,262,60,13,76,Dependent,275,1055,0.0
5,1,35,1,11,10,1061,265,23,7,96,care,272,1084,0.0
5,1,35,1,11,11,1090,262,43,10,93,benefits,272,1133,0.0
4,1,35,1,12,0,12,313,1163,13,-1,,326,1175,0.0
5,1,35,1,12,1,29,313,65,13,81,Employee's,326,94,0.0
5,1,35,1,12,2,99,313,20,10,94,first,323,119,0.0
5,1,35,1,12,3,125,316,30,7,94,name,323,155,0.0
5,1,35,1,12,4,161,313,19,10,96,and,323,180,0.0
5,1,35,1,12,5,186,313,28,10,95,initial,323,214,0.0
5,1,35,1,12,6,280,313,23,10,95,Last,323,303,0.0
5,1,35,1,12,7,309,316,30,7,94,name,323,339,0.0
5,1,35,1,12,8,674,313,11,10,56,71,323,685,0.0
5,1,35,1,12,9,705,313,68,13,69,Nonqualified,326,773,0.0
5,1,35,1,12,10,779,313,29,13,65,"plans,",326,808,0.0
5,1,35,1,12,11,966,313,20,10,36,12a,323,986,0.0
5,1,35,1,12,12,1009,313,22,10,64,See,323,1031,0.0
5,1,35,1,12,13,1037,313,71,10,95,instructions,323,1108,0.0
5,1,35,1,12,14,1112,313,17,10,96,for,323,1129,0.0
5,1,35,1,12,15,1134,313,22,10,96,box,323,1156,0.0
5,1,35,1,12,16,1162,313,13,10,91,12,323,1175,0.0
4,1,35,1,13,0,182,344,920,17,-1,,361,1102,0.0
5,1,35,1,13,1,182,358,3,3,0,r,361,185,0.0
5,1,35,1,13,2,725,344,39,15,96,123,359,764,0.0
5,1,35,1,13,3,1050,344,52,15,96,9488,359,1102,0.0
4,1,35,1,14,0,63,358,924,23,-1,,381,987,0.0
5,1,35,1,14,1,63,359,65,21,94,Mary,380,128,0.0
5,1,35,1,14,2,160,358,143,17,96,Dickerson,375,303,0.0
5,1,35,1,14,3,674,370,13,10,59,1B,380,687,0.0
5,1,35,1,14,4,693,371,43,10,38,Slatutory,381,736,0.0
5,1,35,1,14,5,780,371,50,8,0,Retirement,379,830,0.0
5,1,35,1,14,6,866,371,53,10,0,__Thre-parky,381,919,0.0
5,1,35,1,14,7,966,370,21,10,58,1,380,987,0.0
4,1,35,1,15,0,693,385,213,9,-1,,394,906,0.0
5,1,35,1,15,1,693,385,45,9,12,empoyee,394,738,0.0
5,1,35,1,15,2,780,385,18,9,39,plan,394,798,0.0
5,1,35,1,15,3,867,385,18,8,85,sick,393,885,0.0
5,1,35,1,15,4,895,387,11,7,85,pay,394,906,0.0
4,1,35,1,16,0,67,396,1022,22,-1,,418,1089,0.0
5,1,35,1,16,1,67,396,75,17,96,95842,413,142,1.0
5,1,35,1,16,2,161,397,110,16,93,Freeman,413,271,1.0
5,1,35,1,16,3,289,397,77,16,92,Coves,413,366,1.0
5,1,35,1,16,4,383,397,59,21,95,Apt.,418,442,1.0
5,1,35,1,16,5,467,396,43,17,96,609,413,510,1.0
5,1,35,1,16,6,1006,399,13,14,89,P,413,1019,0.0
5,1,35,1,16,7,1050,398,39,15,89,|329,413,1089,0.0
4,1,35,1,17,0,64,419,922,42,-1,,461,986,0.0
5,1,35,1,17,1,64,419,176,42,92,Robertburgh,461,240,1.0
5,1,35,1,17,2,319,436,34,16,91,MA,452,353,1.0
5,1,35,1,17,3,387,435,155,17,91,63545-3314,452,542,0.0
5,1,35,1,17,4,674,427,13,10,49,44,437,687,0.0
5,1,35,1,17,5,705,427,31,10,81,Other,437,736,0.0
5,1,35,1,17,6,741,427,23,13,86,(see,440,764,0.0
5,1,35,1,17,7,770,427,50,10,96,enclosed,437,820,0.0
5,1,35,1,17,8,826,427,35,10,96,Notice,437,861,0.0
5,1,35,1,17,9,866,428,10,9,96,to,437,876,0.0
5,1,35,1,17,10,882,427,61,13,94,Employee),440,943,0.0
5,1,35,1,17,11,949,419,11,25,46,|,444,960,0.0
5,1,35,1,17,12,966,427,20,10,38,12c,437,986,0.0
4,1,35,1,18,0,1007,458,81,15,-1,,473,1088,0.0
5,1,35,1,18,1,1007,459,12,14,91,P,473,1019,0.0
5,1,35,1,18,2,1050,458,38,15,33,(322,473,1088,0.0
4,1,35,1,19,0,966,484,20,10,-1,,494,986,0.0
5,1,35,1,19,1,966,484,20,10,88,12d,494,986,0.0
4,1,35,1,20,0,1050,515,38,15,-1,,530,1088,0.0
5,1,35,1,20,1,1050,515,38,15,96,812,530,1088,0.0
4,1,35,1,21,0,11,545,213,13,-1,,558,224,0.0
5,1,35,1,21,1,11,545,5,10,91,f,555,16,0.0
5,1,35,1,21,2,29,545,65,13,53,Employee's,558,94,0.0
5,1,35,1,21,3,100,545,44,10,91,address,555,144,0.0
5,1,35,1,21,4,150,545,19,10,96,and,555,169,0.0
5,1,35,1,21,5,174,545,18,10,94,ZIP,555,192,0.0
5,1,35,1,21,6,197,545,27,10,96,code,555,224,0.0
4,1,35,1,22,0,6,562,1210,13,-1,,575,1216,0.0
5,1,35,1,22,1,6,562,13,10,68,15,572,19,0.0
5,1,35,1,22,2,29,562,29,10,39,State!,572,58,0.0
5,1,35,1,22,3,88,562,62,13,38,Employer's,575,150,0.0
5,1,35,1,22,4,156,563,27,9,96,state,572,183,0.0
5,1,35,1,22,5,189,562,10,10,95,ID,572,199,0.0
5,1,35,1,22,6,205,562,42,10,96,number,572,247,0.0
5,1,35,1,22,7,349,562,12,10,90,16,572,361,0.0
5,1,35,1,22,8,370,562,29,10,96,State,572,399,0.0
5,1,35,1,22,9,404,565,36,10,82,wages.,575,440,0.0
5,1,35,1,22,10,449,563,20,12,95,"tips,",575,469,0.0
5,1,35,1,22,11,479,563,16,9,86,etc.,572,495,0.0
5,1,35,1,22,12,541,562,11,10,90,17,572,552,0.0
5,1,35,1,22,13,562,562,29,10,93,State,572,591,0.0
5,1,35,1,22,14,597,565,40,7,96,income,572,637,0.0
5,1,35,1,22,15,642,563,18,9,94,tax,572,660,0.0
5,1,35,1,22,16,726,562,12,10,78,48,572,738,0.0
5,1,35,1,22,17,748,562,29,10,90,Local,572,777,0.0
5,1,35,1,22,18,782,565,36,10,93,wages.,575,818,0.0
5,1,35,1,22,19,827,563,20,12,93,"tips,",575,847,0.0
5,1,35,1,22,20,857,563,16,9,94,etc.,572,873,0.0
5,1,35,1,22,21,930,562,11,10,76,19,572,941,0.0
5,1,35,1,22,22,951,562,29,10,94,Local,572,980,0.0
5,1,35,1,22,23,986,565,40,7,96,income,572,1026,0.0
5,1,35,1,22,24,1031,563,18,9,96,tax,572,1049,0.0
5,1,35,1,22,25,1114,562,13,10,87,20,572,1127,0.0
5,1,35,1,22,26,1137,562,44,13,91,Locality,575,1181,0.0
5,1,35,1,22,27,1186,565,30,7,96,name,572,1216,0.0
4,1,35,1,23,0,16,587,1218,23,-1,,610,1234,0.0
5,1,35,1,23,1,16,588,27,14,62,Dc,602,43,0.0
5,1,35,1,23,2,132,587,137,15,91,966-19-196,602,269,0.0
5,1,35,1,23,3,347,587,122,15,90,110223.67,602,469,0.0
5,1,35,1,23,4,539,587,108,15,89,11688.57,602,647,0.0
5,1,35,1,23,5,724,587,124,15,91,262336.93,602,848,0.0
5,1,35,1,23,6,928,587,94,15,91,44190.0,602,1022,0.0
5,1,35,1,23,7,1116,593,48,9,95,Robert,602,1164,0.0
5,1,35,1,23,8,1173,593,61,17,95,Parkway,610,1234,0.0
5,1,35,1,23,9,1230,583,6,31,96,|,614,1236,0.0
4,1,35,1,24,0,11,634,1222,28,-1,,662,1233,0.0
5,1,35,1,24,1,11,634,34,28,96,AK,662,45,0.0
5,1,35,1,24,2,131,638,137,15,90,251-39-797,653,268,0.0
5,1,35,1,24,3,347,638,122,15,87,113743.74,653,469,0.0
5,1,35,1,24,4,539,638,94,15,90,13074.2,653,633,0.0
5,1,35,1,24,5,724,638,110,15,90,216960.9,653,834,0.0
5,1,35,1,24,6,927,638,110,15,89,25811.99,653,1037,0.0
5,1,35,1,24,7,1113,643,49,10,95,Jason,653,1162,0.0
5,1,35,1,24,8,1173,642,60,11,96,Stream,653,1233,0.0
4,1,35,1,25,0,139,670,1092,22,-1,,692,1231,0.0
5,1,35,1,25,1,139,670,63,22,96,Wage,692,202,0.0
5,1,35,1,25,2,211,670,41,17,96,and,687,252,0.0
5,1,35,1,25,3,261,670,40,17,96,Tax,687,301,0.0
5,1,35,1,25,4,864,675,81,15,96,Department,690,945,0.0
5,1,35,1,25,5,950,675,12,12,96,of,687,962,0.0
5,1,35,1,25,6,966,675,20,12,93,the,687,986,0.0
5,1,35,1,25,7,991,675,118,15,35,TreasuryโInternal,690,1109,0.0
5,1,35,1,25,8,1115,675,59,12,96,Revenue,687,1174,0.0
5,1,35,1,25,9,1180,675,51,12,97,Service,687,1231,0.0
4,1,35,1,26,0,4,677,689,43,-1,,720,693,0.0
5,1,35,1,26,1,4,709,34,11,93,Form,720,38,0.0
5,1,35,1,26,2,47,709,25,11,91,W-2,720,72,0.0
5,1,35,1,26,3,140,701,114,17,96,Statement,718,254,0.0
5,1,35,1,26,4,549,677,27,42,21,c,719,576,0.0
5,1,35,1,26,5,588,677,27,42,50,0,719,615,0.0
5,1,35,1,26,6,628,677,26,42,59,1,719,654,0.0
5,1,35,1,26,7,666,677,27,42,52,0,719,693,0.0
2,1,36,0,0,0,4,732,482,37,-1,,769,486,0.0
3,1,36,1,0,0,4,732,482,37,-1,,769,486,0.0
4,1,36,1,1,0,5,732,462,15,-1,,747,467,0.0
5,1,36,1,1,1,5,732,40,15,93,Copy,747,45,0.0
5,1,36,1,1,2,51,732,43,12,91,B--To,744,94,0.0
5,1,36,1,1,3,100,732,20,12,96,Be,744,120,0.0
5,1,36,1,1,4,126,732,35,12,95,Filed,744,161,0.0
5,1,36,1,1,5,167,732,32,12,96,with,744,199,0.0
5,1,36,1,1,6,206,732,87,15,85,Employee's,747,293,0.0
5,1,36,1,1,7,300,732,76,12,96,FEDERAL,744,376,0.0
5,1,36,1,1,8,382,732,27,12,95,Tax,744,409,0.0
5,1,36,1,1,9,415,732,52,12,96,Return,744,467,0.0
4,1,36,1,2,0,4,754,482,15,-1,,769,486,0.0
5,1,36,1,2,1,4,754,29,12,96,This,766,33,0.0
5,1,36,1,2,2,40,754,79,12,93,information,766,119,0.0
5,1,36,1,2,3,126,757,10,9,93,is,766,136,0.0
5,1,36,1,2,4,143,754,38,15,94,being,769,181,0.0
5,1,36,1,2,5,187,754,67,12,96,furnished,766,254,0.0
5,1,36,1,2,6,260,754,12,12,96,to,766,272,0.0
5,1,36,1,2,7,278,754,22,12,96,the,766,300,0.0
5,1,36,1,2,8,307,754,52,12,93,Internal,766,359,0.0
5,1,36,1,2,9,365,754,62,12,95,Revenue,766,427,0.0
5,1,36,1,2,10,433,754,53,12,96,Service,766,486,0.0
2,1,37,0,0,0,469,825,187,14,-1,,839,656,0.0
3,1,37,1,0,0,469,825,187,14,-1,,839,656,0.0
4,1,37,1,1,0,469,825,187,14,-1,,839,656,0.0
5,1,37,1,1,1,469,825,55,11,40,Tuthere.,836,524,0.0
5,1,37,1,1,2,537,825,32,14,92,Keep,839,569,0.0
5,1,37,1,1,3,575,825,34,11,91,lower,836,609,0.0
5,1,37,1,1,4,614,826,42,13,88,portion,839,656,0.0
2,1,38,0,0,0,661,825,102,14,-1,,839,763,0.0
3,1,38,1,0,0,661,825,102,14,-1,,839,763,0.0
4,1,38,1,1,0,661,825,102,14,-1,,839,763,0.0
5,1,38,1,1,1,661,825,17,11,83,Tor,836,678,0.0
5,1,38,1,1,2,682,828,28,11,95,your,839,710,0.0
5,1,38,1,1,3,715,825,48,11,95,records,836,763,0.0
2,1,39,0,0,0,1,873,1235,3,-1,,876,1236,0.0
3,1,39,1,0,0,1,873,1235,3,-1,,876,1236,0.0
4,1,39,1,1,0,1,873,1235,3,-1,,876,1236,0.0
5,1,39,1,1,1,1,873,1235,3,95, ,876,1236,0.0
2,1,40,0,0,0,212,874,1,52,-1,,926,213,0.0
3,1,40,1,0,0,212,874,1,52,-1,,926,213,0.0
4,1,40,1,1,0,212,874,1,52,-1,,926,213,0.0
5,1,40,1,1,1,212,874,1,52,95, ,926,213,0.0
2,1,41,0,0,0,596,874,1,52,-1,,926,597,0.0
3,1,41,1,0,0,596,874,1,52,-1,,926,597,0.0
4,1,41,1,1,0,596,874,1,52,-1,,926,597,0.0
5,1,41,1,1,1,596,874,1,52,95, ,926,597,0.0
2,1,42,0,0,0,1,924,1235,3,-1,,927,1236,0.0
3,1,42,1,0,0,1,924,1235,3,-1,,927,1236,0.0
4,1,42,1,1,0,1,924,1235,3,-1,,927,1236,0.0
5,1,42,1,1,1,1,924,1235,3,95, ,927,1236,0.0
2,1,43,0,0,0,1,975,1235,3,-1,,978,1236,0.0
3,1,43,1,0,0,1,975,1235,3,-1,,978,1236,0.0
4,1,43,1,1,0,1,975,1235,3,-1,,978,1236,0.0
5,1,43,1,1,1,1,975,1235,3,95, ,978,1236,0.0
2,1,44,0,0,0,660,1027,576,1,-1,,1028,1236,0.0
3,1,44,1,0,0,660,1027,576,1,-1,,1028,1236,0.0
4,1,44,1,1,0,660,1027,576,1,-1,,1028,1236,0.0
5,1,44,1,1,1,660,1027,576,1,95, ,1028,1236,0.0
2,1,45,0,0,0,660,1078,576,1,-1,,1079,1236,0.0
3,1,45,1,0,0,660,1078,576,1,-1,,1079,1236,0.0
4,1,45,1,1,0,660,1078,576,1,-1,,1079,1236,0.0
5,1,45,1,1,1,660,1078,576,1,95, ,1079,1236,0.0
2,1,46,0,0,0,1,1128,1235,3,-1,,1131,1236,0.0
3,1,46,1,0,0,1,1128,1235,3,-1,,1131,1236,0.0
4,1,46,1,1,0,1,1128,1235,3,-1,,1131,1236,0.0
5,1,46,1,1,1,1,1128,1235,3,95, ,1131,1236,0.0
2,1,47,0,0,0,1,1179,1235,3,-1,,1182,1236,0.0
3,1,47,1,0,0,1,1179,1235,3,-1,,1182,1236,0.0
4,1,47,1,1,0,1,1179,1235,3,-1,,1182,1236,0.0
5,1,47,1,1,1,1,1179,1235,3,95, ,1182,1236,0.0
2,1,48,0,0,0,660,1237,576,1,-1,,1238,1236,0.0
3,1,48,1,0,0,660,1237,576,1,-1,,1238,1236,0.0
4,1,48,1,1,0,660,1237,576,1,-1,,1238,1236,0.0
5,1,48,1,1,1,660,1237,576,1,95, ,1238,1236,0.0
2,1,49,0,0,0,689,1267,204,1,-1,,1268,893,0.0
3,1,49,1,0,0,689,1267,204,1,-1,,1268,893,0.0
4,1,49,1,1,0,689,1267,204,1,-1,,1268,893,0.0
5,1,49,1,1,1,689,1267,204,1,95, ,1268,893,0.0
2,1,50,0,0,0,689,1267,1,28,-1,,1295,690,0.0
3,1,50,1,0,0,689,1267,1,28,-1,,1295,690,0.0
4,1,50,1,1,0,689,1267,1,28,-1,,1295,690,0.0
5,1,50,1,1,1,689,1267,1,28,95, ,1295,690,0.0
2,1,51,0,0,0,718,1267,1,28,-1,,1295,719,0.0
3,1,51,1,0,0,718,1267,1,28,-1,,1295,719,0.0
4,1,51,1,1,0,718,1267,1,28,-1,,1295,719,0.0
5,1,51,1,1,1,718,1267,1,28,95, ,1295,719,0.0
2,1,52,0,0,0,776,1267,1,28,-1,,1295,777,0.0
3,1,52,1,0,0,776,1267,1,28,-1,,1295,777,0.0
4,1,52,1,1,0,776,1267,1,28,-1,,1295,777,0.0
5,1,52,1,1,1,776,1267,1,28,95, ,1295,777,0.0
2,1,53,0,0,0,805,1267,1,28,-1,,1295,806,0.0
3,1,53,1,0,0,805,1267,1,28,-1,,1295,806,0.0
4,1,53,1,1,0,805,1267,1,28,-1,,1295,806,0.0
5,1,53,1,1,1,805,1267,1,28,95, ,1295,806,0.0
2,1,54,0,0,0,863,1267,1,28,-1,,1295,864,0.0
3,1,54,1,0,0,863,1267,1,28,-1,,1295,864,0.0
4,1,54,1,1,0,863,1267,1,28,-1,,1295,864,0.0
5,1,54,1,1,1,863,1267,1,28,95, ,1295,864,0.0
2,1,55,0,0,0,892,1267,1,28,-1,,1295,893,0.0
3,1,55,1,0,0,892,1267,1,28,-1,,1295,893,0.0
4,1,55,1,1,0,892,1267,1,28,-1,,1295,893,0.0
5,1,55,1,1,1,892,1267,1,28,95, ,1295,893,0.0
2,1,56,0,0,0,660,1294,576,3,-1,,1297,1236,0.0
3,1,56,1,0,0,660,1294,576,3,-1,,1297,1236,0.0
4,1,56,1,1,0,660,1294,576,3,-1,,1297,1236,0.0
5,1,56,1,1,1,660,1294,576,3,95, ,1297,1236,0.0
2,1,57,0,0,0,11,878,1217,553,-1,,1431,1228,0.0
3,1,57,1,0,0,11,878,1217,553,-1,,1431,1228,0.0
4,1,57,1,1,0,55,878,1137,16,-1,,894,1192,0.0
5,1,57,1,1,1,55,879,103,15,91,REISSUED,894,158,0.0
5,1,57,1,1,2,216,881,6,7,59,[a,888,222,0.0
5,1,57,1,1,3,236,878,71,13,32,Employee's,891,307,0.0
5,1,57,1,1,4,311,878,36,10,94,social,888,347,0.0
5,1,57,1,1,5,352,878,48,13,94,security,891,400,0.0
5,1,57,1,1,6,406,878,48,10,96,number,888,454,0.0
5,1,57,1,1,7,750,878,23,10,95,This,888,773,0.0
5,1,57,1,1,8,779,878,61,10,96,information,888,840,0.0
5,1,57,1,1,9,846,881,8,7,90,is,888,854,0.0
5,1,57,1,1,10,860,878,29,13,90,being,891,889,0.0
5,1,57,1,1,11,894,878,51,10,93,furnished,888,945,0.0
5,1,57,1,1,12,950,879,10,9,96,to,888,960,0.0
5,1,57,1,1,13,965,878,17,10,96,the,888,982,0.0
5,1,57,1,1,14,988,878,40,10,84,Internal,888,1028,0.0
5,1,57,1,1,15,1034,878,47,10,93,Revenue,888,1081,0.0
5,1,57,1,1,16,1087,878,40,10,74,Senice.,888,1127,0.0
5,1,57,1,1,17,1141,878,6,10,77,If,888,1147,0.0
5,1,57,1,1,18,1150,881,20,10,77,you,891,1170,0.0
5,1,57,1,1,19,1176,881,16,7,94,are,888,1192,0.0
4,1,57,1,2,0,751,895,477,13,-1,,908,1228,0.0
5,1,57,1,2,1,751,895,44,13,95,required,908,795,0.0
5,1,57,1,2,2,800,887,8,26,96,to,913,808,0.0
5,1,57,1,2,3,805,895,25,10,96,file,905,830,0.0
5,1,57,1,2,4,836,898,5,7,78,a,905,841,0.0
5,1,57,1,2,5,846,896,18,9,78,tax,905,864,0.0
5,1,57,1,2,6,869,896,35,10,65,"return,",906,904,0.0
5,1,57,1,2,7,910,898,5,7,95,a,905,915,0.0
5,1,57,1,2,8,921,895,60,13,96,negligence,908,981,0.0
5,1,57,1,2,9,987,895,41,13,96,penalty,908,1028,0.0
5,1,57,1,2,10,1033,898,10,7,95,or,905,1043,0.0
5,1,57,1,2,11,1048,895,28,10,96,other,905,1076,0.0
5,1,57,1,2,12,1081,896,47,9,96,sanction,905,1128,0.0
5,1,57,1,2,13,1134,898,24,10,97,may,908,1158,0.0
5,1,57,1,2,14,1163,895,12,10,96,be,905,1175,0.0
5,1,57,1,2,15,1181,895,47,13,88,imposed,908,1228,0.0
4,1,57,1,3,0,44,903,1018,22,-1,,925,1062,0.0
5,1,57,1,3,1,44,906,126,15,96,STATEMENT,921,170,0.0
5,1,57,1,3,2,312,903,150,15,81,036-91-4705,918,462,0.0
5,1,57,1,3,3,612,903,28,10,96,OMB,913,640,0.0
5,1,57,1,3,4,646,903,14,10,79,No.,913,660,0.0
5,1,57,1,3,5,671,903,57,10,80,1645-0008,913,728,0.0
5,1,57,1,3,6,751,915,12,7,50,on,922,763,0.0
5,1,57,1,3,7,776,915,12,7,38,you,922,788,0.0
5,1,57,1,3,8,794,912,6,10,38,if,922,800,0.0
5,1,57,1,3,9,803,912,20,10,79,this,922,823,0.0
5,1,57,1,3,10,829,915,40,7,55,income,922,869,0.0
5,1,57,1,3,11,875,915,8,7,92,is,922,883,0.0
5,1,57,1,3,12,888,912,41,10,92,taxable,922,929,0.0
5,1,57,1,3,13,935,912,19,10,96,and,922,954,0.0
5,1,57,1,3,14,959,899,18,34,75,you,933,977,0.0
5,1,57,1,3,15,984,912,30,10,75,fail,922,1014,0.0
5,1,57,1,3,16,1004,899,10,34,86,to,933,1014,0.0
5,1,57,1,3,17,1020,913,31,12,52,report,925,1051,0.0
5,1,57,1,3,18,1057,913,5,9,52,it,922,1062,0.0
4,1,57,1,4,0,12,929,1143,13,-1,,942,1155,0.0
5,1,57,1,4,1,12,929,7,10,82,b,939,19,0.0
5,1,57,1,4,2,29,929,54,13,95,Employer,942,83,0.0
5,1,57,1,4,3,88,929,70,10,95,identification,939,158,0.0
5,1,57,1,4,4,164,929,42,10,96,number,939,206,0.0
5,1,57,1,4,5,681,929,4,10,61,1,939,685,0.0
5,1,57,1,4,6,704,929,40,13,80,"Wages,",942,744,0.0
5,1,57,1,4,7,753,930,20,12,91,"tips,",942,773,0.0
5,1,57,1,4,8,783,929,28,10,94,other,939,811,0.0
5,1,57,1,4,9,816,930,79,12,96,compensation,942,895,0.0
5,1,57,1,4,10,970,929,7,10,0,2,939,977,0.0
5,1,57,1,4,11,995,929,41,10,78,Federal,939,1036,0.0
5,1,57,1,4,12,1042,932,40,7,95,income,939,1082,0.0
5,1,57,1,4,13,1087,930,18,9,96,tax,939,1105,0.0
5,1,57,1,4,14,1109,929,46,10,95,withheld,939,1155,0.0
4,1,57,1,5,0,65,954,1029,15,-1,,969,1094,0.0
5,1,57,1,5,1,65,954,137,15,92,22-3437795,969,202,0.0
5,1,57,1,5,2,724,954,123,15,85,237575.44,969,847,0.0
5,1,57,1,5,3,986,954,108,15,92,85837.08,969,1094,0.0
4,1,57,1,6,0,13,980,1139,13,-1,,993,1152,0.0
5,1,57,1,6,1,13,983,6,7,35,ยข,990,19,0.0
5,1,57,1,6,2,29,980,62,13,95,Employers,993,91,0.0
5,1,57,1,6,3,97,983,30,7,93,"name,",990,127,0.0
5,1,57,1,6,4,137,980,44,10,92,"address,",990,181,0.0
5,1,57,1,6,5,191,980,19,10,94,and,990,210,0.0
5,1,57,1,6,6,215,980,18,10,95,ZIP,990,233,0.0
5,1,57,1,6,7,239,980,26,10,96,code,990,265,0.0
5,1,57,1,6,8,681,980,6,10,65,3,990,687,0.0
5,1,57,1,6,9,705,980,34,10,87,Social,990,739,0.0
5,1,57,1,6,10,745,972,45,25,95,security,997,790,0.0
5,1,57,1,6,11,797,983,33,10,96,wages,993,830,0.0
5,1,57,1,6,12,970,980,7,10,48,4,990,977,0.0
5,1,57,1,6,13,995,980,34,10,82,Social,990,1029,0.0
5,1,57,1,6,14,1035,980,117,13,96,security,993,1152,0.0
5,1,57,1,6,15,1084,972,18,25,96,tax,997,1102,0.0
5,1,57,1,6,16,1107,980,45,13,96,withheld,993,1152,0.0
4,1,57,1,7,0,64,1005,1030,20,-1,,1025,1094,0.0
5,1,57,1,7,1,64,1006,84,19,96,Morgan,1025,148,0.0
5,1,57,1,7,2,163,1005,41,15,96,Ltd,1020,204,0.0
5,1,57,1,7,3,219,1005,41,15,96,and,1020,260,0.0
5,1,57,1,7,4,276,1006,53,14,96,Sons,1020,329,0.0
5,1,57,1,7,5,724,1005,123,15,90,278526.87,1020,847,0.0
5,1,57,1,7,6,985,1005,109,15,91,21307.31,1020,1094,0.0
4,1,57,1,8,0,66,1031,1053,28,-1,,1059,1119,0.0
5,1,57,1,8,1,66,1039,38,15,96,147,1054,104,0.0
5,1,57,1,8,2,121,1039,82,20,96,Taylor,1059,203,0.0
5,1,57,1,8,3,218,1039,55,15,95,Wall,1054,273,0.0
5,1,57,1,8,4,681,1031,6,10,70,5,1041,687,0.0
5,1,57,1,8,5,705,1031,51,10,79,Medicare,1041,756,0.0
5,1,57,1,8,6,761,1034,36,10,96,wages,1044,797,0.0
5,1,57,1,8,7,803,1031,19,10,88,and,1041,822,0.0
5,1,57,1,8,8,827,1032,20,12,88,tips,1044,847,0.0
5,1,57,1,8,9,970,1031,6,10,64,6,1041,976,0.0
5,1,57,1,8,10,995,1031,51,10,73,Medicare,1041,1046,0.0
5,1,57,1,8,11,1051,1032,18,9,96,tax,1041,1069,0.0
5,1,57,1,8,12,1074,1031,45,10,95,withheld,1041,1119,0.0
4,1,57,1,9,0,725,1056,420,15,-1,,1071,1145,0.0
5,1,57,1,9,1,725,1056,123,15,90,182944.39,1071,848,0.0
5,1,57,1,9,2,1050,1056,95,15,68,5305.39),1071,1145,0.0
4,1,57,1,10,0,64,1073,1008,22,-1,,1095,1072,0.0
5,1,57,1,10,1,64,1074,42,14,96,New,1088,106,0.0
5,1,57,1,10,2,121,1073,82,15,96,Joshua,1088,203,0.0
5,1,57,1,10,3,274,1074,27,14,93,NE,1088,301,0.0
5,1,57,1,10,4,332,1073,137,15,94,07877-3716,1088,469,0.0
5,1,57,1,10,5,681,1082,5,10,82,T,1092,686,0.0
5,1,57,1,10,6,705,1082,34,10,96,Social,1092,739,0.0
5,1,57,1,10,7,747,1070,41,29,79,security,1099,788,0.0
5,1,57,1,10,8,793,1083,21,12,96,tips,1095,814,0.0
5,1,57,1,10,9,971,1082,5,10,50,@,1092,976,0.0
5,1,57,1,10,10,994,1082,53,10,92,Allocated,1092,1047,0.0
5,1,57,1,10,11,1052,1083,20,12,70,tips,1095,1072,0.0
4,1,57,1,11,0,724,1107,447,15,-1,,1122,1171,0.0
5,1,57,1,11,1,724,1107,123,15,91,278526.87,1122,847,0.0
5,1,57,1,11,2,1050,1107,121,15,82,182944.39,1122,1171,0.0
4,1,57,1,12,0,11,1133,1122,13,-1,,1146,1133,0.0
5,1,57,1,12,1,11,1133,57,10,0,โControl,1143,68,0.0
5,1,57,1,12,2,74,1133,42,10,96,number,1143,116,0.0
5,1,57,1,12,3,680,1133,7,10,63,9,1143,687,0.0
5,1,57,1,12,4,704,1133,48,10,71,Advance,1143,752,0.0
5,1,57,1,12,5,758,1133,19,10,91,EIC,1143,777,0.0
5,1,57,1,12,6,783,1134,48,12,96,payment,1146,831,0.0
5,1,57,1,12,7,964,1133,13,10,74,40,1143,977,0.0
5,1,57,1,12,8,995,1133,60,13,71,Dependent,1146,1055,0.0
5,1,57,1,12,9,1061,1136,23,7,92,care,1143,1084,0.0
5,1,57,1,12,10,1090,1133,43,10,92,benefits,1143,1133,0.0
4,1,57,1,13,0,66,1158,1022,15,-1,,1173,1088,0.0
5,1,57,1,13,1,66,1158,94,15,96,6307582,1173,160,0.0
5,1,57,1,13,2,1050,1158,38,15,25,a4.,1173,1088,0.0
4,1,57,1,14,0,12,1184,1163,13,-1,,1197,1175,0.0
5,1,57,1,14,1,12,1187,6,7,45,@,1194,18,0.0
5,1,57,1,14,2,29,1184,65,13,74,Employee's,1197,94,0.0
5,1,57,1,14,3,99,1184,20,10,95,first,1194,119,0.0
5,1,57,1,14,4,125,1187,30,7,95,name,1194,155,0.0
5,1,57,1,14,5,161,1184,19,10,96,and,1194,180,0.0
5,1,57,1,14,6,186,1184,28,10,95,initial,1194,214,0.0
5,1,57,1,14,7,280,1184,23,10,96,Last,1194,303,0.0
5,1,57,1,14,8,309,1187,30,7,94,name,1194,339,0.0
5,1,57,1,14,9,674,1184,11,10,60,11,1194,685,0.0
5,1,57,1,14,10,705,1184,68,13,79,Nonqualified,1197,773,0.0
5,1,57,1,14,11,779,1184,29,13,76,plans,1197,808,0.0
5,1,57,1,14,12,966,1184,20,10,37,12a,1194,986,0.0
5,1,57,1,14,13,1009,1184,22,10,65,See,1194,1031,0.0
5,1,57,1,14,14,1037,1184,92,10,95,instructions,1194,1129,0.0
5,1,57,1,14,15,1112,1176,19,25,96,for,1201,1131,0.0
5,1,57,1,14,16,1134,1184,22,10,96,box,1194,1156,0.0
5,1,57,1,14,17,1162,1184,13,10,91,12,1194,1175,0.0
4,1,57,1,15,0,182,1215,920,17,-1,,1232,1102,0.0
5,1,57,1,15,1,182,1229,3,3,0,-,1232,185,0.0
5,1,57,1,15,2,725,1215,39,15,96,123,1230,764,0.0
5,1,57,1,15,3,1050,1215,52,15,95,9488,1230,1102,0.0
4,1,57,1,16,0,63,1229,924,23,-1,,1252,987,0.0
5,1,57,1,16,1,63,1230,65,21,96,Mary,1251,128,0.0
5,1,57,1,16,2,160,1229,143,17,95,Dickerson,1246,303,0.0
5,1,57,1,16,3,674,1241,13,10,56,13,1251,687,0.0
5,1,57,1,16,4,693,1242,43,10,0,Satay,1252,736,0.0
5,1,57,1,16,5,780,1242,50,8,1,Ratrenent,1250,830,0.0
5,1,57,1,16,6,866,1242,53,10,0,โโthvapary),1252,919,0.0
5,1,57,1,16,7,966,1241,21,10,37,2b,1251,987,0.0
4,1,57,1,17,0,693,1257,213,10,-1,,1267,906,0.0
5,1,57,1,17,1,693,1257,44,10,56,empoyee,1267,737,0.0
5,1,57,1,17,2,780,1257,18,10,40,plan,1267,798,0.0
5,1,57,1,17,3,867,1257,18,8,95,sick,1265,885,0.0
5,1,57,1,17,4,889,1259,17,8,94,pay,1267,906,0.0
4,1,57,1,18,0,67,1269,1022,22,-1,,1291,1089,0.0
5,1,57,1,18,1,67,1269,75,17,96,95842,1286,142,0.0
5,1,57,1,18,2,161,1270,110,16,93,Freeman,1286,271,0.0
5,1,57,1,18,3,289,1270,77,16,91,Coves,1286,366,0.0
5,1,57,1,18,4,383,1270,59,21,95,Apt.,1291,442,0.0
5,1,57,1,18,5,467,1269,43,17,96,609,1286,510,0.0
5,1,57,1,18,6,1007,1272,12,14,83,P,1286,1019,0.0
5,1,57,1,18,7,1050,1271,39,15,79,|329,1286,1089,0.0
4,1,57,1,19,0,674,1300,312,13,-1,,1313,986,0.0
5,1,57,1,19,1,674,1300,13,10,51,44,1310,687,0.0
5,1,57,1,19,2,705,1300,31,10,82,Other,1310,736,0.0
5,1,57,1,19,3,741,1301,23,12,87,(see,1313,764,0.0
5,1,57,1,19,4,770,1300,50,10,96,enclosed,1310,820,0.0
5,1,57,1,19,5,826,1300,35,10,94,Notice,1310,861,0.0
5,1,57,1,19,6,866,1301,10,9,96,to,1310,876,0.0
5,1,57,1,19,7,882,1300,61,13,96,Employee),1313,943,0.0
5,1,57,1,19,8,949,1292,9,25,48,|,1317,958,0.0
5,1,57,1,19,9,966,1300,20,10,39,12c,1310,986,0.0
4,1,57,1,20,0,64,1304,478,31,-1,,1335,542,0.0
5,1,57,1,20,1,64,1304,175,31,92,Robertburgh,1335,239,0.0
5,1,57,1,20,2,319,1309,34,16,80,MA,1325,353,0.0
5,1,57,1,20,3,387,1308,155,17,80,63545-3314,1325,542,0.0
4,1,57,1,21,0,1007,1331,81,15,-1,,1346,1088,0.0
5,1,57,1,21,1,1007,1332,12,14,92,P,1346,1019,0.0
5,1,57,1,21,2,1050,1331,38,15,28,(322,1346,1088,0.0
4,1,57,1,22,0,966,1357,20,10,-1,,1367,986,0.0
5,1,57,1,22,1,966,1357,20,10,88,12d,1367,986,0.0
4,1,57,1,23,0,1050,1388,38,15,-1,,1403,1088,0.0
5,1,57,1,23,1,1050,1388,38,15,96,812,1403,1088,0.0
4,1,57,1,24,0,11,1418,213,13,-1,,1431,224,0.0
5,1,57,1,24,1,11,1418,5,10,69,f,1428,16,0.0
5,1,57,1,24,2,29,1418,65,13,69,Employee's,1431,94,0.0
5,1,57,1,24,3,100,1418,44,10,93,address,1428,144,0.0
5,1,57,1,24,4,150,1418,19,10,96,and,1428,169,0.0
5,1,57,1,24,5,174,1418,18,10,92,ZIP,1428,192,0.0
5,1,57,1,24,6,197,1418,27,10,92,code,1428,224,0.0
2,1,58,0,0,0,659,925,3,507,-1,,1432,662,0.0
3,1,58,1,0,0,659,925,3,507,-1,,1432,662,0.0
4,1,58,1,1,0,659,925,3,507,-1,,1432,662,0.0
5,1,58,1,1,1,659,925,3,507,95, ,1432,662,0.0
2,1,59,0,0,0,689,1294,547,3,-1,,1297,1236,0.0
3,1,59,1,0,0,689,1294,547,3,-1,,1297,1236,0.0
4,1,59,1,1,0,689,1294,547,3,-1,,1297,1236,0.0
5,1,59,1,1,1,689,1294,547,3,95, ,1297,1236,0.0
2,1,60,0,0,0,689,1294,547,3,-1,,1297,1236,0.0
3,1,60,1,0,0,689,1294,547,3,-1,,1297,1236,0.0
4,1,60,1,1,0,689,1294,547,3,-1,,1297,1236,0.0
5,1,60,1,1,1,689,1294,547,3,95, ,1297,1236,0.0
2,1,61,0,0,0,689,1294,547,3,-1,,1297,1236,0.0
3,1,61,1,0,0,689,1294,547,3,-1,,1297,1236,0.0
4,1,61,1,1,0,689,1294,547,3,-1,,1297,1236,0.0
5,1,61,1,1,1,689,1294,547,3,95, ,1297,1236,0.0
2,1,62,0,0,0,950,1353,286,1,-1,,1354,1236,0.0
3,1,62,1,0,0,950,1353,286,1,-1,,1354,1236,0.0
4,1,62,1,1,0,950,1353,286,1,-1,,1354,1236,0.0
5,1,62,1,1,1,950,1353,286,1,95, ,1354,1236,0.0
2,1,63,0,0,0,1042,1197,3,214,-1,,1411,1045,0.0
3,1,63,1,0,0,1042,1197,3,214,-1,,1411,1045,0.0
4,1,63,1,1,0,1042,1197,3,214,-1,,1411,1045,0.0
5,1,63,1,1,1,1042,1197,3,214,95, ,1411,1045,0.0
2,1,64,0,0,0,950,1410,286,1,-1,,1411,1236,0.0
3,1,64,1,0,0,950,1410,286,1,-1,,1411,1236,0.0
4,1,64,1,1,0,950,1410,286,1,-1,,1411,1236,0.0
5,1,64,1,1,1,950,1410,286,1,95, ,1411,1236,0.0
2,1,65,0,0,0,949,925,3,507,-1,,1432,952,0.0
3,1,65,1,0,0,949,925,3,507,-1,,1432,952,0.0
4,1,65,1,1,0,949,925,3,507,-1,,1432,952,0.0
5,1,65,1,1,1,949,925,3,507,95, ,1432,952,0.0
2,1,66,0,0,0,1,1430,1235,3,-1,,1433,1236,0.0
3,1,66,1,0,0,1,1430,1235,3,-1,,1433,1236,0.0
4,1,66,1,1,0,1,1430,1235,3,-1,,1433,1236,0.0
5,1,66,1,1,1,1,1430,1235,3,95, ,1433,1236,0.0
2,1,67,0,0,0,6,1435,241,13,-1,,1448,247,0.0
3,1,67,1,0,0,6,1435,241,13,-1,,1448,247,0.0
4,1,67,1,1,0,6,1435,241,13,-1,,1448,247,0.0
5,1,67,1,1,1,6,1435,13,10,88,15,1445,19,0.0
5,1,67,1,1,2,29,1435,29,10,58,State!,1445,58,0.0
5,1,67,1,1,3,88,1435,62,13,54,Employer's,1448,150,0.0
5,1,67,1,1,4,156,1436,27,9,86,state,1445,183,0.0
5,1,67,1,1,5,189,1435,10,10,86,ID,1445,199,0.0
5,1,67,1,1,6,205,1435,42,10,95,number,1445,247,0.0
2,1,68,0,0,0,349,1435,146,13,-1,,1448,495,0.0
3,1,68,1,0,0,349,1435,146,13,-1,,1448,495,0.0
4,1,68,1,1,0,349,1435,146,13,-1,,1448,495,0.0
5,1,68,1,1,1,349,1435,11,10,53,16,1445,360,0.0
5,1,68,1,1,2,370,1435,29,10,93,State,1445,399,0.0
5,1,68,1,1,3,404,1438,36,10,90,"wages,",1448,440,0.0
5,1,68,1,1,4,449,1436,20,12,90,"tips,",1448,469,0.0
5,1,68,1,1,5,479,1436,16,9,77,etc,1445,495,0.0
2,1,69,0,0,0,541,1435,119,10,-1,,1445,660,0.0
3,1,69,1,0,0,541,1435,119,10,-1,,1445,660,0.0
4,1,69,1,1,0,541,1435,119,10,-1,,1445,660,0.0
5,1,69,1,1,1,541,1435,12,10,63,17,1445,553,0.0
5,1,69,1,1,2,562,1435,29,10,94,State,1445,591,0.0
5,1,69,1,1,3,597,1438,40,7,95,income,1445,637,0.0
5,1,69,1,1,4,642,1436,18,9,96,tax,1445,660,0.0
2,1,70,0,0,0,0,1456,1236,31,-1,,1487,1236,0.0
3,1,70,1,0,0,0,1456,1236,31,-1,,1487,1236,0.0
4,1,70,1,1,0,0,1456,1236,31,-1,,1487,1236,0.0
5,1,70,1,1,1,0,1456,1236,31,95, ,1487,1236,0.0
2,1,71,0,0,0,59,1431,1,104,-1,,1535,60,0.0
3,1,71,1,0,0,59,1431,1,104,-1,,1535,60,0.0
4,1,71,1,1,0,59,1431,1,104,-1,,1535,60,0.0
5,1,71,1,1,1,59,1431,1,104,95, ,1535,60,0.0
2,1,72,0,0,0,340,1431,1,104,-1,,1535,341,0.0
3,1,72,1,0,0,340,1431,1,104,-1,,1535,341,0.0
4,1,72,1,1,0,340,1431,1,104,-1,,1535,341,0.0
5,1,72,1,1,1,340,1431,1,104,95, ,1535,341,0.0
2,1,73,0,0,0,532,1431,1,104,-1,,1535,533,0.0
3,1,73,1,0,0,532,1431,1,104,-1,,1535,533,0.0
4,1,73,1,1,0,532,1431,1,104,-1,,1535,533,0.0
5,1,73,1,1,1,532,1431,1,104,95, ,1535,533,0.0
2,1,74,0,0,0,0,1530,341,9,-1,,1539,341,0.0
3,1,74,1,0,0,0,1530,341,9,-1,,1539,341,0.0
4,1,74,1,1,0,0,1530,341,9,-1,,1539,341,0.0
5,1,74,1,1,1,0,1530,341,9,95, ,1539,341,0.0
2,1,75,0,0,0,727,1435,489,13,-1,,1448,1216,0.0
3,1,75,1,0,0,727,1435,489,13,-1,,1448,1216,0.0
4,1,75,1,1,0,727,1435,489,13,-1,,1448,1216,0.0
5,1,75,1,1,1,727,1435,11,10,69,78,1445,738,0.0
5,1,75,1,1,2,748,1435,29,10,94,Local,1445,777,0.0
5,1,75,1,1,3,782,1438,40,10,94,"wages,",1448,822,0.0
5,1,75,1,1,4,827,1436,20,12,94,"tips,",1448,847,0.0
5,1,75,1,1,5,857,1436,16,9,75,etc,1445,873,0.0
5,1,75,1,1,6,929,1435,12,10,76,79,1445,941,0.0
5,1,75,1,1,7,951,1435,29,10,85,Local,1445,980,0.0
5,1,75,1,1,8,986,1438,40,7,96,income,1445,1026,0.0
5,1,75,1,1,9,1031,1436,18,9,96,tax,1445,1049,0.0
5,1,75,1,1,10,1114,1435,13,10,85,20,1445,1127,0.0
5,1,75,1,1,11,1137,1435,44,13,89,Locality,1448,1181,0.0
5,1,75,1,1,12,1186,1438,30,7,96,name,1445,1216,0.0
2,1,76,0,0,0,724,1512,313,15,-1,,1527,1037,0.0
3,1,76,1,0,0,724,1512,313,15,-1,,1527,1037,0.0
4,1,76,1,1,0,724,1512,313,15,-1,,1527,1037,0.0
5,1,76,1,1,1,724,1512,110,15,90,216960.9,1527,834,0.0
5,1,76,1,1,2,927,1512,110,15,92,25811.99,1527,1037,0.0
2,1,77,0,0,0,1113,1516,120,11,-1,,1527,1233,0.0
3,1,77,1,0,0,1113,1516,120,11,-1,,1527,1233,0.0
4,1,77,1,1,0,1113,1516,120,11,-1,,1527,1233,0.0
5,1,77,1,1,1,1113,1517,49,10,96,Jason,1527,1162,0.0
5,1,77,1,1,2,1173,1516,60,11,96,Stream,1527,1233,0.0
2,1,78,0,0,0,1234,874,2,661,-1,,1535,1236,0.0
3,1,78,1,0,0,1234,874,2,661,-1,,1535,1236,0.0
4,1,78,1,1,0,1234,874,2,661,-1,,1535,1236,0.0
5,1,78,1,1,1,1234,874,2,661,95, ,1535,1236,0.0
2,1,79,0,0,0,718,1267,1,268,-1,,1535,719,0.0
3,1,79,1,0,0,718,1267,1,268,-1,,1535,719,0.0
4,1,79,1,1,0,718,1267,1,268,-1,,1535,719,0.0
5,1,79,1,1,1,718,1267,1,268,95, ,1535,719,0.0
2,1,80,0,0,0,921,1431,1,104,-1,,1535,922,0.0
3,1,80,1,0,0,921,1431,1,104,-1,,1535,922,0.0
4,1,80,1,1,0,921,1431,1,104,-1,,1535,922,0.0
5,1,80,1,1,1,921,1431,1,104,95, ,1535,922,0.0
2,1,81,0,0,0,1107,1431,1,104,-1,,1535,1108,0.0
3,1,81,1,0,0,1107,1431,1,104,-1,,1535,1108,0.0
4,1,81,1,1,0,1107,1431,1,104,-1,,1535,1108,0.0
5,1,81,1,1,1,1107,1431,1,104,95, ,1535,1108,0.0
2,1,82,0,0,0,338,1533,898,3,-1,,1536,1236,0.0
3,1,82,1,0,0,338,1533,898,3,-1,,1536,1236,0.0
4,1,82,1,1,0,338,1533,898,3,-1,,1536,1236,0.0
5,1,82,1,1,1,338,1533,898,3,95, ,1536,1236,0.0
2,1,83,0,0,0,4,1508,650,92,-1,,1600,654,0.0
3,1,83,1,0,0,4,1508,650,83,-1,,1591,654,0.0
4,1,83,1,1,0,11,1508,622,28,-1,,1536,633,0.0
5,1,83,1,1,1,11,1508,33,28,96,AK,1536,44,0.0
5,1,83,1,1,2,131,1512,137,15,90,251-39-797,1527,268,0.0
5,1,83,1,1,3,347,1512,122,15,88,113743.74,1527,469,0.0
5,1,83,1,1,4,539,1512,94,15,88,13074.2,1527,633,0.0
4,1,83,1,2,0,139,1542,162,22,-1,,1564,301,0.0
5,1,83,1,2,1,139,1542,63,22,95,Wage,1564,202,0.0
5,1,83,1,2,2,211,1542,41,17,96,and,1559,252,0.0
5,1,83,1,2,3,261,1542,40,17,95,Tax,1559,301,0.0
4,1,83,1,3,0,4,1549,650,51,-1,,1600,654,0.0
5,1,83,1,3,1,4,1579,34,11,93,Form,1590,38,0.0
5,1,83,1,3,2,47,1579,25,11,89,W-2,1590,72,0.0
5,1,83,1,3,3,140,1569,114,31,96,Statement,1600,254,0.0
5,1,83,1,3,4,549,1549,27,42,18,c,1591,576,0.0
5,1,83,1,3,5,588,1549,27,42,58,0,1591,615,0.0
5,1,83,1,3,6,628,1549,26,42,59,1,1591,654,0.0
2,1,84,0,0,0,5,1602,291,37,-1,,1639,296,0.0
3,1,84,1,0,0,5,1602,291,37,-1,,1639,296,0.0
4,1,84,1,1,0,5,1602,291,15,-1,,1617,296,0.0
5,1,84,1,1,1,5,1602,40,15,93,Copy,1617,45,0.0
5,1,84,1,1,2,51,1602,10,12,91,C,1614,61,0.0
5,1,84,1,1,3,68,1602,26,12,96,For,1614,94,0.0
5,1,84,1,1,4,100,1602,103,12,86,EMPLOYEE'S,1614,203,0.0
5,1,84,1,1,5,210,1602,86,12,96,RECORDS.,1614,296,0.0
4,1,84,1,2,0,5,1624,276,15,-1,,1639,281,0.0
5,1,84,1,2,1,5,1624,33,15,95,(See,1639,38,0.0
5,1,84,1,2,2,44,1624,69,12,96,enclosed,1636,113,0.0
5,1,84,1,2,3,120,1624,49,12,96,Notice,1636,169,0.0
5,1,84,1,2,4,174,1624,16,12,96,to,1636,190,0.0
5,1,84,1,2,5,196,1624,85,15,95,Employee.),1639,281,0.0
2,1,85,0,0,0,864,1547,367,15,-1,,1562,1231,0.0
3,1,85,1,0,0,864,1547,367,15,-1,,1562,1231,0.0
4,1,85,1,1,0,864,1547,367,15,-1,,1562,1231,0.0
5,1,85,1,1,1,864,1547,81,15,95,Department,1562,945,0.0
5,1,85,1,1,2,950,1547,12,12,95,of,1559,962,0.0
5,1,85,1,1,3,966,1547,20,12,93,the,1559,986,0.0
5,1,85,1,1,4,991,1547,118,15,64,Treasury-Internal,1562,1109,0.0
5,1,85,1,1,5,1115,1547,59,12,94,Revenue,1559,1174,0.0
5,1,85,1,1,6,1180,1547,51,12,96,Service,1559,1231,0.0
2,1,86,0,0,0,666,1549,519,76,-1,,1625,1185,0.0
3,1,86,1,0,0,666,1549,519,76,-1,,1625,1185,0.0
4,1,86,1,1,0,666,1549,519,76,-1,,1625,1185,0.0
5,1,86,1,1,1,666,1549,27,42,64,0,1591,693,0.0
5,1,86,1,1,2,1044,1574,141,51,0,<2zT>,1625,1185,0.0
2,1,87,0,0,0,926,1575,110,33,-1,,1608,1036,0.0
3,1,87,1,0,0,926,1575,110,33,-1,,1608,1036,0.0
4,1,87,1,1,0,927,1575,109,15,-1,,1590,1036,0.0
5,1,87,1,1,1,927,1575,35,15,92,"Safe,",1590,962,0.0
5,1,87,1,1,2,967,1575,69,15,92,"accurate,",1590,1036,0.0
4,1,87,1,2,0,926,1596,82,12,-1,,1608,1008,0.0
5,1,87,1,2,1,926,1596,44,12,94,FAST!,1608,970,0.0
5,1,87,1,2,2,980,1596,28,12,94,Use,1608,1008,0.0
1,1,0,0,0,0,0,0,1236,1658,-1,,1658,1236,0.0
2,1,1,0,0,0,596,1,1,50,-1,,51,597,0.0
3,1,1,1,0,0,596,1,1,50,-1,,51,597,0.0
4,1,1,1,1,0,596,1,1,50,-1,,51,597,0.0
5,1,1,1,1,1,596,1,1,50,95, ,51,597,0.0
2,1,2,0,0,0,1,51,658,1,-1,,52,659,0.0
3,1,2,1,0,0,1,51,658,1,-1,,52,659,0.0
4,1,2,1,1,0,1,51,658,1,-1,,52,659,0.0
5,1,2,1,1,1,1,51,658,1,95, ,52,659,0.0
2,1,3,0,0,0,1,103,658,1,-1,,104,659,0.0
3,1,3,1,0,0,1,103,658,1,-1,,104,659,0.0
4,1,3,1,1,0,1,103,658,1,-1,,104,659,0.0
5,1,3,1,1,1,1,103,658,1,95, ,104,659,0.0
2,1,4,0,0,0,660,154,576,3,-1,,157,1236,0.0
3,1,4,1,0,0,660,154,576,3,-1,,157,1236,0.0
4,1,4,1,1,0,660,154,576,3,-1,,157,1236,0.0
5,1,4,1,1,1,660,154,576,3,95, ,157,1236,0.0
2,1,5,0,0,0,660,205,576,3,-1,,208,1236,0.0
3,1,5,1,0,0,660,205,576,3,-1,,208,1236,0.0
4,1,5,1,1,0,660,205,576,3,-1,,208,1236,0.0
5,1,5,1,1,1,660,205,576,3,95, ,208,1236,0.0
2,1,6,0,0,0,1,257,658,1,-1,,258,659,0.0
3,1,6,1,0,0,1,257,658,1,-1,,258,659,0.0
4,1,6,1,1,0,1,257,658,1,-1,,258,659,0.0
5,1,6,1,1,1,1,257,658,1,95, ,258,659,0.0
2,1,7,0,0,0,1,309,658,1,-1,,310,659,0.0
3,1,7,1,0,0,1,309,658,1,-1,,310,659,0.0
4,1,7,1,1,0,1,309,658,1,-1,,310,659,0.0
5,1,7,1,1,1,1,309,658,1,95, ,310,659,0.0
2,1,8,0,0,0,11,3,1182,555,-1,,558,1193,0.0
3,1,8,1,0,0,11,3,1182,555,-1,,558,1193,0.0
4,1,8,1,1,0,55,3,1138,17,-1,,20,1193,0.0
5,1,8,1,1,1,55,5,103,15,91,REISSUED,20,158,0.0
5,1,8,1,1,2,216,7,6,7,2,a,14,222,0.0
5,1,8,1,1,3,236,0,70,24,67,Employee's,24,306,0.0
5,1,8,1,1,4,312,4,35,10,94,social,14,347,0.0
5,1,8,1,1,5,352,4,48,13,96,security,17,400,0.0
5,1,8,1,1,6,406,4,48,10,95,number,14,454,0.0
5,1,8,1,1,7,782,3,35,14,96,"Safe,",17,817,0.0
5,1,8,1,1,8,822,3,71,14,96,"Accurate,",17,893,0.0
5,1,8,1,1,9,1043,0,35,26,95,Visit,26,1078,0.0
5,1,8,1,1,10,1084,4,18,12,95,the,16,1102,0.0
5,1,8,1,1,11,1108,4,23,12,96,IRS,16,1131,0.0
5,1,8,1,1,12,1136,4,57,12,96,Website,16,1193,0.0
4,1,8,1,2,0,44,6,1136,45,-1,,51,1180,0.0
5,1,8,1,2,1,44,19,126,32,96,STATEMENT,51,170,0.0
5,1,8,1,2,2,312,28,150,15,89,760-19-8138,43,462,0.0
5,1,8,1,2,3,612,29,28,10,93,OMB,39,640,0.0
5,1,8,1,2,4,646,29,14,10,96,No.,39,660,0.0
5,1,8,1,2,5,671,29,57,10,87,1545-0008,39,728,0.0
5,1,8,1,2,6,781,28,44,12,95,FAST!,40,825,0.0
5,1,8,1,2,7,835,28,28,12,96,Use,40,863,0.0
5,1,8,1,2,8,900,6,120,45,0,e-file,51,1020,0.0
5,1,8,1,2,9,1031,6,12,45,0,),51,1043,0.0
5,1,8,1,2,10,1048,30,12,11,96,at,41,1060,0.0
5,1,8,1,2,11,1068,22,25,29,88,www,51,1093,0.0
5,1,8,1,2,12,1102,29,78,15,58,irs.goviefile.,44,1180,0.0
4,1,8,1,3,0,12,56,1143,13,-1,,69,1155,0.0
5,1,8,1,3,1,12,56,7,10,79,b,66,19,0.0
5,1,8,1,3,2,29,56,54,13,90,Employer,69,83,0.0
5,1,8,1,3,3,88,56,70,10,95,identification,66,158,0.0
5,1,8,1,3,4,164,56,42,10,96,number,66,206,0.0
5,1,8,1,3,5,681,56,4,10,70,1,66,685,0.0
5,1,8,1,3,6,704,56,40,13,79,"Wages,",69,744,0.0
5,1,8,1,3,7,753,57,24,12,95,"tips,",69,777,0.0
5,1,8,1,3,8,783,56,28,10,96,other,66,811,0.0
5,1,8,1,3,9,819,48,76,26,96,compensation,74,895,0.0
5,1,8,1,3,10,970,56,7,10,31,2,66,977,0.0
5,1,8,1,3,11,995,56,41,10,83,Federal,66,1036,0.0
5,1,8,1,3,12,1042,59,40,7,96,income,66,1082,0.0
5,1,8,1,3,13,1087,57,18,9,96,tax,66,1105,0.0
5,1,8,1,3,14,1109,56,46,10,96,withheld,66,1155,0.0
4,1,8,1,4,0,65,80,1030,15,-1,,95,1095,0.0
5,1,8,1,4,1,65,80,137,15,91,21-7657558,95,202,0.0
5,1,8,1,4,2,725,80,123,15,91,162805.19,95,848,0.0
5,1,8,1,4,3,986,80,109,15,89,57402.86,95,1095,0.0
4,1,8,1,5,0,13,108,1139,13,-1,,121,1152,0.0
5,1,8,1,5,1,13,111,6,7,48,ยข,118,19,0.0
5,1,8,1,5,2,29,108,62,13,94,Employers,121,91,0.0
5,1,8,1,5,3,97,111,30,7,87,"name,",118,127,0.0
5,1,8,1,5,4,137,108,44,10,90,"address,",118,181,0.0
5,1,8,1,5,5,191,108,19,10,96,and,118,210,0.0
5,1,8,1,5,6,215,108,18,10,96,ZIP,118,233,0.0
5,1,8,1,5,7,239,108,26,10,96,code,118,265,0.0
5,1,8,1,5,8,681,108,6,10,69,3,118,687,0.0
5,1,8,1,5,9,705,108,34,10,89,Social,118,739,0.0
5,1,8,1,5,10,747,100,43,25,93,security,125,790,0.0
5,1,8,1,5,11,797,111,33,10,96,wages,121,830,0.0
5,1,8,1,5,12,970,108,7,10,66,4,118,977,0.0
5,1,8,1,5,13,995,108,34,10,71,Social,118,1029,0.0
5,1,8,1,5,14,1035,108,117,13,96,security,121,1152,0.0
5,1,8,1,5,15,1084,100,18,25,96,tax,125,1102,0.0
5,1,8,1,5,16,1107,108,45,13,96,withheld,121,1152,0.0
4,1,8,1,6,0,64,133,1030,20,-1,,153,1094,0.0
5,1,8,1,6,1,64,134,70,14,96,Brown,148,134,0.0
5,1,8,1,6,2,149,134,40,14,96,LLC,148,189,0.0
5,1,8,1,6,3,205,134,68,19,95,Group,153,273,0.0
5,1,8,1,6,4,725,133,123,15,90,184235.06,148,848,0.0
5,1,8,1,6,5,986,133,108,15,89,14093.98,148,1094,0.0
4,1,8,1,7,0,65,159,1054,28,-1,,187,1119,0.0
5,1,8,1,7,1,65,167,40,15,96,489,182,105,0.0
5,1,8,1,7,2,121,167,41,15,96,Liu,182,162,0.0
5,1,8,1,7,3,175,167,112,20,96,Villages,187,287,0.0
5,1,8,1,7,4,681,159,6,10,68,5,169,687,0.0
5,1,8,1,7,5,705,159,51,10,74,Medicare,169,756,0.0
5,1,8,1,7,6,761,162,36,10,96,wages,172,797,0.0
5,1,8,1,7,7,803,159,19,10,92,and,169,822,0.0
5,1,8,1,7,8,827,160,20,12,92,tips,172,847,0.0
5,1,8,1,7,9,970,159,6,10,61,6,169,976,0.0
5,1,8,1,7,10,995,159,51,10,73,Medicare,169,1046,0.0
5,1,8,1,7,11,1051,160,18,9,96,tax,169,1069,0.0
5,1,8,1,7,12,1073,159,46,10,93,withheld,169,1119,0.0
4,1,8,1,8,0,725,184,419,15,-1,,199,1144,0.0
5,1,8,1,8,1,725,184,122,15,90,121322.24,199,847,0.0
5,1,8,1,8,2,1050,184,94,15,95,3518.34,199,1144,0.0
4,1,8,1,9,0,66,201,1006,22,-1,,223,1072,0.0
5,1,8,1,9,1,66,201,68,15,93,South,216,134,0.0
5,1,8,1,9,2,149,201,181,20,93,Thomasborough,221,330,0.0
5,1,8,1,9,3,400,202,29,14,49,NV,216,429,0.0
5,1,8,1,9,4,472,201,122,15,49,46057-871,216,594,0.0
5,1,8,1,9,5,681,210,5,10,67,7,220,686,0.0
5,1,8,1,9,6,705,210,34,10,67,Social,220,739,0.0
5,1,8,1,9,7,746,211,42,12,40,security,223,788,0.0
5,1,8,1,9,8,795,211,19,12,88,tps,223,814,0.0
5,1,8,1,9,9,970,210,6,10,31,8,220,976,0.0
5,1,8,1,9,10,994,210,53,10,55,Allocated,220,1047,0.0
5,1,8,1,9,11,1052,211,20,12,85,tips,223,1072,0.0
4,1,8,1,10,0,725,235,446,15,-1,,250,1171,0.0
5,1,8,1,10,1,725,235,123,15,90,184235.06,250,848,0.0
5,1,8,1,10,2,1050,235,121,15,90,121322.24,250,1171,0.0
4,1,8,1,11,0,11,262,1122,13,-1,,275,1133,0.0
5,1,8,1,11,1,11,262,7,10,0,d-,272,18,0.0
5,1,8,1,11,2,29,262,39,10,33,Control,272,68,0.0
5,1,8,1,11,3,74,262,42,10,96,number,272,116,0.0
5,1,8,1,11,4,680,262,7,10,66,9,272,687,0.0
5,1,8,1,11,5,704,262,48,10,71,Advance,272,752,0.0
5,1,8,1,11,6,758,262,19,10,92,EIC,272,777,0.0
5,1,8,1,11,7,783,263,48,12,96,payment,275,831,0.0
5,1,8,1,11,8,964,262,13,10,79,10,272,977,0.0
5,1,8,1,11,9,995,262,60,13,72,Dependent,275,1055,0.0
5,1,8,1,11,10,1061,265,23,7,96,care,272,1084,0.0
5,1,8,1,11,11,1090,262,43,10,94,benefits,272,1133,0.0
4,1,8,1,12,0,66,286,1023,15,-1,,301,1089,0.0
5,1,8,1,12,1,66,286,80,15,96,396234,301,146,0.0
5,1,8,1,12,2,1050,286,39,15,95,119,301,1089,0.0
4,1,8,1,13,0,12,313,1163,13,-1,,326,1175,0.0
5,1,8,1,13,1,29,313,65,13,81,Employee's,326,94,0.0
5,1,8,1,13,2,99,313,20,10,94,first,323,119,0.0
5,1,8,1,13,3,125,316,30,7,94,name,323,155,0.0
5,1,8,1,13,4,161,313,19,10,96,and,323,180,0.0
5,1,8,1,13,5,186,313,28,10,95,initial,323,214,0.0
5,1,8,1,13,6,280,313,23,10,95,Last,323,303,0.0
5,1,8,1,13,7,309,316,30,7,94,name,323,339,0.0
5,1,8,1,13,8,674,313,11,10,56,71,323,685,0.0
5,1,8,1,13,9,705,313,68,13,69,Nonqualified,326,773,0.0
5,1,8,1,13,10,779,313,29,13,65,"plans,",326,808,0.0
5,1,8,1,13,11,966,313,20,10,36,12a,323,986,0.0
5,1,8,1,13,12,1009,313,22,10,64,See,323,1031,0.0
5,1,8,1,13,13,1037,313,71,10,95,instructions,323,1108,0.0
5,1,8,1,13,14,1112,313,17,10,96,for,323,1129,0.0
5,1,8,1,13,15,1134,313,22,10,96,box,323,1156,0.0
5,1,8,1,13,16,1162,313,13,10,91,12,323,1175,0.0
4,1,8,1,14,0,214,344,888,17,-1,,361,1102,0.0
5,1,8,1,14,1,214,358,3,3,0,r,361,217,0.0
5,1,8,1,14,2,725,344,38,15,95,148,359,763,0.0
5,1,8,1,14,3,1050,344,52,15,96,5315,359,1102,0.0
4,1,8,1,15,0,66,358,921,23,-1,,381,987,0.0
5,1,8,1,15,1,66,358,61,17,96,Seth,375,127,0.0
5,1,8,1,15,2,176,358,96,22,96,Bailey,380,272,0.0
5,1,8,1,15,3,674,370,13,10,48,3,380,687,0.0
5,1,8,1,15,4,693,371,43,10,70,Statutory,381,736,0.0
5,1,8,1,15,5,780,371,50,8,19,Retement,379,830,0.0
5,1,8,1,15,6,866,371,53,10,60,Third-party,381,919,0.0
5,1,8,1,15,7,966,370,21,10,51,12,380,987,0.0
4,1,8,1,16,0,693,385,213,9,-1,,394,906,0.0
5,1,8,1,16,1,693,385,44,9,18,empeyee,394,737,0.0
5,1,8,1,16,2,780,385,18,9,46,plan,394,798,0.0
5,1,8,1,16,3,867,385,18,8,85,sick,393,885,0.0
5,1,8,1,16,4,895,387,11,7,85,pay,394,906,0.0
4,1,8,1,17,0,66,396,1022,17,-1,,413,1088,0.0
5,1,8,1,17,1,66,396,44,17,95,341,413,110,1.0
5,1,8,1,17,2,129,396,109,17,95,Charles,413,238,1.0
5,1,8,1,17,3,255,396,143,17,96,Mountains,413,398,1.0
5,1,8,1,17,4,786,402,10,11,94,x,413,796,0.0
5,1,8,1,17,5,1005,399,13,14,88,D,413,1018,0.0
5,1,8,1,17,6,1050,398,38,15,74,|640,413,1088,0.0
4,1,8,1,18,0,63,419,923,42,-1,,461,986,0.0
5,1,8,1,18,1,63,419,161,42,92,Morganberg,461,224,1.0
5,1,8,1,18,2,305,436,31,16,95,co,452,336,0.0
5,1,8,1,18,3,418,435,156,17,96,47155-8501,452,574,0.0
5,1,8,1,18,4,674,427,13,10,49,44,437,687,0.0
5,1,8,1,18,5,705,427,31,10,81,Other,437,736,0.0
5,1,8,1,18,6,741,427,23,13,86,(see,440,764,0.0
5,1,8,1,18,7,770,427,50,10,96,enclosed,437,820,0.0
5,1,8,1,18,8,826,427,35,10,96,Notice,437,861,0.0
5,1,8,1,18,9,866,428,10,9,96,to,437,876,0.0
5,1,8,1,18,10,882,427,61,13,94,Employee),440,943,0.0
5,1,8,1,18,11,949,419,11,25,46,|,444,960,0.0
5,1,8,1,18,12,966,427,20,10,38,12c,437,986,0.0
4,1,8,1,19,0,1005,458,83,15,-1,,473,1088,0.0
5,1,8,1,19,1,1005,459,13,14,73,D,473,1018,0.0
5,1,8,1,19,2,1049,458,39,15,65,(241,473,1088,0.0
4,1,8,1,20,0,966,484,20,10,-1,,494,986,0.0
5,1,8,1,20,1,966,484,20,10,88,12d,494,986,0.0
4,1,8,1,21,0,1006,515,82,15,-1,,530,1088,0.0
5,1,8,1,21,1,1006,516,13,14,92,H,530,1019,0.0
5,1,8,1,21,2,1050,515,38,15,2,{921,530,1088,0.0
4,1,8,1,22,0,11,545,213,13,-1,,558,224,0.0
5,1,8,1,22,1,11,545,5,10,91,f,555,16,0.0
5,1,8,1,22,2,29,545,65,13,53,Employee's,558,94,0.0
5,1,8,1,22,3,100,545,44,10,91,address,555,144,0.0
5,1,8,1,22,4,150,545,19,10,96,and,555,169,0.0
5,1,8,1,22,5,174,545,18,10,94,ZIP,555,192,0.0
5,1,8,1,22,6,197,545,27,10,96,code,555,224,0.0
2,1,9,0,0,0,660,365,576,3,-1,,368,1236,0.0
3,1,9,1,0,0,660,365,576,3,-1,,368,1236,0.0
4,1,9,1,1,0,660,365,576,3,-1,,368,1236,0.0
5,1,9,1,1,1,660,365,576,3,95, ,368,1236,0.0
2,1,10,0,0,0,689,394,204,1,-1,,395,893,0.0
3,1,10,1,0,0,689,394,204,1,-1,,395,893,0.0
4,1,10,1,1,0,689,394,204,1,-1,,395,893,0.0
5,1,10,1,1,1,689,394,204,1,95, ,395,893,0.0
2,1,11,0,0,0,689,394,1,28,-1,,422,690,0.0
3,1,11,1,0,0,689,394,1,28,-1,,422,690,0.0
4,1,11,1,1,0,689,394,1,28,-1,,422,690,0.0
5,1,11,1,1,1,689,394,1,28,95, ,422,690,0.0
2,1,12,0,0,0,718,394,1,28,-1,,422,719,0.0
3,1,12,1,0,0,718,394,1,28,-1,,422,719,0.0
4,1,12,1,1,0,718,394,1,28,-1,,422,719,0.0
5,1,12,1,1,1,718,394,1,28,95, ,422,719,0.0
2,1,13,0,0,0,776,394,1,28,-1,,422,777,0.0
3,1,13,1,0,0,776,394,1,28,-1,,422,777,0.0
4,1,13,1,1,0,776,394,1,28,-1,,422,777,0.0
5,1,13,1,1,1,776,394,1,28,95, ,422,777,0.0
2,1,14,0,0,0,805,394,1,28,-1,,422,806,0.0
3,1,14,1,0,0,805,394,1,28,-1,,422,806,0.0
4,1,14,1,1,0,805,394,1,28,-1,,422,806,0.0
5,1,14,1,1,1,805,394,1,28,95, ,422,806,0.0
2,1,15,0,0,0,863,394,1,28,-1,,422,864,0.0
3,1,15,1,0,0,863,394,1,28,-1,,422,864,0.0
4,1,15,1,1,0,863,394,1,28,-1,,422,864,0.0
5,1,15,1,1,1,863,394,1,28,95, ,422,864,0.0
2,1,16,0,0,0,892,394,1,28,-1,,422,893,0.0
3,1,16,1,0,0,892,394,1,28,-1,,422,893,0.0
4,1,16,1,1,0,892,394,1,28,-1,,422,893,0.0
5,1,16,1,1,1,892,394,1,28,95, ,422,893,0.0
2,1,17,0,0,0,660,421,576,3,-1,,424,1236,0.0
3,1,17,1,0,0,660,421,576,3,-1,,424,1236,0.0
4,1,17,1,1,0,660,421,576,3,-1,,424,1236,0.0
5,1,17,1,1,1,660,421,576,3,95, ,424,1236,0.0
2,1,18,0,0,0,660,105,1,454,-1,,559,661,0.0
3,1,18,1,0,0,660,105,1,454,-1,,559,661,0.0
4,1,18,1,1,0,660,105,1,454,-1,,559,661,0.0
5,1,18,1,1,1,660,105,1,454,95, ,559,661,0.0
2,1,19,0,0,0,689,421,547,3,-1,,424,1236,0.0
3,1,19,1,0,0,689,421,547,3,-1,,424,1236,0.0
4,1,19,1,1,0,689,421,547,3,-1,,424,1236,0.0
5,1,19,1,1,1,689,421,547,3,95, ,424,1236,0.0
2,1,20,0,0,0,689,421,547,3,-1,,424,1236,0.0
3,1,20,1,0,0,689,421,547,3,-1,,424,1236,0.0
4,1,20,1,1,0,689,421,547,3,-1,,424,1236,0.0
5,1,20,1,1,1,689,421,547,3,95, ,424,1236,0.0
2,1,21,0,0,0,689,421,547,3,-1,,424,1236,0.0
3,1,21,1,0,0,689,421,547,3,-1,,424,1236,0.0
4,1,21,1,1,0,689,421,547,3,-1,,424,1236,0.0
5,1,21,1,1,1,689,421,547,3,95, ,424,1236,0.0
2,1,22,0,0,0,950,479,286,3,-1,,482,1236,0.0
3,1,22,1,0,0,950,479,286,3,-1,,482,1236,0.0
4,1,22,1,1,0,950,479,286,3,-1,,482,1236,0.0
5,1,22,1,1,1,950,479,286,3,95, ,482,1236,0.0
2,1,23,0,0,0,1043,326,1,212,-1,,538,1044,0.0
3,1,23,1,0,0,1043,326,1,212,-1,,538,1044,0.0
4,1,23,1,1,0,1043,326,1,212,-1,,538,1044,0.0
5,1,23,1,1,1,1043,326,1,212,95, ,538,1044,0.0
2,1,24,0,0,0,950,536,286,3,-1,,539,1236,0.0
3,1,24,1,0,0,950,536,286,3,-1,,539,1236,0.0
4,1,24,1,1,0,950,536,286,3,-1,,539,1236,0.0
5,1,24,1,1,1,950,536,286,3,95, ,539,1236,0.0
2,1,25,0,0,0,950,105,1,454,-1,,559,951,0.0
3,1,25,1,0,0,950,105,1,454,-1,,559,951,0.0
4,1,25,1,1,0,950,105,1,454,-1,,559,951,0.0
5,1,25,1,1,1,950,105,1,454,95, ,559,951,0.0
2,1,26,0,0,0,1,557,1235,3,-1,,560,1236,0.0
3,1,26,1,0,0,1,557,1235,3,-1,,560,1236,0.0
4,1,26,1,1,0,1,557,1235,3,-1,,560,1236,0.0
5,1,26,1,1,1,1,557,1235,3,95, ,560,1236,0.0
2,1,27,0,0,0,6,562,241,13,-1,,575,247,0.0
3,1,27,1,0,0,6,562,241,13,-1,,575,247,0.0
4,1,27,1,1,0,6,562,241,13,-1,,575,247,0.0
5,1,27,1,1,1,6,562,13,10,91,15,572,19,0.0
5,1,27,1,1,2,29,562,29,10,62,State!,572,58,0.0
5,1,27,1,1,3,88,562,62,13,60,Employer's,575,150,0.0
5,1,27,1,1,4,156,563,27,9,88,state,572,183,0.0
5,1,27,1,1,5,189,562,10,10,87,ID,572,199,0.0
5,1,27,1,1,6,205,562,42,10,95,number,572,247,0.0
2,1,28,0,0,0,131,587,138,15,-1,,602,269,0.0
3,1,28,1,0,0,131,587,138,15,-1,,602,269,0.0
4,1,28,1,1,0,131,587,138,15,-1,,602,269,0.0
5,1,28,1,1,1,131,587,138,15,87,255-66-026,602,269,0.0
2,1,29,0,0,0,349,562,146,13,-1,,575,495,0.0
3,1,29,1,0,0,349,562,146,13,-1,,575,495,0.0
4,1,29,1,1,0,349,562,146,13,-1,,575,495,0.0
5,1,29,1,1,1,349,562,12,10,57,16,572,361,0.0
5,1,29,1,1,2,370,562,29,10,91,State,572,399,0.0
5,1,29,1,1,3,404,565,36,10,84,"wages,",575,440,0.0
5,1,29,1,1,4,449,563,20,12,94,"tips,",575,469,0.0
5,1,29,1,1,5,479,563,16,9,75,etc,572,495,0.0
2,1,30,0,0,0,347,587,108,15,-1,,602,455,0.0
3,1,30,1,0,0,347,587,108,15,-1,,602,455,0.0
4,1,30,1,1,0,347,587,108,15,-1,,602,455,0.0
5,1,30,1,1,1,347,587,108,15,91,88732.15,602,455,0.0
2,1,31,0,0,0,15,588,28,14,-1,,602,43,0.0
3,1,31,1,0,0,15,588,28,14,-1,,602,43,0.0
4,1,31,1,1,0,15,588,28,14,-1,,602,43,0.0
5,1,31,1,1,1,15,588,28,14,53,vt,602,43,0.0
2,1,32,0,0,0,3,608,1109,3,-1,,611,1112,0.0
3,1,32,1,0,0,3,608,1109,3,-1,,611,1112,0.0
4,1,32,1,1,0,3,608,1109,3,-1,,611,1112,0.0
5,1,32,1,1,1,3,608,1109,3,95, ,611,1112,0.0
2,1,33,0,0,0,58,558,3,103,-1,,661,61,0.0
3,1,33,1,0,0,58,558,3,103,-1,,661,61,0.0
4,1,33,1,1,0,58,558,3,103,-1,,661,61,0.0
5,1,33,1,1,1,58,558,3,103,95, ,661,61,0.0
2,1,34,0,0,0,339,558,3,103,-1,,661,342,0.0
3,1,34,1,0,0,339,558,3,103,-1,,661,342,0.0
4,1,34,1,1,0,339,558,3,103,-1,,661,342,0.0
5,1,34,1,1,1,339,558,3,103,95, ,661,342,0.0
2,1,35,0,0,0,531,558,3,103,-1,,661,534,0.0
3,1,35,1,0,0,531,558,3,103,-1,,661,534,0.0
4,1,35,1,1,0,531,558,3,103,-1,,661,534,0.0
5,1,35,1,1,1,531,558,3,103,95, ,661,534,0.0
2,1,36,0,0,0,541,562,119,10,-1,,572,660,0.0
3,1,36,1,0,0,541,562,119,10,-1,,572,660,0.0
4,1,36,1,1,0,541,562,119,10,-1,,572,660,0.0
5,1,36,1,1,1,541,562,11,10,64,TT,572,552,0.0
5,1,36,1,1,2,562,562,29,10,95,State,572,591,0.0
5,1,36,1,1,3,597,565,40,7,96,income,572,637,0.0
5,1,36,1,1,4,642,563,18,9,96,tax,572,660,0.0
2,1,37,0,0,0,539,587,80,15,-1,,602,619,0.0
3,1,37,1,0,0,539,587,80,15,-1,,602,619,0.0
4,1,37,1,1,0,539,587,80,15,-1,,602,619,0.0
5,1,37,1,1,1,539,587,80,15,89,7477.8,602,619,0.0
2,1,38,0,0,0,930,562,119,10,-1,,572,1049,0.0
3,1,38,1,0,0,930,562,119,10,-1,,572,1049,0.0
4,1,38,1,1,0,930,562,119,10,-1,,572,1049,0.0
5,1,38,1,1,1,930,562,11,10,73,19,572,941,0.0
5,1,38,1,1,2,951,562,29,10,84,Local,572,980,0.0
5,1,38,1,1,3,986,565,40,7,88,income,572,1026,0.0
5,1,38,1,1,4,1031,563,18,9,96,tax,572,1049,0.0
2,1,39,0,0,0,927,587,110,15,-1,,602,1037,0.0
3,1,39,1,0,0,927,587,110,15,-1,,602,1037,0.0
4,1,39,1,1,0,927,587,110,15,-1,,602,1037,0.0
5,1,39,1,1,1,927,587,110,15,87,26813.43,602,1037,0.0
2,1,40,0,0,0,726,562,147,13,-1,,575,873,0.0
3,1,40,1,0,0,726,562,147,13,-1,,575,873,0.0
4,1,40,1,1,0,726,562,147,13,-1,,575,873,0.0
5,1,40,1,1,1,726,562,12,10,75,78,572,738,0.0
5,1,40,1,1,2,748,562,29,10,92,Local,572,777,0.0
5,1,40,1,1,3,782,565,36,10,79,wages.,575,818,0.0
5,1,40,1,1,4,827,563,20,12,94,"tips,",575,847,0.0
5,1,40,1,1,5,857,563,16,9,76,ete,572,873,0.0
2,1,41,0,0,0,725,587,122,15,-1,,602,847,0.0
3,1,41,1,0,0,725,587,122,15,-1,,602,847,0.0
4,1,41,1,1,0,725,587,122,15,-1,,602,847,0.0
5,1,41,1,1,1,725,587,122,15,90,151147.54,602,847,0.0
2,1,42,0,0,0,1114,562,102,13,-1,,575,1216,0.0
3,1,42,1,0,0,1114,562,102,13,-1,,575,1216,0.0
4,1,42,1,1,0,1114,562,102,13,-1,,575,1216,0.0
5,1,42,1,1,1,1114,562,13,10,82,20,572,1127,0.0
5,1,42,1,1,2,1137,562,44,13,90,Locality,575,1181,0.0
5,1,42,1,1,3,1186,565,30,7,96,name,572,1216,0.0
2,1,43,0,0,0,1112,594,117,11,-1,,605,1229,0.0
3,1,43,1,0,0,1112,594,117,11,-1,,605,1229,0.0
4,1,43,1,1,0,1112,594,117,11,-1,,605,1229,0.0
5,1,43,1,1,1,1112,594,28,11,92,Amy,605,1140,0.0
5,1,43,1,1,2,1150,594,79,8,92,Stravenue,602,1229,0.0
2,1,44,0,0,0,1234,1,2,660,-1,,661,1236,0.0
3,1,44,1,0,0,1234,1,2,660,-1,,661,1236,0.0
4,1,44,1,1,0,1234,1,2,660,-1,,661,1236,0.0
5,1,44,1,1,1,1234,1,2,660,95, ,661,1236,0.0
2,1,45,0,0,0,717,394,3,267,-1,,661,720,0.0
3,1,45,1,0,0,717,394,3,267,-1,,661,720,0.0
4,1,45,1,1,0,717,394,3,267,-1,,661,720,0.0
5,1,45,1,1,1,717,394,3,267,95, ,661,720,0.0
2,1,46,0,0,0,1106,558,3,103,-1,,661,1109,0.0
3,1,46,1,0,0,1106,558,3,103,-1,,661,1109,0.0
4,1,46,1,1,0,1106,558,3,103,-1,,661,1109,0.0
5,1,46,1,1,1,1106,558,3,103,95, ,661,1109,0.0
2,1,47,0,0,0,920,558,3,103,-1,,661,923,0.0
3,1,47,1,0,0,920,558,3,103,-1,,661,923,0.0
4,1,47,1,1,0,920,558,3,103,-1,,661,923,0.0
5,1,47,1,1,1,920,558,3,103,95, ,661,923,0.0
2,1,48,0,0,0,1,659,1235,3,-1,,662,1236,0.0
3,1,48,1,0,0,1,659,1235,3,-1,,662,1236,0.0
4,1,48,1,1,0,1,659,1235,3,-1,,662,1236,0.0
5,1,48,1,1,1,1,659,1235,3,95, ,662,1236,0.0
2,1,49,0,0,0,4,634,1228,94,-1,,728,1232,0.0
3,1,49,1,0,0,4,634,1228,86,-1,,720,1232,0.0
4,1,49,1,1,0,12,634,1220,28,-1,,662,1232,0.0
5,1,49,1,1,1,12,634,33,28,96,NM,662,45,0.0
5,1,49,1,1,2,131,638,138,15,90,497-84-843,653,269,0.0
5,1,49,1,1,3,347,638,108,15,90,86586.78,653,455,0.0
5,1,49,1,1,4,539,638,95,15,94,6301.73,653,634,0.0
5,1,49,1,1,5,724,638,124,15,92,200100.36,653,848,0.0
5,1,49,1,1,6,928,638,108,15,90,18330.78,653,1036,0.0
5,1,49,1,1,7,1112,645,48,8,32,Hunter,653,1160,0.0
5,1,49,1,1,8,1168,645,64,8,91,Mountain|,653,1232,0.0
4,1,49,1,2,0,139,670,1092,22,-1,,692,1231,0.0
5,1,49,1,2,1,139,670,63,22,96,Wage,692,202,0.0
5,1,49,1,2,2,211,670,41,17,96,and,687,252,0.0
5,1,49,1,2,3,261,670,40,17,96,Tax,687,301,0.0
5,1,49,1,2,4,864,675,81,15,96,Department,690,945,0.0
5,1,49,1,2,5,950,675,12,12,96,of,687,962,0.0
5,1,49,1,2,6,966,675,20,12,93,the,687,986,0.0
5,1,49,1,2,7,991,675,118,15,35,TreasuryโInternal,690,1109,0.0
5,1,49,1,2,8,1115,675,59,12,96,Revenue,687,1174,0.0
5,1,49,1,2,9,1180,675,51,12,97,Service,687,1231,0.0
4,1,49,1,3,0,4,677,689,51,-1,,728,693,0.0
5,1,49,1,3,1,4,709,34,11,93,Form,720,38,0.0
5,1,49,1,3,2,47,709,25,11,91,W-2,720,72,0.0
5,1,49,1,3,3,140,697,114,31,96,Statement,728,254,0.0
5,1,49,1,3,4,549,677,27,42,21,c,719,576,0.0
5,1,49,1,3,5,588,677,27,42,50,0,719,615,0.0
5,1,49,1,3,6,628,677,26,42,59,1,719,654,0.0
5,1,49,1,3,7,666,677,27,42,52,0,719,693,0.0
2,1,50,0,0,0,4,732,482,37,-1,,769,486,0.0
3,1,50,1,0,0,4,732,482,37,-1,,769,486,0.0
4,1,50,1,1,0,5,732,462,15,-1,,747,467,0.0
5,1,50,1,1,1,5,732,40,15,93,Copy,747,45,0.0
5,1,50,1,1,2,51,732,43,12,91,B--To,744,94,0.0
5,1,50,1,1,3,100,732,19,12,96,Be,744,119,0.0
5,1,50,1,1,4,126,732,35,12,95,Filed,744,161,0.0
5,1,50,1,1,5,167,732,32,12,96,with,744,199,0.0
5,1,50,1,1,6,206,732,87,15,85,Employee's,747,293,0.0
5,1,50,1,1,7,300,732,76,12,96,FEDERAL,744,376,0.0
5,1,50,1,1,8,382,732,27,12,95,Tax,744,409,0.0
5,1,50,1,1,9,415,732,52,12,96,Return,744,467,0.0
4,1,50,1,2,0,4,754,482,15,-1,,769,486,0.0
5,1,50,1,2,1,4,754,29,12,96,This,766,33,0.0
5,1,50,1,2,2,40,754,79,12,93,information,766,119,0.0
5,1,50,1,2,3,126,757,10,9,93,is,766,136,0.0
5,1,50,1,2,4,143,754,38,15,94,being,769,181,0.0
5,1,50,1,2,5,187,754,67,12,96,furnished,766,254,0.0
5,1,50,1,2,6,260,754,12,12,96,to,766,272,0.0
5,1,50,1,2,7,278,754,22,12,96,the,766,300,0.0
5,1,50,1,2,8,307,754,52,12,93,Internal,766,359,0.0
5,1,50,1,2,9,365,754,62,12,95,Revenue,766,427,0.0
5,1,50,1,2,10,433,754,53,12,96,Service,766,486,0.0
2,1,51,0,0,0,469,825,294,14,-1,,839,763,0.0
3,1,51,1,0,0,469,825,294,14,-1,,839,763,0.0
4,1,51,1,1,0,469,825,294,14,-1,,839,763,0.0
5,1,51,1,1,1,469,825,55,11,51,Tuthere.,836,524,0.0
5,1,51,1,1,2,537,825,32,14,92,Keep,839,569,0.0
5,1,51,1,1,3,575,825,34,11,94,lower,836,609,0.0
5,1,51,1,1,4,614,826,42,13,96,portion,839,656,0.0
5,1,51,1,1,5,661,825,17,11,72,for,836,678,0.0
5,1,51,1,1,6,682,828,28,11,94,your,839,710,0.0
5,1,51,1,1,7,715,825,48,11,67,records,836,763,0.0
2,1,52,0,0,0,1,873,1235,3,-1,,876,1236,0.0
3,1,52,1,0,0,1,873,1235,3,-1,,876,1236,0.0
4,1,52,1,1,0,1,873,1235,3,-1,,876,1236,0.0
5,1,52,1,1,1,1,873,1235,3,95, ,876,1236,0.0
2,1,53,0,0,0,212,874,1,52,-1,,926,213,0.0
3,1,53,1,0,0,212,874,1,52,-1,,926,213,0.0
4,1,53,1,1,0,212,874,1,52,-1,,926,213,0.0
5,1,53,1,1,1,212,874,1,52,95, ,926,213,0.0
2,1,54,0,0,0,596,874,1,52,-1,,926,597,0.0
3,1,54,1,0,0,596,874,1,52,-1,,926,597,0.0
4,1,54,1,1,0,596,874,1,52,-1,,926,597,0.0
5,1,54,1,1,1,596,874,1,52,95, ,926,597,0.0
2,1,55,0,0,0,1,924,1235,3,-1,,927,1236,0.0
3,1,55,1,0,0,1,924,1235,3,-1,,927,1236,0.0
4,1,55,1,1,0,1,924,1235,3,-1,,927,1236,0.0
5,1,55,1,1,1,1,924,1235,3,95, ,927,1236,0.0
2,1,56,0,0,0,1,975,1235,3,-1,,978,1236,0.0
3,1,56,1,0,0,1,975,1235,3,-1,,978,1236,0.0
4,1,56,1,1,0,1,975,1235,3,-1,,978,1236,0.0
5,1,56,1,1,1,1,975,1235,3,95, ,978,1236,0.0
2,1,57,0,0,0,660,1026,576,3,-1,,1029,1236,0.0
3,1,57,1,0,0,660,1026,576,3,-1,,1029,1236,0.0
4,1,57,1,1,0,660,1026,576,3,-1,,1029,1236,0.0
5,1,57,1,1,1,660,1026,576,3,95, ,1029,1236,0.0
2,1,58,0,0,0,660,1077,576,3,-1,,1080,1236,0.0
3,1,58,1,0,0,660,1077,576,3,-1,,1080,1236,0.0
4,1,58,1,1,0,660,1077,576,3,-1,,1080,1236,0.0
5,1,58,1,1,1,660,1077,576,3,95, ,1080,1236,0.0
2,1,59,0,0,0,1,1128,1235,3,-1,,1131,1236,0.0
3,1,59,1,0,0,1,1128,1235,3,-1,,1131,1236,0.0
4,1,59,1,1,0,1,1128,1235,3,-1,,1131,1236,0.0
5,1,59,1,1,1,1,1128,1235,3,95, ,1131,1236,0.0
2,1,60,0,0,0,1,1179,1235,3,-1,,1182,1236,0.0
3,1,60,1,0,0,1,1179,1235,3,-1,,1182,1236,0.0
4,1,60,1,1,0,1,1179,1235,3,-1,,1182,1236,0.0
5,1,60,1,1,1,1,1179,1235,3,95, ,1182,1236,0.0
2,1,61,0,0,0,11,878,1217,553,-1,,1431,1228,0.0
3,1,61,1,0,0,11,878,1217,553,-1,,1431,1228,0.0
4,1,61,1,1,0,216,878,976,13,-1,,891,1192,0.0
5,1,61,1,1,1,216,881,6,7,44,[a,888,222,0.0
5,1,61,1,1,2,236,878,71,13,41,Employee's,891,307,0.0
5,1,61,1,1,3,311,878,36,10,96,social,888,347,0.0
5,1,61,1,1,4,352,878,48,13,96,security,891,400,0.0
5,1,61,1,1,5,406,878,48,10,90,number,888,454,0.0
5,1,61,1,1,6,750,878,23,10,96,This,888,773,0.0
5,1,61,1,1,7,779,878,61,10,96,information,888,840,0.0
5,1,61,1,1,8,846,881,8,7,96,is,888,854,0.0
5,1,61,1,1,9,860,878,29,13,96,being,891,889,0.0
5,1,61,1,1,10,894,878,51,10,96,furnished,888,945,0.0
5,1,61,1,1,11,950,879,10,9,96,to,888,960,0.0
5,1,61,1,1,12,965,878,17,10,94,the,888,982,0.0
5,1,61,1,1,13,988,878,40,10,28,intemal,888,1028,0.0
5,1,61,1,1,14,1034,878,47,10,96,Revenue,888,1081,0.0
5,1,61,1,1,15,1087,878,40,10,77,Service.,888,1127,0.0
5,1,61,1,1,16,1141,878,29,13,73,Ifyou,891,1170,0.0
5,1,61,1,1,17,1176,881,16,7,93,are,888,1192,0.0
4,1,61,1,2,0,55,879,1173,34,-1,,913,1228,0.0
5,1,61,1,2,1,55,879,103,15,90,REISSUED,894,158,0.0
5,1,61,1,2,2,790,895,5,10,63,d,905,795,0.0
5,1,61,1,2,3,800,891,8,22,96,to,913,808,0.0
5,1,61,1,2,4,815,895,8,10,95,file,905,823,0.0
5,1,61,1,2,5,835,891,5,22,93,a,913,840,0.0
5,1,61,1,2,6,846,896,3,9,61,ti,905,849,0.0
5,1,61,1,2,7,875,891,7,22,63,tt,913,882,0.0
5,1,61,1,2,8,942,895,1,10,62,i,905,943,0.0
5,1,61,1,2,9,1015,891,9,22,59,ty,913,1024,0.0
5,1,61,1,2,10,1054,895,10,10,47,th,905,1064,0.0
5,1,61,1,2,11,1108,891,7,22,85,ti,913,1115,0.0
5,1,61,1,2,12,1159,891,10,22,93,be,913,1169,0.0
5,1,61,1,2,13,1219,891,9,22,3,od,913,1228,0.0
4,1,61,1,3,0,751,898,470,10,-1,,908,1221,0.0
5,1,61,1,3,1,751,898,37,10,90,required,908,788,0.0
5,1,61,1,3,2,798,884,9,31,96,to,915,807,0.0
5,1,61,1,3,3,825,898,5,7,81,fle,905,830,0.0
5,1,61,1,3,4,836,898,5,7,94,a,905,841,0.0
5,1,61,1,3,5,851,898,13,7,96,tax,905,864,0.0
5,1,61,1,3,6,869,898,35,8,94,"return,",906,904,0.0
5,1,61,1,3,7,910,898,5,7,96,a,905,915,0.0
5,1,61,1,3,8,921,898,60,10,94,negligence,908,981,0.0
5,1,61,1,3,9,987,898,26,10,96,penalty,908,1013,0.0
5,1,61,1,3,10,1033,898,9,10,96,or,908,1042,0.0
5,1,61,1,3,11,1066,898,10,7,95,other,905,1076,0.0
5,1,61,1,3,12,1081,898,47,7,92,sanction,905,1128,0.0
5,1,61,1,3,13,1134,898,24,10,96,may,908,1158,0.0
5,1,61,1,3,14,1170,898,5,7,96,be,905,1175,0.0
5,1,61,1,3,15,1181,898,40,10,60,impose,908,1221,0.0
4,1,61,1,4,0,44,903,1018,22,-1,,925,1062,0.0
5,1,61,1,4,1,44,906,126,15,96,STATEMENT,921,170,0.0
5,1,61,1,4,2,312,903,150,15,84,760-19-8138,918,462,0.0
5,1,61,1,4,3,612,903,28,10,96,OMB,913,640,0.0
5,1,61,1,4,4,646,903,14,10,79,No.,913,660,0.0
5,1,61,1,4,5,671,903,57,10,80,1645-0008,913,728,0.0
5,1,61,1,4,6,751,915,12,7,50,on,922,763,0.0
5,1,61,1,4,7,776,915,12,7,38,you,922,788,0.0
5,1,61,1,4,8,794,912,6,10,38,if,922,800,0.0
5,1,61,1,4,9,803,912,20,10,79,this,922,823,0.0
5,1,61,1,4,10,829,915,40,7,55,income,922,869,0.0
5,1,61,1,4,11,875,915,8,7,92,is,922,883,0.0
5,1,61,1,4,12,888,912,41,10,92,taxable,922,929,0.0
5,1,61,1,4,13,935,912,19,10,96,and,922,954,0.0
5,1,61,1,4,14,967,915,12,7,75,you,922,979,0.0
5,1,61,1,4,15,984,912,15,10,75,fail,922,999,0.0
5,1,61,1,4,16,1004,913,10,9,86,to,922,1014,0.0
5,1,61,1,4,17,1020,913,31,12,52,report,925,1051,0.0
5,1,61,1,4,18,1057,913,5,9,52,it,922,1062,0.0
4,1,61,1,5,0,12,929,1143,13,-1,,942,1155,0.0
5,1,61,1,5,1,12,929,7,10,82,b,939,19,0.0
5,1,61,1,5,2,29,929,54,13,93,Employer,942,83,0.0
5,1,61,1,5,3,88,929,70,10,96,identification,939,158,0.0
5,1,61,1,5,4,164,929,42,10,96,number,939,206,0.0
5,1,61,1,5,5,681,929,4,10,60,1,939,685,0.0
5,1,61,1,5,6,704,929,40,13,84,"Wages,",942,744,0.0
5,1,61,1,5,7,753,930,20,12,95,"tips,",942,773,0.0
5,1,61,1,5,8,783,929,28,10,96,other,939,811,0.0
5,1,61,1,5,9,816,930,79,12,96,compensation,942,895,0.0
5,1,61,1,5,10,970,929,7,10,0,2,939,977,0.0
5,1,61,1,5,11,995,929,41,10,75,Federal,939,1036,0.0
5,1,61,1,5,12,1042,932,40,7,95,income,939,1082,0.0
5,1,61,1,5,13,1087,930,18,9,96,tax,939,1105,0.0
5,1,61,1,5,14,1109,929,46,10,96,withheld,939,1155,0.0
4,1,61,1,6,0,65,954,1030,15,-1,,969,1095,0.0
5,1,61,1,6,1,65,954,137,15,92,21-7657558,969,202,0.0
5,1,61,1,6,2,725,954,123,15,90,162805.19,969,848,0.0
5,1,61,1,6,3,986,954,109,15,85,57402.86,969,1095,0.0
4,1,61,1,7,0,13,980,1139,13,-1,,993,1152,0.0
5,1,61,1,7,1,13,983,6,7,43,ยข,990,19,0.0
5,1,61,1,7,2,29,980,62,13,94,Employers,993,91,0.0
5,1,61,1,7,3,97,983,30,7,91,"name,",990,127,0.0
5,1,61,1,7,4,137,980,44,10,92,"address,",990,181,0.0
5,1,61,1,7,5,191,980,19,10,95,and,990,210,0.0
5,1,61,1,7,6,215,980,18,10,95,ZIP,990,233,0.0
5,1,61,1,7,7,239,980,26,10,96,code,990,265,0.0
5,1,61,1,7,8,681,980,6,10,66,3,990,687,0.0
5,1,61,1,7,9,705,980,34,10,90,Social,990,739,0.0
5,1,61,1,7,10,745,972,45,25,95,security,997,790,0.0
5,1,61,1,7,11,797,983,33,10,96,wages,993,830,0.0
5,1,61,1,7,12,970,980,7,10,58,4,990,977,0.0
5,1,61,1,7,13,995,980,34,10,83,Social,990,1029,0.0
5,1,61,1,7,14,1035,980,117,13,96,security,993,1152,0.0
5,1,61,1,7,15,1084,972,18,25,96,tax,997,1102,0.0
5,1,61,1,7,16,1107,980,45,13,96,withheld,993,1152,0.0
4,1,61,1,8,0,64,1005,1030,20,-1,,1025,1094,0.0
5,1,61,1,8,1,64,1006,70,14,96,Brown,1020,134,0.0
5,1,61,1,8,2,149,1006,40,14,96,LLC,1020,189,0.0
5,1,61,1,8,3,205,1006,68,19,96,Group,1025,273,0.0
5,1,61,1,8,4,725,1005,123,15,89,184235.06,1020,848,0.0
5,1,61,1,8,5,986,1005,108,15,87,14093.98,1020,1094,0.0
4,1,61,1,9,0,65,1031,1054,28,-1,,1059,1119,0.0
5,1,61,1,9,1,65,1039,40,15,96,489,1054,105,0.0
5,1,61,1,9,2,121,1039,41,15,96,Liu,1054,162,0.0
5,1,61,1,9,3,175,1039,112,20,95,Villages,1059,287,0.0
5,1,61,1,9,4,681,1031,6,10,67,5,1041,687,0.0
5,1,61,1,9,5,705,1031,51,10,81,Medicare,1041,756,0.0
5,1,61,1,9,6,761,1034,36,10,96,wages,1044,797,0.0
5,1,61,1,9,7,803,1031,19,10,93,and,1041,822,0.0
5,1,61,1,9,8,827,1032,20,12,93,tips,1044,847,0.0
5,1,61,1,9,9,970,1031,6,10,68,6,1041,976,0.0
5,1,61,1,9,10,995,1031,51,10,66,Medicare,1041,1046,0.0
5,1,61,1,9,11,1051,1032,18,9,96,tax,1041,1069,0.0
5,1,61,1,9,12,1074,1031,45,10,95,withheld,1041,1119,0.0
4,1,61,1,10,0,725,1056,419,15,-1,,1071,1144,0.0
5,1,61,1,10,1,725,1056,122,15,89,121322.24,1071,847,0.0
5,1,61,1,10,2,1050,1056,94,15,94,3518.34,1071,1144,0.0
4,1,61,1,11,0,66,1073,1006,22,-1,,1095,1072,0.0
5,1,61,1,11,1,66,1073,68,15,93,South,1088,134,0.0
5,1,61,1,11,2,149,1073,181,20,93,Thomasborough,1093,330,0.0
5,1,61,1,11,3,400,1074,29,14,49,NV,1088,429,0.0
5,1,61,1,11,4,472,1073,122,15,49,46057-871,1088,594,0.0
5,1,61,1,11,5,681,1082,5,10,69,7,1092,686,0.0
5,1,61,1,11,6,705,1082,34,10,69,Social,1092,739,0.0
5,1,61,1,11,7,746,1083,42,12,40,security,1095,788,0.0
5,1,61,1,11,8,795,1083,19,12,85,tps,1095,814,0.0
5,1,61,1,11,9,971,1082,5,10,47,8,1092,976,0.0
5,1,61,1,11,10,994,1082,53,10,84,Allocated,1092,1047,0.0
5,1,61,1,11,11,1052,1083,20,12,91,tips,1095,1072,0.0
4,1,61,1,12,0,725,1107,446,15,-1,,1122,1171,0.0
5,1,61,1,12,1,725,1107,123,15,90,184235.06,1122,848,0.0
5,1,61,1,12,2,1050,1107,121,15,90,121322.24,1122,1171,0.0
4,1,61,1,13,0,11,1133,1122,13,-1,,1146,1133,0.0
5,1,61,1,13,1,11,1133,57,10,0,โControl,1143,68,0.0
5,1,61,1,13,2,74,1133,42,10,96,number,1143,116,0.0
5,1,61,1,13,3,680,1133,7,10,67,9,1143,687,0.0
5,1,61,1,13,4,704,1133,48,10,67,Advance,1143,752,0.0
5,1,61,1,13,5,758,1133,19,10,92,EIC,1143,777,0.0
5,1,61,1,13,6,783,1134,48,12,96,payment,1146,831,0.0
5,1,61,1,13,7,964,1133,13,10,78,40,1143,977,0.0
5,1,61,1,13,8,995,1133,60,13,75,Dependent,1146,1055,0.0
5,1,61,1,13,9,1061,1136,23,7,92,care,1143,1084,0.0
5,1,61,1,13,10,1090,1133,43,10,91,benefits,1143,1133,0.0
4,1,61,1,14,0,66,1158,1023,15,-1,,1173,1089,0.0
5,1,61,1,14,1,66,1158,80,15,96,396234,1173,146,0.0
5,1,61,1,14,2,1050,1158,39,15,95,119,1173,1089,0.0
4,1,61,1,15,0,12,1184,1163,13,-1,,1197,1175,0.0
5,1,61,1,15,1,12,1187,6,7,33,@,1194,18,0.0
5,1,61,1,15,2,29,1184,65,13,76,Employee's,1197,94,0.0
5,1,61,1,15,3,99,1184,20,10,95,first,1194,119,0.0
5,1,61,1,15,4,125,1187,30,7,95,name,1194,155,0.0
5,1,61,1,15,5,161,1184,19,10,96,and,1194,180,0.0
5,1,61,1,15,6,186,1184,28,10,96,initial,1194,214,0.0
5,1,61,1,15,7,280,1184,23,10,96,Last,1194,303,0.0
5,1,61,1,15,8,309,1187,30,7,94,name,1194,339,0.0
5,1,61,1,15,9,674,1184,11,10,60,11,1194,685,0.0
5,1,61,1,15,10,705,1184,68,13,79,Nonqualified,1197,773,0.0
5,1,61,1,15,11,779,1184,29,13,76,plans,1197,808,0.0
5,1,61,1,15,12,966,1184,20,10,36,12a,1194,986,0.0
5,1,61,1,15,13,1009,1184,22,10,63,See,1194,1031,0.0
5,1,61,1,15,14,1037,1184,71,10,91,instructions,1194,1108,0.0
5,1,61,1,15,15,1112,1184,17,10,96,for,1194,1129,0.0
5,1,61,1,15,16,1134,1184,22,10,96,box,1194,1156,0.0
5,1,61,1,15,17,1162,1184,13,10,89,12,1194,1175,0.0
4,1,61,1,16,0,214,1215,888,17,-1,,1232,1102,0.0
5,1,61,1,16,1,214,1229,3,3,0,-,1232,217,0.0
5,1,61,1,16,2,725,1215,38,15,96,148,1230,763,0.0
5,1,61,1,16,3,1050,1215,52,15,94,5315,1230,1102,0.0
4,1,61,1,17,0,66,1229,921,23,-1,,1252,987,0.0
5,1,61,1,17,1,66,1229,61,17,96,Seth,1246,127,0.0
5,1,61,1,17,2,176,1229,96,22,96,Bailey,1251,272,0.0
5,1,61,1,17,3,674,1241,13,10,45,7B,1251,687,0.0
5,1,61,1,17,4,693,1242,43,10,81,Statutory,1252,736,0.0
5,1,61,1,17,5,780,1242,139,10,0,Retrement__Thie-party,1252,919,0.0
5,1,61,1,17,6,966,1241,21,10,62,12,1251,987,0.0
4,1,61,1,18,0,693,1257,213,10,-1,,1267,906,0.0
5,1,61,1,18,1,693,1257,44,10,59,empoyee,1267,737,0.0
5,1,61,1,18,2,780,1257,18,10,31,plan,1267,798,0.0
5,1,61,1,18,3,867,1257,18,8,95,sick,1265,885,0.0
5,1,61,1,18,4,889,1259,17,8,94,pay,1267,906,0.0
4,1,61,1,19,0,66,1269,1022,17,-1,,1286,1088,0.0
5,1,61,1,19,1,66,1269,44,17,95,341,1286,110,0.0
5,1,61,1,19,2,129,1269,109,17,96,Charles,1286,238,0.0
5,1,61,1,19,3,255,1270,143,16,96,Mountains,1286,398,0.0
5,1,61,1,19,4,786,1275,10,11,93,x,1286,796,0.0
5,1,61,1,19,5,1005,1272,13,14,90,D,1286,1018,0.0
5,1,61,1,19,6,1050,1271,38,15,81,|640,1286,1088,0.0
4,1,61,1,20,0,674,1300,312,13,-1,,1313,986,0.0
5,1,61,1,20,1,674,1300,13,10,49,44,1310,687,0.0
5,1,61,1,20,2,705,1300,31,10,84,Other,1310,736,0.0
5,1,61,1,20,3,741,1301,23,12,85,(see,1313,764,0.0
5,1,61,1,20,4,770,1300,50,10,96,enclosed,1310,820,0.0
5,1,61,1,20,5,826,1300,35,10,96,Notice,1310,861,0.0
5,1,61,1,20,6,866,1301,10,9,96,to,1310,876,0.0
5,1,61,1,20,7,882,1300,61,13,96,Employee),1313,943,0.0
5,1,61,1,20,8,949,1292,9,25,49,|,1317,958,0.0
5,1,61,1,20,9,966,1300,20,10,49,12c,1310,986,0.0
4,1,61,1,21,0,63,1304,511,31,-1,,1335,574,0.0
5,1,61,1,21,1,63,1304,161,31,92,Morganberg,1335,224,0.0
5,1,61,1,21,2,305,1309,31,16,90,co,1325,336,0.0
5,1,61,1,21,3,418,1308,156,17,95,47155-8501,1325,574,0.0
4,1,61,1,22,0,1005,1331,83,15,-1,,1346,1088,0.0
5,1,61,1,22,1,1005,1332,13,14,75,D,1346,1018,0.0
5,1,61,1,22,2,1049,1331,39,15,66,(241,1346,1088,0.0
4,1,61,1,23,0,966,1357,20,10,-1,,1367,986,0.0
5,1,61,1,23,1,966,1357,20,10,88,12d,1367,986,0.0
4,1,61,1,24,0,1006,1388,82,15,-1,,1403,1088,0.0
5,1,61,1,24,1,1006,1389,13,14,92,H,1403,1019,0.0
5,1,61,1,24,2,1050,1388,38,15,19,{921,1403,1088,0.0
4,1,61,1,25,0,11,1418,213,13,-1,,1431,224,0.0
5,1,61,1,25,1,11,1418,5,10,69,f,1428,16,0.0
5,1,61,1,25,2,29,1418,65,13,69,Employee's,1431,94,0.0
5,1,61,1,25,3,100,1418,44,10,93,address,1428,144,0.0
5,1,61,1,25,4,150,1418,19,10,96,and,1428,169,0.0
5,1,61,1,25,5,174,1418,18,10,92,ZIP,1428,192,0.0
5,1,61,1,25,6,197,1418,27,10,92,code,1428,224,0.0
2,1,62,0,0,0,660,925,1,507,-1,,1432,661,0.0
3,1,62,1,0,0,660,925,1,507,-1,,1432,661,0.0
4,1,62,1,1,0,660,925,1,507,-1,,1432,661,0.0
5,1,62,1,1,1,660,925,1,507,95, ,1432,661,0.0
2,1,63,0,0,0,660,1236,576,3,-1,,1239,1236,0.0
3,1,63,1,0,0,660,1236,576,3,-1,,1239,1236,0.0
4,1,63,1,1,0,660,1236,576,3,-1,,1239,1236,0.0
5,1,63,1,1,1,660,1236,576,3,95, ,1239,1236,0.0
2,1,64,0,0,0,689,1267,204,1,-1,,1268,893,0.0
3,1,64,1,0,0,689,1267,204,1,-1,,1268,893,0.0
4,1,64,1,1,0,689,1267,204,1,-1,,1268,893,0.0
5,1,64,1,1,1,689,1267,204,1,95, ,1268,893,0.0
2,1,65,0,0,0,689,1267,1,28,-1,,1295,690,0.0
3,1,65,1,0,0,689,1267,1,28,-1,,1295,690,0.0
4,1,65,1,1,0,689,1267,1,28,-1,,1295,690,0.0
5,1,65,1,1,1,689,1267,1,28,95, ,1295,690,0.0
2,1,66,0,0,0,718,1267,1,28,-1,,1295,719,0.0
3,1,66,1,0,0,718,1267,1,28,-1,,1295,719,0.0
4,1,66,1,1,0,718,1267,1,28,-1,,1295,719,0.0
5,1,66,1,1,1,718,1267,1,28,95, ,1295,719,0.0
2,1,67,0,0,0,776,1267,1,28,-1,,1295,777,0.0
3,1,67,1,0,0,776,1267,1,28,-1,,1295,777,0.0
4,1,67,1,1,0,776,1267,1,28,-1,,1295,777,0.0
5,1,67,1,1,1,776,1267,1,28,95, ,1295,777,0.0
2,1,68,0,0,0,805,1267,1,28,-1,,1295,806,0.0
3,1,68,1,0,0,805,1267,1,28,-1,,1295,806,0.0
4,1,68,1,1,0,805,1267,1,28,-1,,1295,806,0.0
5,1,68,1,1,1,805,1267,1,28,95, ,1295,806,0.0
2,1,69,0,0,0,863,1267,1,28,-1,,1295,864,0.0
3,1,69,1,0,0,863,1267,1,28,-1,,1295,864,0.0
4,1,69,1,1,0,863,1267,1,28,-1,,1295,864,0.0
5,1,69,1,1,1,863,1267,1,28,95, ,1295,864,0.0
2,1,70,0,0,0,892,1267,1,28,-1,,1295,893,0.0
3,1,70,1,0,0,892,1267,1,28,-1,,1295,893,0.0
4,1,70,1,1,0,892,1267,1,28,-1,,1295,893,0.0
5,1,70,1,1,1,892,1267,1,28,95, ,1295,893,0.0
2,1,71,0,0,0,660,1294,576,3,-1,,1297,1236,0.0
3,1,71,1,0,0,660,1294,576,3,-1,,1297,1236,0.0
4,1,71,1,1,0,660,1294,576,3,-1,,1297,1236,0.0
5,1,71,1,1,1,660,1294,576,3,95, ,1297,1236,0.0
2,1,72,0,0,0,689,1294,547,3,-1,,1297,1236,0.0
3,1,72,1,0,0,689,1294,547,3,-1,,1297,1236,0.0
4,1,72,1,1,0,689,1294,547,3,-1,,1297,1236,0.0
5,1,72,1,1,1,689,1294,547,3,95, ,1297,1236,0.0
2,1,73,0,0,0,689,1294,547,3,-1,,1297,1236,0.0
3,1,73,1,0,0,689,1294,547,3,-1,,1297,1236,0.0
4,1,73,1,1,0,689,1294,547,3,-1,,1297,1236,0.0
5,1,73,1,1,1,689,1294,547,3,95, ,1297,1236,0.0
2,1,74,0,0,0,689,1294,547,3,-1,,1297,1236,0.0
3,1,74,1,0,0,689,1294,547,3,-1,,1297,1236,0.0
4,1,74,1,1,0,689,1294,547,3,-1,,1297,1236,0.0
5,1,74,1,1,1,689,1294,547,3,95, ,1297,1236,0.0
2,1,75,0,0,0,950,1352,286,3,-1,,1355,1236,0.0
3,1,75,1,0,0,950,1352,286,3,-1,,1355,1236,0.0
4,1,75,1,1,0,950,1352,286,3,-1,,1355,1236,0.0
5,1,75,1,1,1,950,1352,286,3,95, ,1355,1236,0.0
2,1,76,0,0,0,1043,1197,1,214,-1,,1411,1044,0.0
3,1,76,1,0,0,1043,1197,1,214,-1,,1411,1044,0.0
4,1,76,1,1,0,1043,1197,1,214,-1,,1411,1044,0.0
5,1,76,1,1,1,1043,1197,1,214,95, ,1411,1044,0.0
2,1,77,0,0,0,950,1409,286,3,-1,,1412,1236,0.0
3,1,77,1,0,0,950,1409,286,3,-1,,1412,1236,0.0
4,1,77,1,1,0,950,1409,286,3,-1,,1412,1236,0.0
5,1,77,1,1,1,950,1409,286,3,95, ,1412,1236,0.0
2,1,78,0,0,0,950,925,1,507,-1,,1432,951,0.0
3,1,78,1,0,0,950,925,1,507,-1,,1432,951,0.0
4,1,78,1,1,0,950,925,1,507,-1,,1432,951,0.0
5,1,78,1,1,1,950,925,1,507,95, ,1432,951,0.0
2,1,79,0,0,0,1,1430,1235,3,-1,,1433,1236,0.0
3,1,79,1,0,0,1,1430,1235,3,-1,,1433,1236,0.0
4,1,79,1,1,0,1,1430,1235,3,-1,,1433,1236,0.0
5,1,79,1,1,1,1,1430,1235,3,95, ,1433,1236,0.0
2,1,80,0,0,0,6,1435,52,10,-1,,1445,58,0.0
3,1,80,1,0,0,6,1435,52,10,-1,,1445,58,0.0
4,1,80,1,1,0,6,1435,52,10,-1,,1445,58,0.0
5,1,80,1,1,1,6,1435,13,10,85,15,1445,19,0.0
5,1,80,1,1,2,29,1435,29,10,85,State,1445,58,0.0
2,1,81,0,0,0,88,1435,159,13,-1,,1448,247,0.0
3,1,81,1,0,0,88,1435,159,13,-1,,1448,247,0.0
4,1,81,1,1,0,88,1435,159,13,-1,,1448,247,0.0
5,1,81,1,1,1,88,1435,62,13,72,Employer's,1448,150,0.0
5,1,81,1,1,2,156,1436,27,9,92,state,1445,183,0.0
5,1,81,1,1,3,189,1435,10,10,90,ID,1445,199,0.0
5,1,81,1,1,4,205,1435,42,10,96,number,1445,247,0.0
2,1,82,0,0,0,349,1435,146,13,-1,,1448,495,0.0
3,1,82,1,0,0,349,1435,146,13,-1,,1448,495,0.0
4,1,82,1,1,0,349,1435,146,13,-1,,1448,495,0.0
5,1,82,1,1,1,349,1435,11,10,53,16,1445,360,0.0
5,1,82,1,1,2,370,1435,29,10,93,State,1445,399,0.0
5,1,82,1,1,3,404,1438,36,10,90,"wages,",1448,440,0.0
5,1,82,1,1,4,449,1436,20,12,90,"tips,",1448,469,0.0
5,1,82,1,1,5,479,1436,16,9,77,etc,1445,495,0.0
2,1,83,0,0,0,0,1456,1236,31,-1,,1487,1236,0.0
3,1,83,1,0,0,0,1456,1236,31,-1,,1487,1236,0.0
4,1,83,1,1,0,0,1456,1236,31,-1,,1487,1236,0.0
5,1,83,1,1,1,0,1456,1236,31,95, ,1487,1236,0.0
2,1,84,0,0,0,59,1431,1,104,-1,,1535,60,0.0
3,1,84,1,0,0,59,1431,1,104,-1,,1535,60,0.0
4,1,84,1,1,0,59,1431,1,104,-1,,1535,60,0.0
5,1,84,1,1,1,59,1431,1,104,95, ,1535,60,0.0
2,1,85,0,0,0,340,1431,1,104,-1,,1535,341,0.0
3,1,85,1,0,0,340,1431,1,104,-1,,1535,341,0.0
4,1,85,1,1,0,340,1431,1,104,-1,,1535,341,0.0
5,1,85,1,1,1,340,1431,1,104,95, ,1535,341,0.0
2,1,86,0,0,0,532,1431,1,104,-1,,1535,533,0.0
3,1,86,1,0,0,532,1431,1,104,-1,,1535,533,0.0
4,1,86,1,1,0,532,1431,1,104,-1,,1535,533,0.0
5,1,86,1,1,1,532,1431,1,104,95, ,1535,533,0.0
2,1,87,0,0,0,541,1435,119,10,-1,,1445,660,0.0
3,1,87,1,0,0,541,1435,119,10,-1,,1445,660,0.0
4,1,87,1,1,0,541,1435,119,10,-1,,1445,660,0.0
5,1,87,1,1,1,541,1435,12,10,63,17,1445,553,0.0
5,1,87,1,1,2,562,1435,29,10,94,State,1445,591,0.0
5,1,87,1,1,3,597,1438,40,7,95,income,1445,637,0.0
5,1,87,1,1,4,642,1436,18,9,96,tax,1445,660,0.0
2,1,88,0,0,0,539,1512,95,15,-1,,1527,634,0.0
3,1,88,1,0,0,539,1512,95,15,-1,,1527,634,0.0
4,1,88,1,1,0,539,1512,95,15,-1,,1527,634,0.0
5,1,88,1,1,1,539,1512,95,15,96,6301.73,1527,634,0.0
2,1,89,0,0,0,727,1435,489,13,-1,,1448,1216,0.0
3,1,89,1,0,0,727,1435,489,13,-1,,1448,1216,0.0
4,1,89,1,1,0,727,1435,489,13,-1,,1448,1216,0.0
5,1,89,1,1,1,727,1435,11,10,69,78,1445,738,0.0
5,1,89,1,1,2,748,1435,29,10,94,Local,1445,777,0.0
5,1,89,1,1,3,782,1438,40,10,94,"wages,",1448,822,0.0
5,1,89,1,1,4,827,1436,20,12,94,"tips,",1448,847,0.0
5,1,89,1,1,5,857,1436,16,9,75,etc,1445,873,0.0
5,1,89,1,1,6,929,1435,12,10,76,79,1445,941,0.0
5,1,89,1,1,7,951,1435,29,10,85,Local,1445,980,0.0
5,1,89,1,1,8,986,1438,40,7,96,income,1445,1026,0.0
5,1,89,1,1,9,1031,1436,18,9,96,tax,1445,1049,0.0
5,1,89,1,1,10,1114,1435,13,10,85,20,1445,1127,0.0
5,1,89,1,1,11,1137,1435,44,13,89,Locality,1448,1181,0.0
5,1,89,1,1,12,1186,1438,30,7,96,name,1445,1216,0.0
2,1,90,0,0,0,724,1512,312,15,-1,,1527,1036,0.0
3,1,90,1,0,0,724,1512,312,15,-1,,1527,1036,0.0
4,1,90,1,1,0,724,1512,312,15,-1,,1527,1036,0.0
5,1,90,1,1,1,724,1512,124,15,90,200100.36,1527,848,0.0
5,1,90,1,1,2,928,1512,108,15,89,18330.78,1527,1036,0.0
2,1,91,0,0,0,1113,1519,119,8,-1,,1527,1232,0.0
3,1,91,1,0,0,1113,1519,119,8,-1,,1527,1232,0.0
4,1,91,1,1,0,1113,1519,119,8,-1,,1527,1232,0.0
5,1,91,1,1,1,1113,1519,47,8,90,Hunter,1527,1160,0.0
5,1,91,1,1,2,1168,1519,64,8,90,Mountain|,1527,1232,0.0
2,1,92,0,0,0,1235,874,1,661,-1,,1535,1236,0.0
3,1,92,1,0,0,1235,874,1,661,-1,,1535,1236,0.0
4,1,92,1,1,0,1235,874,1,661,-1,,1535,1236,0.0
5,1,92,1,1,1,1235,874,1,661,95, ,1535,1236,0.0
2,1,93,0,0,0,718,1267,1,268,-1,,1535,719,0.0
3,1,93,1,0,0,718,1267,1,268,-1,,1535,719,0.0
4,1,93,1,1,0,718,1267,1,268,-1,,1535,719,0.0
5,1,93,1,1,1,718,1267,1,268,95, ,1535,719,0.0
2,1,94,0,0,0,1107,1431,1,104,-1,,1535,1108,0.0
3,1,94,1,0,0,1107,1431,1,104,-1,,1535,1108,0.0
4,1,94,1,1,0,1107,1431,1,104,-1,,1535,1108,0.0
5,1,94,1,1,1,1107,1431,1,104,95, ,1535,1108,0.0
2,1,95,0,0,0,921,1431,1,104,-1,,1535,922,0.0
3,1,95,1,0,0,921,1431,1,104,-1,,1535,922,0.0
4,1,95,1,1,0,921,1431,1,104,-1,,1535,922,0.0
5,1,95,1,1,1,921,1431,1,104,95, ,1535,922,0.0
2,1,96,0,0,0,338,1533,898,3,-1,,1536,1236,0.0
3,1,96,1,0,0,338,1533,898,3,-1,,1536,1236,0.0
4,1,96,1,1,0,338,1533,898,3,-1,,1536,1236,0.0
5,1,96,1,1,1,338,1533,898,3,95, ,1536,1236,0.0
2,1,97,0,0,0,0,1530,341,9,-1,,1539,341,0.0
3,1,97,1,0,0,0,1530,341,9,-1,,1539,341,0.0
4,1,97,1,1,0,0,1530,341,9,-1,,1539,341,0.0
5,1,97,1,1,1,0,1530,341,9,95, ,1539,341,0.0
2,1,98,0,0,0,4,1508,451,82,-1,,1590,455,0.0
3,1,98,1,0,0,4,1508,451,82,-1,,1590,455,0.0
4,1,98,1,1,0,12,1508,443,28,-1,,1536,455,0.0
5,1,98,1,1,1,12,1508,33,28,96,NM,1536,45,0.0
5,1,98,1,1,2,131,1512,138,15,91,497-84-843,1527,269,0.0
5,1,98,1,1,3,347,1512,108,15,89,86586.78,1527,455,0.0
4,1,98,1,2,0,139,1542,162,22,-1,,1564,301,0.0
5,1,98,1,2,1,139,1542,63,22,95,Wage,1564,202,0.0
5,1,98,1,2,2,211,1542,41,17,96,and,1559,252,0.0
5,1,98,1,2,3,261,1542,40,17,95,Tax,1559,301,0.0
4,1,98,1,3,0,4,1573,250,17,-1,,1590,254,0.0
5,1,98,1,3,1,4,1579,34,11,93,Form,1590,38,0.0
5,1,98,1,3,2,47,1579,25,11,89,W-2,1590,72,0.0
5,1,98,1,3,3,140,1573,114,17,96,Statement,1590,254,0.0
2,1,99,0,0,0,5,1602,291,37,-1,,1639,296,0.0
3,1,99,1,0,0,5,1602,291,37,-1,,1639,296,0.0
4,1,99,1,1,0,5,1602,291,15,-1,,1617,296,0.0
5,1,99,1,1,1,5,1602,40,15,93,Copy,1617,45,0.0
5,1,99,1,1,2,51,1602,10,12,91,C,1614,61,0.0
5,1,99,1,1,3,68,1602,26,12,96,For,1614,94,0.0
5,1,99,1,1,4,100,1602,103,12,86,EMPLOYEE'S,1614,203,0.0
5,1,99,1,1,5,210,1602,86,12,96,RECORDS.,1614,296,0.0
4,1,99,1,2,0,5,1624,276,15,-1,,1639,281,0.0
5,1,99,1,2,1,5,1624,33,15,95,(See,1639,38,0.0
5,1,99,1,2,2,44,1624,69,12,96,enclosed,1636,113,0.0
5,1,99,1,2,3,120,1624,49,12,96,Notice,1636,169,0.0
5,1,99,1,2,4,174,1624,16,12,96,to,1636,190,0.0
5,1,99,1,2,5,196,1624,85,15,95,Employee.),1639,281,0.0
2,1,100,0,0,0,549,1549,105,42,-1,,1591,654,0.0
3,1,100,1,0,0,549,1549,105,42,-1,,1591,654,0.0
4,1,100,1,1,0,549,1549,105,42,-1,,1591,654,0.0
5,1,100,1,1,1,549,1549,105,42,74,cOl,1591,654,0.0
2,1,101,0,0,0,864,1547,367,15,-1,,1562,1231,0.0
3,1,101,1,0,0,864,1547,367,15,-1,,1562,1231,0.0
4,1,101,1,1,0,864,1547,367,15,-1,,1562,1231,0.0
5,1,101,1,1,1,864,1547,81,15,95,Department,1562,945,0.0
5,1,101,1,1,2,950,1547,12,12,95,of,1559,962,0.0
5,1,101,1,1,3,966,1547,20,12,93,the,1559,986,0.0
5,1,101,1,1,4,991,1547,118,15,64,Treasury-Internal,1562,1109,0.0
5,1,101,1,1,5,1115,1547,59,12,94,Revenue,1559,1174,0.0
5,1,101,1,1,6,1180,1547,51,12,96,Service,1559,1231,0.0
2,1,102,0,0,0,666,1549,519,76,-1,,1625,1185,0.0
3,1,102,1,0,0,666,1549,519,76,-1,,1625,1185,0.0
4,1,102,1,1,0,666,1549,519,76,-1,,1625,1185,0.0
5,1,102,1,1,1,666,1549,27,42,64,0,1591,693,0.0
5,1,102,1,1,2,1044,1574,141,51,0,<2zT>,1625,1185,0.0
2,1,103,0,0,0,926,1575,110,33,-1,,1608,1036,0.0
3,1,103,1,0,0,926,1575,110,33,-1,,1608,1036,0.0
4,1,103,1,1,0,927,1575,109,15,-1,,1590,1036,0.0
5,1,103,1,1,1,927,1575,35,15,92,"Safe,",1590,962,0.0
5,1,103,1,1,2,967,1575,69,15,92,"accurate,",1590,1036,0.0
4,1,103,1,2,0,926,1596,82,12,-1,,1608,1008,0.0
5,1,103,1,2,1,926,1596,44,12,94,FAST!,1608,970,0.0
5,1,103,1,2,2,980,1596,28,12,94,Use,1608,1008,0.0
1,1,0,0,0,0,0,0,1236,1658,-1,,1658,1236,0.0
2,1,1,0,0,0,55,5,103,15,-1,,20,158,0.0
3,1,1,1,0,0,55,5,103,15,-1,,20,158,0.0
4,1,1,1,1,0,55,5,103,15,-1,,20,158,0.0
5,1,1,1,1,1,55,5,103,15,92,REISSUED,20,158,0.0
2,1,2,0,0,0,216,4,238,13,-1,,17,454,0.0
3,1,2,1,0,0,216,4,238,13,-1,,17,454,0.0
4,1,2,1,1,0,216,4,238,13,-1,,17,454,0.0
5,1,2,1,1,1,216,7,6,7,0,a,14,222,0.0
5,1,2,1,1,2,236,4,71,13,72,Employee's,17,307,0.0
5,1,2,1,1,3,311,4,36,10,96,social,14,347,0.0
5,1,2,1,1,4,352,4,48,13,95,security,17,400,0.0
5,1,2,1,1,5,406,4,48,10,95,number,14,454,0.0
2,1,3,0,0,0,596,1,1,50,-1,,51,597,0.0
3,1,3,1,0,0,596,1,1,50,-1,,51,597,0.0
4,1,3,1,1,0,596,1,1,50,-1,,51,597,0.0
5,1,3,1,1,1,596,1,1,50,95, ,51,597,0.0
2,1,4,0,0,0,1,50,658,3,-1,,53,659,0.0
3,1,4,1,0,0,1,50,658,3,-1,,53,659,0.0
4,1,4,1,1,0,1,50,658,3,-1,,53,659,0.0
5,1,4,1,1,1,1,50,658,3,95, ,53,659,0.0
2,1,5,0,0,0,1,102,658,3,-1,,105,659,0.0
3,1,5,1,0,0,1,102,658,3,-1,,105,659,0.0
4,1,5,1,1,0,1,102,658,3,-1,,105,659,0.0
5,1,5,1,1,1,1,102,658,3,95, ,105,659,0.0
2,1,6,0,0,0,782,3,411,14,-1,,17,1193,0.0
3,1,6,1,0,0,782,3,411,14,-1,,17,1193,0.0
4,1,6,1,1,0,782,3,411,14,-1,,17,1193,0.0
5,1,6,1,1,1,782,3,35,14,95,"Safe,",17,817,0.0
5,1,6,1,1,2,822,3,71,14,96,"Accurate,",17,893,0.0
5,1,6,1,1,3,1047,4,31,12,96,Visit,16,1078,0.0
5,1,6,1,1,4,1082,4,20,12,96,the,16,1102,0.0
5,1,6,1,1,5,1108,4,23,12,96,IRS,16,1131,0.0
5,1,6,1,1,6,1136,4,57,12,96,Website,16,1193,0.0
2,1,7,0,0,0,904,10,136,34,-1,,44,1040,0.0
3,1,7,1,0,0,904,10,136,34,-1,,44,1040,0.0
4,1,7,1,1,0,904,10,136,34,-1,,44,1040,0.0
5,1,7,1,1,1,904,10,136,34,6,e-file],44,1040,0.0
2,1,8,0,0,0,660,153,576,5,-1,,158,1236,0.0
3,1,8,1,0,0,660,153,576,5,-1,,158,1236,0.0
4,1,8,1,1,0,660,153,576,5,-1,,158,1236,0.0
5,1,8,1,1,1,660,153,576,5,95, ,158,1236,0.0
2,1,9,0,0,0,660,204,576,5,-1,,209,1236,0.0
3,1,9,1,0,0,660,204,576,5,-1,,209,1236,0.0
4,1,9,1,1,0,660,204,576,5,-1,,209,1236,0.0
5,1,9,1,1,1,660,204,576,5,95, ,209,1236,0.0
2,1,10,0,0,0,1,256,658,3,-1,,259,659,0.0
3,1,10,1,0,0,1,256,658,3,-1,,259,659,0.0
4,1,10,1,1,0,1,256,658,3,-1,,259,659,0.0
5,1,10,1,1,1,1,256,658,3,95, ,259,659,0.0
2,1,11,0,0,0,1,308,658,3,-1,,311,659,0.0
3,1,11,1,0,0,1,308,658,3,-1,,311,659,0.0
4,1,11,1,1,0,1,308,658,3,-1,,311,659,0.0
5,1,11,1,1,1,1,308,658,3,95, ,311,659,0.0
2,1,12,0,0,0,660,364,576,5,-1,,369,1236,0.0
3,1,12,1,0,0,660,364,576,5,-1,,369,1236,0.0
4,1,12,1,1,0,660,364,576,5,-1,,369,1236,0.0
5,1,12,1,1,1,660,364,576,5,95, ,369,1236,0.0
2,1,13,0,0,0,689,394,204,1,-1,,395,893,0.0
3,1,13,1,0,0,689,394,204,1,-1,,395,893,0.0
4,1,13,1,1,0,689,394,204,1,-1,,395,893,0.0
5,1,13,1,1,1,689,394,204,1,95, ,395,893,0.0
2,1,14,0,0,0,689,394,1,28,-1,,422,690,0.0
3,1,14,1,0,0,689,394,1,28,-1,,422,690,0.0
4,1,14,1,1,0,689,394,1,28,-1,,422,690,0.0
5,1,14,1,1,1,689,394,1,28,95, ,422,690,0.0
2,1,15,0,0,0,718,394,1,28,-1,,422,719,0.0
3,1,15,1,0,0,718,394,1,28,-1,,422,719,0.0
4,1,15,1,1,0,718,394,1,28,-1,,422,719,0.0
5,1,15,1,1,1,718,394,1,28,95, ,422,719,0.0
2,1,16,0,0,0,776,394,1,28,-1,,422,777,0.0
3,1,16,1,0,0,776,394,1,28,-1,,422,777,0.0
4,1,16,1,1,0,776,394,1,28,-1,,422,777,0.0
5,1,16,1,1,1,776,394,1,28,95, ,422,777,0.0
2,1,17,0,0,0,805,394,1,28,-1,,422,806,0.0
3,1,17,1,0,0,805,394,1,28,-1,,422,806,0.0
4,1,17,1,1,0,805,394,1,28,-1,,422,806,0.0
5,1,17,1,1,1,805,394,1,28,95, ,422,806,0.0
2,1,18,0,0,0,863,394,1,28,-1,,422,864,0.0
3,1,18,1,0,0,863,394,1,28,-1,,422,864,0.0
4,1,18,1,1,0,863,394,1,28,-1,,422,864,0.0
5,1,18,1,1,1,863,394,1,28,95, ,422,864,0.0
2,1,19,0,0,0,892,394,1,28,-1,,422,893,0.0
3,1,19,1,0,0,892,394,1,28,-1,,422,893,0.0
4,1,19,1,1,0,892,394,1,28,-1,,422,893,0.0
5,1,19,1,1,1,892,394,1,28,95, ,422,893,0.0
2,1,20,0,0,0,660,419,576,7,-1,,426,1236,0.0
3,1,20,1,0,0,660,419,576,7,-1,,426,1236,0.0
4,1,20,1,1,0,660,419,576,7,-1,,426,1236,0.0
5,1,20,1,1,1,660,419,576,7,95, ,426,1236,0.0
2,1,21,0,0,0,689,420,547,5,-1,,425,1236,0.0
3,1,21,1,0,0,689,420,547,5,-1,,425,1236,0.0
4,1,21,1,1,0,689,420,547,5,-1,,425,1236,0.0
5,1,21,1,1,1,689,420,547,5,95, ,425,1236,0.0
2,1,22,0,0,0,689,420,547,5,-1,,425,1236,0.0
3,1,22,1,0,0,689,420,547,5,-1,,425,1236,0.0
4,1,22,1,1,0,689,420,547,5,-1,,425,1236,0.0
5,1,22,1,1,1,689,420,547,5,95, ,425,1236,0.0
2,1,23,0,0,0,689,420,547,5,-1,,425,1236,0.0
3,1,23,1,0,0,689,420,547,5,-1,,425,1236,0.0
4,1,23,1,1,0,689,420,547,5,-1,,425,1236,0.0
5,1,23,1,1,1,689,420,547,5,95, ,425,1236,0.0
2,1,24,0,0,0,950,479,286,3,-1,,482,1236,0.0
3,1,24,1,0,0,950,479,286,3,-1,,482,1236,0.0
4,1,24,1,1,0,950,479,286,3,-1,,482,1236,0.0
5,1,24,1,1,1,950,479,286,3,95, ,482,1236,0.0
2,1,25,0,0,0,1043,326,1,212,-1,,538,1044,0.0
3,1,25,1,0,0,1043,326,1,212,-1,,538,1044,0.0
4,1,25,1,1,0,1043,326,1,212,-1,,538,1044,0.0
5,1,25,1,1,1,1043,326,1,212,95, ,538,1044,0.0
2,1,26,0,0,0,950,536,286,3,-1,,539,1236,0.0
3,1,26,1,0,0,950,536,286,3,-1,,539,1236,0.0
4,1,26,1,1,0,950,536,286,3,-1,,539,1236,0.0
5,1,26,1,1,1,950,536,286,3,95, ,539,1236,0.0
2,1,27,0,0,0,11,18,1169,540,-1,,558,1180,0.0
3,1,27,1,0,0,12,18,1168,103,-1,,121,1180,0.0
4,1,27,1,1,0,44,18,1136,33,-1,,51,1180,0.0
5,1,27,1,1,1,44,18,126,33,96,STATEMENT,51,170,0.0
5,1,27,1,1,2,311,28,151,15,91,280-96-5377,43,462,0.0
5,1,27,1,1,3,612,29,28,10,93,OMB,39,640,0.0
5,1,27,1,1,4,646,29,14,10,93,No.,39,660,0.0
5,1,27,1,1,5,671,29,57,10,69,1646-0008,39,728,0.0
5,1,27,1,1,6,781,28,44,12,94,FAST!,40,825,0.0
5,1,27,1,1,7,835,28,28,12,94,Use,40,863,0.0
5,1,27,1,1,8,1048,30,12,11,93,at,41,1060,0.0
5,1,27,1,1,9,1069,29,111,15,64,www.irs.goviefile.,44,1180,0.0
4,1,27,1,2,0,12,56,1143,13,-1,,69,1155,0.0
5,1,27,1,2,1,12,56,7,10,79,b,66,19,0.0
5,1,27,1,2,2,29,56,54,13,90,Employer,69,83,0.0
5,1,27,1,2,3,88,56,70,10,95,identification,66,158,0.0
5,1,27,1,2,4,164,56,42,10,96,number,66,206,0.0
5,1,27,1,2,5,681,56,4,10,70,1,66,685,0.0
5,1,27,1,2,6,704,56,40,13,79,"Wages,",69,744,0.0
5,1,27,1,2,7,753,57,24,12,95,"tips,",69,777,0.0
5,1,27,1,2,8,783,56,28,10,96,other,66,811,0.0
5,1,27,1,2,9,819,48,76,26,96,compensation,74,895,0.0
5,1,27,1,2,10,970,56,7,10,31,2,66,977,0.0
5,1,27,1,2,11,995,56,41,10,83,Federal,66,1036,0.0
5,1,27,1,2,12,1042,59,40,7,96,income,66,1082,0.0
5,1,27,1,2,13,1087,57,16,9,96,tax,66,1103,0.0
5,1,27,1,2,14,1109,56,46,10,96,withheld,66,1155,0.0
4,1,27,1,3,0,66,80,1028,15,-1,,95,1094,0.0
5,1,27,1,3,1,66,80,136,15,92,33-0179104,95,202,0.0
5,1,27,1,3,2,725,80,108,15,44,71292.15,95,833,0.0
5,1,27,1,3,3,985,80,109,15,91,22405.22,95,1094,0.0
4,1,27,1,4,0,13,108,1139,13,-1,,121,1152,0.0
5,1,27,1,4,1,13,111,6,7,48,ยข,118,19,0.0
5,1,27,1,4,2,29,108,62,13,94,Employers,121,91,0.0
5,1,27,1,4,3,97,111,30,7,87,"name,",118,127,0.0
5,1,27,1,4,4,137,108,44,10,90,"address,",118,181,0.0
5,1,27,1,4,5,191,108,19,10,96,and,118,210,0.0
5,1,27,1,4,6,215,108,18,10,96,ZIP,118,233,0.0
5,1,27,1,4,7,239,108,26,10,96,code,118,265,0.0
5,1,27,1,4,8,681,108,6,10,69,3,118,687,0.0
5,1,27,1,4,9,705,108,34,10,89,Social,118,739,0.0
5,1,27,1,4,10,747,100,43,25,93,security,125,790,0.0
5,1,27,1,4,11,797,111,33,10,96,wages,121,830,0.0
5,1,27,1,4,12,970,108,7,10,66,4,118,977,0.0
5,1,27,1,4,13,995,108,34,10,71,Social,118,1029,0.0
5,1,27,1,4,14,1035,108,117,13,96,security,121,1152,0.0
5,1,27,1,4,15,1084,100,18,25,96,tax,125,1102,0.0
5,1,27,1,4,16,1107,108,45,13,96,withheld,121,1152,0.0
3,1,27,2,0,0,11,133,1164,425,-1,,558,1175,0.0
4,1,27,2,1,0,65,133,1015,19,-1,,152,1080,0.0
5,1,27,2,1,1,65,133,92,19,96,"Flores,",152,157,0.0
5,1,27,2,1,2,177,133,98,15,96,Hubbard,148,275,0.0
5,1,27,2,1,3,289,133,41,15,96,and,148,330,0.0
5,1,27,2,1,4,345,133,111,15,96,Franklin,148,456,0.0
5,1,27,2,1,5,472,134,39,14,96,Inc,148,511,0.0
5,1,27,2,1,6,725,133,109,15,89,59800.89,148,834,0.0
5,1,27,2,1,7,985,133,95,15,17,4574.77,148,1080,0.0
4,1,27,2,2,0,66,159,1053,28,-1,,187,1119,0.0
5,1,27,2,2,1,66,167,38,15,96,638,182,104,0.0
5,1,27,2,2,2,121,167,110,15,95,Jennifer,182,231,0.0
5,1,27,2,2,3,248,167,95,20,83,springs,187,343,0.0
5,1,27,2,2,4,681,159,6,10,73,5,169,687,0.0
5,1,27,2,2,5,705,159,51,10,79,Medicare,169,756,0.0
5,1,27,2,2,6,761,162,36,10,96,wages,172,797,0.0
5,1,27,2,2,7,803,159,19,10,87,and,169,822,0.0
5,1,27,2,2,8,827,160,20,12,87,tips,172,847,0.0
5,1,27,2,2,9,970,159,6,10,62,6,169,976,0.0
5,1,27,2,2,10,995,159,51,10,75,Medicare,169,1046,0.0
5,1,27,2,2,11,1051,160,18,9,96,tax,169,1069,0.0
5,1,27,2,2,12,1073,159,46,10,95,withheld,169,1119,0.0
4,1,27,2,3,0,725,184,420,15,-1,,199,1145,0.0
5,1,27,2,3,1,725,184,109,15,91,65211.43,199,834,0.0
5,1,27,2,3,2,1050,184,95,15,95,1891.13,199,1145,0.0
4,1,27,2,4,0,63,196,1009,30,-1,,226,1072,0.0
5,1,27,2,4,1,63,196,141,30,90,Adamsmouth,226,204,0.0
5,1,27,2,4,2,274,202,29,14,96,OR,216,303,0.0
5,1,27,2,4,3,360,201,136,15,93,71848-7881,216,496,0.0
5,1,27,2,4,4,681,210,5,10,65,7,220,686,0.0
5,1,27,2,4,5,705,210,34,10,84,Social,220,739,0.0
5,1,27,2,4,6,747,198,40,30,52,secunty,228,787,0.0
5,1,27,2,4,7,794,211,20,12,95,tips,223,814,0.0
5,1,27,2,4,8,970,210,6,10,83,@,220,976,0.0
5,1,27,2,4,9,994,210,53,10,62,Allocated,220,1047,0.0
5,1,27,2,4,10,1052,211,20,12,80,tips,223,1072,0.0
4,1,27,2,5,0,725,235,434,15,-1,,250,1159,0.0
5,1,27,2,5,1,725,235,109,15,89,59800.89,250,834,0.0
5,1,27,2,5,2,1050,235,109,15,0,65211.,250,1159,0.0
5,1,27,2,5,3,1134,231,29,28,0,43,259,1163,0.0
4,1,27,2,6,0,11,262,1122,13,-1,,275,1133,0.0
5,1,27,2,6,1,11,262,7,10,0,d-,272,18,0.0
5,1,27,2,6,2,29,262,39,10,94,Control,272,68,0.0
5,1,27,2,6,3,74,262,42,10,96,number,272,116,0.0
5,1,27,2,6,4,680,262,7,10,62,9,272,687,0.0
5,1,27,2,6,5,704,262,48,10,74,Advance,272,752,0.0
5,1,27,2,6,6,758,262,19,10,91,EIC,272,777,0.0
5,1,27,2,6,7,783,263,48,12,96,payment,275,831,0.0
5,1,27,2,6,8,964,262,13,10,79,10,272,977,0.0
5,1,27,2,6,9,995,262,60,13,74,Dependent,275,1055,0.0
5,1,27,2,6,10,1061,265,23,7,96,care,272,1084,0.0
5,1,27,2,6,11,1090,262,43,10,93,benefits,272,1133,0.0
4,1,27,2,7,0,65,286,1023,15,-1,,301,1088,0.0
5,1,27,2,7,1,65,286,95,15,95,4858295,301,160,0.0
5,1,27,2,7,2,1049,286,39,15,96,287,301,1088,0.0
4,1,27,2,8,0,12,313,1163,13,-1,,326,1175,0.0
5,1,27,2,8,1,29,313,65,13,81,Employee's,326,94,0.0
5,1,27,2,8,2,99,313,20,10,94,first,323,119,0.0
5,1,27,2,8,3,125,316,30,7,94,name,323,155,0.0
5,1,27,2,8,4,161,313,19,10,96,and,323,180,0.0
5,1,27,2,8,5,186,313,28,10,95,initial,323,214,0.0
5,1,27,2,8,6,280,313,23,10,95,Last,323,303,0.0
5,1,27,2,8,7,309,316,30,7,94,name,323,339,0.0
5,1,27,2,8,8,674,313,11,10,56,71,323,685,0.0
5,1,27,2,8,9,705,313,68,13,69,Nonqualified,326,773,0.0
5,1,27,2,8,10,779,313,29,13,65,"plans,",326,808,0.0
5,1,27,2,8,11,966,313,20,10,36,12a,323,986,0.0
5,1,27,2,8,12,1009,313,22,10,64,See,323,1031,0.0
5,1,27,2,8,13,1037,313,92,10,95,instructions,323,1129,0.0
5,1,27,2,8,14,1112,305,19,25,96,for,330,1131,0.0
5,1,27,2,8,15,1134,313,22,10,96,box,323,1156,0.0
5,1,27,2,8,16,1162,313,13,10,91,12,323,1175,0.0
4,1,27,2,9,0,725,344,377,15,-1,,359,1102,0.0
5,1,27,2,9,1,725,344,38,15,96,300,359,763,0.0
5,1,27,2,9,2,1050,344,52,15,95,4755,359,1102,0.0
4,1,27,2,10,0,64,358,923,23,-1,,381,987,0.0
5,1,27,2,10,1,64,358,95,17,96,Robert,375,159,0.0
5,1,27,2,10,2,224,359,95,16,96,Benson,375,319,0.0
5,1,27,2,10,3,674,370,13,10,83,13,380,687,0.0
5,1,27,2,10,4,693,371,43,10,0,Stauiory,381,736,0.0
5,1,27,2,10,5,780,371,50,8,9,__Relrement,379,830,0.0
5,1,27,2,10,6,866,371,53,10,9,__โThire-pary,381,919,0.0
5,1,27,2,10,7,966,370,21,10,58,1,380,987,0.0
4,1,27,2,11,0,693,385,213,9,-1,,394,906,0.0
5,1,27,2,11,1,693,385,44,9,12,empoyee,394,737,0.0
5,1,27,2,11,2,780,385,18,9,39,plan,394,798,0.0
5,1,27,2,11,3,867,385,18,8,91,sick,393,885,0.0
5,1,27,2,11,4,895,387,11,7,91,pay,394,906,0.0
4,1,27,2,12,0,66,396,1022,22,-1,,418,1088,0.0
5,1,27,2,12,1,66,396,76,17,96,84813,413,142,1.0
5,1,27,2,12,2,160,396,63,17,96,Eric,413,223,1.0
5,1,27,2,12,3,240,397,48,21,96,Way,418,288,1.0
5,1,27,2,12,4,303,397,59,21,95,Apt.,418,362,1.0
5,1,27,2,12,5,386,396,45,17,96,116,413,431,1.0
5,1,27,2,12,6,873,402,10,11,94,x,413,883,0.0
5,1,27,2,12,7,1006,399,13,14,88,H,413,1019,0.0
5,1,27,2,12,8,1050,398,38,15,78,|685,413,1088,0.0
4,1,27,2,13,0,64,419,922,38,-1,,457,986,0.0
5,1,27,2,13,1,64,435,80,17,96,North,452,144,1.0
5,1,27,2,13,2,192,435,160,22,91,berborough,457,352,0.0
5,1,27,2,13,3,427,419,38,37,94,AR,456,465,1.0
5,1,27,2,13,4,531,435,65,17,69,9425',452,596,0.0
5,1,27,2,13,5,674,427,13,10,49,44,437,687,0.0
5,1,27,2,13,6,705,427,31,10,81,Other,437,736,0.0
5,1,27,2,13,7,741,427,23,13,86,(see,440,764,0.0
5,1,27,2,13,8,770,427,50,10,96,enclosed,437,820,0.0
5,1,27,2,13,9,826,427,35,10,96,Notice,437,861,0.0
5,1,27,2,13,10,866,428,10,9,96,to,437,876,0.0
5,1,27,2,13,11,882,427,61,13,94,Employee),440,943,0.0
5,1,27,2,13,12,949,419,11,25,46,|,444,960,0.0
5,1,27,2,13,13,966,427,20,10,38,12c,437,986,0.0
4,1,27,2,14,0,1005,458,83,15,-1,,473,1088,0.0
5,1,27,2,14,1,1005,459,13,14,75,E,473,1018,0.0
5,1,27,2,14,2,1049,458,39,15,65,|201,473,1088,0.0
4,1,27,2,15,0,966,484,20,10,-1,,494,986,0.0
5,1,27,2,15,1,966,484,20,10,88,12d,494,986,0.0
4,1,27,2,16,0,1050,515,38,15,-1,,530,1088,0.0
5,1,27,2,16,1,1050,515,38,15,96,595,530,1088,0.0
4,1,27,2,17,0,11,545,213,13,-1,,558,224,0.0
5,1,27,2,17,1,11,545,5,10,91,f,555,16,0.0
5,1,27,2,17,2,29,545,65,13,53,Employee's,558,94,0.0
5,1,27,2,17,3,100,545,44,10,91,address,555,144,0.0
5,1,27,2,17,4,150,545,19,10,96,and,555,169,0.0
5,1,27,2,17,5,174,545,18,10,94,ZIP,555,192,0.0
5,1,27,2,17,6,197,545,27,10,96,code,555,224,0.0
2,1,28,0,0,0,659,105,3,454,-1,,559,662,0.0
3,1,28,1,0,0,659,105,3,454,-1,,559,662,0.0
4,1,28,1,1,0,659,105,3,454,-1,,559,662,0.0
5,1,28,1,1,1,659,105,3,454,95, ,559,662,0.0
2,1,29,0,0,0,949,105,3,454,-1,,559,952,0.0
3,1,29,1,0,0,949,105,3,454,-1,,559,952,0.0
4,1,29,1,1,0,949,105,3,454,-1,,559,952,0.0
5,1,29,1,1,1,949,105,3,454,95, ,559,952,0.0
2,1,30,0,0,0,1,555,1235,7,-1,,562,1236,0.0
3,1,30,1,0,0,1,555,1235,7,-1,,562,1236,0.0
4,1,30,1,1,0,1,555,1235,7,-1,,562,1236,0.0
5,1,30,1,1,1,1,555,1235,7,95, ,562,1236,0.0
2,1,31,0,0,0,6,562,52,40,-1,,602,58,0.0
3,1,31,1,0,0,6,562,52,40,-1,,602,58,0.0
4,1,31,1,1,0,6,562,52,10,-1,,572,58,0.0
5,1,31,1,1,1,6,562,13,10,89,15,572,19,0.0
5,1,31,1,1,2,29,562,29,10,89,State,572,58,0.0
4,1,31,1,2,0,17,588,27,14,-1,,602,44,0.0
5,1,31,1,2,1,17,588,27,14,85,TX,602,44,0.0
2,1,32,0,0,0,88,562,159,13,-1,,575,247,0.0
3,1,32,1,0,0,88,562,159,13,-1,,575,247,0.0
4,1,32,1,1,0,88,562,159,13,-1,,575,247,0.0
5,1,32,1,1,1,88,562,62,13,70,Employer's,575,150,0.0
5,1,32,1,1,2,156,563,27,9,95,state,572,183,0.0
5,1,32,1,1,3,189,562,10,10,85,ID,572,199,0.0
5,1,32,1,1,4,205,562,42,10,96,number,572,247,0.0
2,1,33,0,0,0,132,587,136,15,-1,,602,268,0.0
3,1,33,1,0,0,132,587,136,15,-1,,602,268,0.0
4,1,33,1,1,0,132,587,136,15,-1,,602,268,0.0
5,1,33,1,1,1,132,587,136,15,90,901-77-594,602,268,0.0
2,1,34,0,0,0,349,562,146,13,-1,,575,495,0.0
3,1,34,1,0,0,349,562,146,13,-1,,575,495,0.0
4,1,34,1,1,0,349,562,146,13,-1,,575,495,0.0
5,1,34,1,1,1,349,562,12,10,54,16,572,361,0.0
5,1,34,1,1,2,370,562,29,10,91,State,572,399,0.0
5,1,34,1,1,3,404,565,36,10,84,"wages,",575,440,0.0
5,1,34,1,1,4,449,563,20,12,93,"tips,",575,469,0.0
5,1,34,1,1,5,479,563,16,9,79,etc,572,495,0.0
2,1,35,0,0,0,347,587,108,15,-1,,602,455,0.0
3,1,35,1,0,0,347,587,108,15,-1,,602,455,0.0
4,1,35,1,1,0,347,587,108,15,-1,,602,455,0.0
5,1,35,1,1,1,347,587,108,15,91,36999.45,602,455,0.0
2,1,36,0,0,0,3,608,1109,3,-1,,611,1112,0.0
3,1,36,1,0,0,3,608,1109,3,-1,,611,1112,0.0
4,1,36,1,1,0,3,608,1109,3,-1,,611,1112,0.0
5,1,36,1,1,1,3,608,1109,3,95, ,611,1112,0.0
2,1,37,0,0,0,59,558,1,103,-1,,661,60,0.0
3,1,37,1,0,0,59,558,1,103,-1,,661,60,0.0
4,1,37,1,1,0,59,558,1,103,-1,,661,60,0.0
5,1,37,1,1,1,59,558,1,103,95, ,661,60,0.0
2,1,38,0,0,0,340,558,1,103,-1,,661,341,0.0
3,1,38,1,0,0,340,558,1,103,-1,,661,341,0.0
4,1,38,1,1,0,340,558,1,103,-1,,661,341,0.0
5,1,38,1,1,1,340,558,1,103,95, ,661,341,0.0
2,1,39,0,0,0,541,562,119,10,-1,,572,660,0.0
3,1,39,1,0,0,541,562,119,10,-1,,572,660,0.0
4,1,39,1,1,0,541,562,119,10,-1,,572,660,0.0
5,1,39,1,1,1,541,562,11,10,60,TT,572,552,0.0
5,1,39,1,1,2,562,562,29,10,94,State,572,591,0.0
5,1,39,1,1,3,597,565,40,7,90,income,572,637,0.0
5,1,39,1,1,4,642,563,18,9,96,tax,572,660,0.0
2,1,40,0,0,0,538,587,95,15,-1,,602,633,0.0
3,1,40,1,0,0,538,587,95,15,-1,,602,633,0.0
4,1,40,1,1,0,538,587,95,15,-1,,602,633,0.0
5,1,40,1,1,1,538,587,95,15,96,2903.07,602,633,0.0
2,1,41,0,0,0,532,558,1,103,-1,,661,533,0.0
3,1,41,1,0,0,532,558,1,103,-1,,661,533,0.0
4,1,41,1,1,0,532,558,1,103,-1,,661,533,0.0
5,1,41,1,1,1,532,558,1,103,95, ,661,533,0.0
2,1,42,0,0,0,930,562,119,10,-1,,572,1049,0.0
3,1,42,1,0,0,930,562,119,10,-1,,572,1049,0.0
4,1,42,1,1,0,930,562,119,10,-1,,572,1049,0.0
5,1,42,1,1,1,930,562,11,10,77,19,572,941,0.0
5,1,42,1,1,2,951,562,29,10,86,Local,572,980,0.0
5,1,42,1,1,3,986,565,40,7,89,income,572,1026,0.0
5,1,42,1,1,4,1031,563,18,9,96,tax,572,1049,0.0
2,1,43,0,0,0,928,587,109,15,-1,,602,1037,0.0
3,1,43,1,0,0,928,587,109,15,-1,,602,1037,0.0
4,1,43,1,1,0,928,587,109,15,-1,,602,1037,0.0
5,1,43,1,1,1,928,587,109,15,90,11815.19,602,1037,0.0
2,1,44,0,0,0,726,562,490,13,-1,,575,1216,0.0
3,1,44,1,0,0,726,562,490,13,-1,,575,1216,0.0
4,1,44,1,1,0,726,562,490,13,-1,,575,1216,0.0
5,1,44,1,1,1,726,562,12,10,70,78,572,738,0.0
5,1,44,1,1,2,748,562,29,10,94,Local,572,777,0.0
5,1,44,1,1,3,782,565,36,10,82,wages.,575,818,0.0
5,1,44,1,1,4,827,563,20,12,94,"tips,",575,847,0.0
5,1,44,1,1,5,857,563,16,9,79,ete,572,873,0.0
5,1,44,1,1,6,1114,562,13,10,82,20,572,1127,0.0
5,1,44,1,1,7,1137,562,44,13,90,Locality,575,1181,0.0
5,1,44,1,1,8,1186,565,30,7,96,name,572,1216,0.0
2,1,45,0,0,0,725,587,109,15,-1,,602,834,0.0
3,1,45,1,0,0,725,587,109,15,-1,,602,834,0.0
4,1,45,1,1,0,725,587,109,15,-1,,602,834,0.0
5,1,45,1,1,1,725,587,66,15,68,77272,602,791,0.0
5,1,45,1,1,2,798,587,36,15,49,.53,602,834,0.0
2,1,46,0,0,0,1112,593,117,9,-1,,602,1229,0.0
3,1,46,1,0,0,1112,593,117,9,-1,,602,1229,0.0
4,1,46,1,1,0,1112,593,117,9,-1,,602,1229,0.0
5,1,46,1,1,1,1112,593,64,9,96,Melissa,602,1176,0.0
5,1,46,1,1,2,1186,593,43,9,96,Shoal,602,1229,0.0
2,1,47,0,0,0,1233,1,3,660,-1,,661,1236,0.0
3,1,47,1,0,0,1233,1,3,660,-1,,661,1236,0.0
4,1,47,1,1,0,1233,1,3,660,-1,,661,1236,0.0
5,1,47,1,1,1,1233,1,3,660,95, ,661,1236,0.0
2,1,48,0,0,0,717,394,3,267,-1,,661,720,0.0
3,1,48,1,0,0,717,394,3,267,-1,,661,720,0.0
4,1,48,1,1,0,717,394,3,267,-1,,661,720,0.0
5,1,48,1,1,1,717,394,3,267,95, ,661,720,0.0
2,1,49,0,0,0,921,558,1,103,-1,,661,922,0.0
3,1,49,1,0,0,921,558,1,103,-1,,661,922,0.0
4,1,49,1,1,0,921,558,1,103,-1,,661,922,0.0
5,1,49,1,1,1,921,558,1,103,95, ,661,922,0.0
2,1,50,0,0,0,1107,558,1,103,-1,,661,1108,0.0
3,1,50,1,0,0,1107,558,1,103,-1,,661,1108,0.0
4,1,50,1,1,0,1107,558,1,103,-1,,661,1108,0.0
5,1,50,1,1,1,1107,558,1,103,95, ,661,1108,0.0
2,1,51,0,0,0,1,657,1235,7,-1,,664,1236,0.0
3,1,51,1,0,0,1,657,1235,7,-1,,664,1236,0.0
4,1,51,1,1,0,1,657,1235,7,-1,,664,1236,0.0
5,1,51,1,1,1,1,657,1235,7,95, ,664,1236,0.0
2,1,52,0,0,0,4,634,1227,94,-1,,728,1231,0.0
3,1,52,1,0,0,4,634,1227,86,-1,,720,1231,0.0
4,1,52,1,1,0,12,634,1218,28,-1,,662,1230,0.0
5,1,52,1,1,1,12,634,32,28,96,MN,662,44,0.0
5,1,52,1,1,2,132,638,137,15,91,661-57-909,653,269,0.0
5,1,52,1,1,3,347,638,109,15,90,37030.53,653,456,0.0
5,1,52,1,1,4,538,638,95,15,95,2672.65,653,633,0.0
5,1,52,1,1,5,725,638,95,15,81,63242.6,653,820,0.0
5,1,52,1,1,6,928,638,94,15,94,7283.25,653,1022,0.0
5,1,52,1,1,7,1113,644,54,9,96,Briana,653,1167,0.0
5,1,52,1,1,8,1177,645,53,8,96,Corner,653,1230,0.0
4,1,52,1,2,0,139,670,1092,22,-1,,692,1231,0.0
5,1,52,1,2,1,139,670,63,22,96,Wage,692,202,0.0
5,1,52,1,2,2,211,670,41,17,96,and,687,252,0.0
5,1,52,1,2,3,261,670,40,17,96,Tax,687,301,0.0
5,1,52,1,2,4,864,675,81,15,96,Department,690,945,0.0
5,1,52,1,2,5,950,675,12,12,96,of,687,962,0.0
5,1,52,1,2,6,966,675,20,12,93,the,687,986,0.0
5,1,52,1,2,7,991,675,118,15,35,TreasuryโInternal,690,1109,0.0
5,1,52,1,2,8,1115,675,59,12,96,Revenue,687,1174,0.0
5,1,52,1,2,9,1180,675,51,12,97,Service,687,1231,0.0
4,1,52,1,3,0,4,677,689,51,-1,,728,693,0.0
5,1,52,1,3,1,4,709,34,11,93,Form,720,38,0.0
5,1,52,1,3,2,47,709,25,11,91,W-2,720,72,0.0
5,1,52,1,3,3,140,697,114,31,96,Statement,728,254,0.0
5,1,52,1,3,4,549,677,27,42,21,c,719,576,0.0
5,1,52,1,3,5,588,677,27,42,50,0,719,615,0.0
5,1,52,1,3,6,628,677,26,42,59,1,719,654,0.0
5,1,52,1,3,7,666,677,27,42,52,0,719,693,0.0
2,1,53,0,0,0,4,732,482,37,-1,,769,486,0.0
3,1,53,1,0,0,4,732,482,37,-1,,769,486,0.0
4,1,53,1,1,0,5,732,462,15,-1,,747,467,0.0
5,1,53,1,1,1,5,732,40,15,93,Copy,747,45,0.0
5,1,53,1,1,2,51,732,43,12,91,B--To,744,94,0.0
5,1,53,1,1,3,100,732,19,12,96,Be,744,119,0.0
5,1,53,1,1,4,126,732,35,12,95,Filed,744,161,0.0
5,1,53,1,1,5,167,732,32,12,96,with,744,199,0.0
5,1,53,1,1,6,206,732,87,15,85,Employee's,747,293,0.0
5,1,53,1,1,7,300,732,76,12,96,FEDERAL,744,376,0.0
5,1,53,1,1,8,382,732,27,12,95,Tax,744,409,0.0
5,1,53,1,1,9,415,732,52,12,96,Return,744,467,0.0
4,1,53,1,2,0,4,754,482,15,-1,,769,486,0.0
5,1,53,1,2,1,4,754,29,12,96,This,766,33,0.0
5,1,53,1,2,2,40,754,79,12,93,information,766,119,0.0
5,1,53,1,2,3,126,757,10,9,93,is,766,136,0.0
5,1,53,1,2,4,143,754,38,15,94,being,769,181,0.0
5,1,53,1,2,5,187,754,67,12,96,furnished,766,254,0.0
5,1,53,1,2,6,260,754,12,12,96,to,766,272,0.0
5,1,53,1,2,7,278,754,22,12,96,the,766,300,0.0
5,1,53,1,2,8,307,754,52,12,93,Internal,766,359,0.0
5,1,53,1,2,9,365,754,62,12,95,Revenue,766,427,0.0
5,1,53,1,2,10,433,754,53,12,96,Service,766,486,0.0
2,1,54,0,0,0,469,825,294,14,-1,,839,763,0.0
3,1,54,1,0,0,469,825,294,14,-1,,839,763,0.0
4,1,54,1,1,0,469,825,294,14,-1,,839,763,0.0
5,1,54,1,1,1,469,825,55,11,51,Tuthere.,836,524,0.0
5,1,54,1,1,2,537,825,32,14,92,Keep,839,569,0.0
5,1,54,1,1,3,575,825,34,11,94,lower,836,609,0.0
5,1,54,1,1,4,614,826,42,13,96,portion,839,656,0.0
5,1,54,1,1,5,661,825,17,11,72,for,836,678,0.0
5,1,54,1,1,6,682,828,28,11,94,your,839,710,0.0
5,1,54,1,1,7,715,825,48,11,67,records,836,763,0.0
2,1,55,0,0,0,1,871,1235,7,-1,,878,1236,0.0
3,1,55,1,0,0,1,871,1235,7,-1,,878,1236,0.0
4,1,55,1,1,0,1,871,1235,7,-1,,878,1236,0.0
5,1,55,1,1,1,1,871,1235,7,95, ,878,1236,0.0
2,1,56,0,0,0,212,874,1,52,-1,,926,213,0.0
3,1,56,1,0,0,212,874,1,52,-1,,926,213,0.0
4,1,56,1,1,0,212,874,1,52,-1,,926,213,0.0
5,1,56,1,1,1,212,874,1,52,95, ,926,213,0.0
2,1,57,0,0,0,596,874,1,52,-1,,926,597,0.0
3,1,57,1,0,0,596,874,1,52,-1,,926,597,0.0
4,1,57,1,1,0,596,874,1,52,-1,,926,597,0.0
5,1,57,1,1,1,596,874,1,52,95, ,926,597,0.0
2,1,58,0,0,0,1,922,1235,7,-1,,929,1236,0.0
3,1,58,1,0,0,1,922,1235,7,-1,,929,1236,0.0
4,1,58,1,1,0,1,922,1235,7,-1,,929,1236,0.0
5,1,58,1,1,1,1,922,1235,7,95, ,929,1236,0.0
2,1,59,0,0,0,1,973,1235,7,-1,,980,1236,0.0
3,1,59,1,0,0,1,973,1235,7,-1,,980,1236,0.0
4,1,59,1,1,0,1,973,1235,7,-1,,980,1236,0.0
5,1,59,1,1,1,1,973,1235,7,95, ,980,1236,0.0
2,1,60,0,0,0,660,1025,576,5,-1,,1030,1236,0.0
3,1,60,1,0,0,660,1025,576,5,-1,,1030,1236,0.0
4,1,60,1,1,0,660,1025,576,5,-1,,1030,1236,0.0
5,1,60,1,1,1,660,1025,576,5,95, ,1030,1236,0.0
2,1,61,0,0,0,660,1076,576,5,-1,,1081,1236,0.0
3,1,61,1,0,0,660,1076,576,5,-1,,1081,1236,0.0
4,1,61,1,1,0,660,1076,576,5,-1,,1081,1236,0.0
5,1,61,1,1,1,660,1076,576,5,95, ,1081,1236,0.0
2,1,62,0,0,0,1,1126,1235,7,-1,,1133,1236,0.0
3,1,62,1,0,0,1,1126,1235,7,-1,,1133,1236,0.0
4,1,62,1,1,0,1,1126,1235,7,-1,,1133,1236,0.0
5,1,62,1,1,1,1,1126,1235,7,95, ,1133,1236,0.0
2,1,63,0,0,0,1,1177,1235,7,-1,,1184,1236,0.0
3,1,63,1,0,0,1,1177,1235,7,-1,,1184,1236,0.0
4,1,63,1,1,0,1,1177,1235,7,-1,,1184,1236,0.0
5,1,63,1,1,1,1,1177,1235,7,95, ,1184,1236,0.0
2,1,64,0,0,0,11,878,1217,553,-1,,1431,1228,0.0
3,1,64,1,0,0,11,878,1217,553,-1,,1431,1228,0.0
4,1,64,1,1,0,55,878,1137,16,-1,,894,1192,0.0
5,1,64,1,1,1,55,879,103,15,91,REISSUED,894,158,0.0
5,1,64,1,1,2,216,881,6,7,58,[a,888,222,0.0
5,1,64,1,1,3,236,878,71,13,31,Employee's,891,307,0.0
5,1,64,1,1,4,311,878,36,10,91,social,888,347,0.0
5,1,64,1,1,5,352,878,48,13,91,security,891,400,0.0
5,1,64,1,1,6,406,878,48,10,96,number,888,454,0.0
5,1,64,1,1,7,750,878,23,10,95,This,888,773,0.0
5,1,64,1,1,8,779,878,61,10,96,information,888,840,0.0
5,1,64,1,1,9,846,881,8,7,90,is,888,854,0.0
5,1,64,1,1,10,860,878,29,13,90,being,891,889,0.0
5,1,64,1,1,11,894,878,51,10,93,furnished,888,945,0.0
5,1,64,1,1,12,950,879,10,9,96,to,888,960,0.0
5,1,64,1,1,13,965,878,17,10,96,the,888,982,0.0
5,1,64,1,1,14,988,878,40,10,84,Internal,888,1028,0.0
5,1,64,1,1,15,1034,878,47,10,93,Revenue,888,1081,0.0
5,1,64,1,1,16,1087,878,40,10,74,Senice.,888,1127,0.0
5,1,64,1,1,17,1141,878,6,10,77,If,888,1147,0.0
5,1,64,1,1,18,1150,881,20,10,77,you,891,1170,0.0
5,1,64,1,1,19,1176,881,16,7,94,are,888,1192,0.0
4,1,64,1,2,0,751,895,477,13,-1,,908,1228,0.0
5,1,64,1,2,1,751,895,44,13,95,required,908,795,0.0
5,1,64,1,2,2,800,887,8,26,96,to,913,808,0.0
5,1,64,1,2,3,805,895,25,10,96,file,905,830,0.0
5,1,64,1,2,4,836,898,5,7,78,a,905,841,0.0
5,1,64,1,2,5,846,896,18,9,78,tax,905,864,0.0
5,1,64,1,2,6,869,896,35,10,65,"return,",906,904,0.0
5,1,64,1,2,7,910,898,5,7,95,a,905,915,0.0
5,1,64,1,2,8,921,895,60,13,96,negligence,908,981,0.0
5,1,64,1,2,9,987,895,41,13,96,penalty,908,1028,0.0
5,1,64,1,2,10,1033,898,10,7,95,or,905,1043,0.0
5,1,64,1,2,11,1048,895,28,10,96,other,905,1076,0.0
5,1,64,1,2,12,1081,896,47,9,96,sanction,905,1128,0.0
5,1,64,1,2,13,1134,898,24,10,97,may,908,1158,0.0
5,1,64,1,2,14,1163,895,12,10,96,be,905,1175,0.0
5,1,64,1,2,15,1181,895,47,13,88,imposed,908,1228,0.0
4,1,64,1,3,0,44,903,1018,22,-1,,925,1062,0.0
5,1,64,1,3,1,44,906,126,15,96,STATEMENT,921,170,0.0
5,1,64,1,3,2,311,903,151,15,84,280-96-5377,918,462,0.0
5,1,64,1,3,3,612,903,28,10,96,OMB,913,640,0.0
5,1,64,1,3,4,646,903,14,10,79,No.,913,660,0.0
5,1,64,1,3,5,671,903,57,10,80,1645-0008,913,728,0.0
5,1,64,1,3,6,751,915,12,7,50,on,922,763,0.0
5,1,64,1,3,7,776,915,12,7,38,you,922,788,0.0
5,1,64,1,3,8,794,912,6,10,38,if,922,800,0.0
5,1,64,1,3,9,803,912,20,10,79,this,922,823,0.0
5,1,64,1,3,10,829,915,40,7,55,income,922,869,0.0
5,1,64,1,3,11,875,915,8,7,92,is,922,883,0.0
5,1,64,1,3,12,888,912,41,10,92,taxable,922,929,0.0
5,1,64,1,3,13,935,912,19,10,96,and,922,954,0.0
5,1,64,1,3,14,967,915,12,7,75,you,922,979,0.0
5,1,64,1,3,15,984,912,15,10,75,fail,922,999,0.0
5,1,64,1,3,16,1004,913,10,9,86,to,922,1014,0.0
5,1,64,1,3,17,1020,913,31,12,52,report,925,1051,0.0
5,1,64,1,3,18,1057,913,5,9,52,it,922,1062,0.0
4,1,64,1,4,0,12,929,1143,13,-1,,942,1155,0.0
5,1,64,1,4,1,12,929,7,10,82,b,939,19,0.0
5,1,64,1,4,2,29,929,54,13,95,Employer,942,83,0.0
5,1,64,1,4,3,88,929,70,10,95,identification,939,158,0.0
5,1,64,1,4,4,164,929,42,10,96,number,939,206,0.0
5,1,64,1,4,5,681,929,4,10,63,1,939,685,0.0
5,1,64,1,4,6,704,929,40,13,82,"Wages,",942,744,0.0
5,1,64,1,4,7,753,930,20,12,95,"tips,",942,773,0.0
5,1,64,1,4,8,783,929,28,10,96,other,939,811,0.0
5,1,64,1,4,9,816,930,79,12,96,compensation,942,895,0.0
5,1,64,1,4,10,970,929,7,10,0,2,939,977,0.0
5,1,64,1,4,11,995,929,41,10,68,Federal,939,1036,0.0
5,1,64,1,4,12,1042,932,40,7,95,income,939,1082,0.0
5,1,64,1,4,13,1087,930,18,9,96,tax,939,1105,0.0
5,1,64,1,4,14,1109,929,46,10,96,withheld,939,1155,0.0
4,1,64,1,5,0,66,954,1028,15,-1,,969,1094,0.0
5,1,64,1,5,1,66,954,136,15,92,33-0179104,969,202,0.0
5,1,64,1,5,2,725,954,108,15,88,71292.15,969,833,0.0
5,1,64,1,5,3,985,954,109,15,84,22405.22,969,1094,0.0
4,1,64,1,6,0,13,980,1139,13,-1,,993,1152,0.0
5,1,64,1,6,1,13,983,6,7,46,ยข,990,19,0.0
5,1,64,1,6,2,29,980,62,13,95,Employers,993,91,0.0
5,1,64,1,6,3,97,983,30,7,93,"name,",990,127,0.0
5,1,64,1,6,4,137,980,44,10,92,"address,",990,181,0.0
5,1,64,1,6,5,191,980,19,10,94,and,990,210,0.0
5,1,64,1,6,6,215,980,18,10,95,ZIP,990,233,0.0
5,1,64,1,6,7,239,980,26,10,96,code,990,265,0.0
5,1,64,1,6,8,681,980,6,10,65,3,990,687,0.0
5,1,64,1,6,9,705,980,34,10,86,Social,990,739,0.0
5,1,64,1,6,10,745,972,45,25,94,security,997,790,0.0
5,1,64,1,6,11,797,983,33,10,96,wages,993,830,0.0
5,1,64,1,6,12,970,980,7,10,57,4,990,977,0.0
5,1,64,1,6,13,995,980,34,10,81,Social,990,1029,0.0
5,1,64,1,6,14,1035,980,117,13,96,security,993,1152,0.0
5,1,64,1,6,15,1084,972,18,25,96,tax,997,1102,0.0
5,1,64,1,6,16,1107,980,45,13,96,withheld,993,1152,0.0
4,1,64,1,7,0,65,1005,1015,19,-1,,1024,1080,0.0
5,1,64,1,7,1,65,1005,92,19,96,"Flores,",1024,157,0.0
5,1,64,1,7,2,177,1005,97,15,96,Hubbard,1020,274,0.0
5,1,64,1,7,3,289,1005,42,15,96,and,1020,331,0.0
5,1,64,1,7,4,345,1005,111,15,96,Franklin,1020,456,0.0
5,1,64,1,7,5,472,1006,39,14,96,Inc,1020,511,0.0
5,1,64,1,7,6,725,1005,109,15,90,59800.89,1020,834,0.0
5,1,64,1,7,7,985,1005,95,15,49,4574.77,1020,1080,0.0
4,1,64,1,8,0,66,1031,1053,28,-1,,1059,1119,0.0
5,1,64,1,8,1,66,1039,38,15,96,638,1054,104,0.0
5,1,64,1,8,2,121,1039,110,15,96,Jennifer,1054,231,0.0
5,1,64,1,8,3,248,1039,95,20,78,Springs,1059,343,0.0
5,1,64,1,8,4,681,1031,6,10,66,5,1041,687,0.0
5,1,64,1,8,5,705,1031,51,10,90,Medicare,1041,756,0.0
5,1,64,1,8,6,761,1034,36,10,96,wages,1044,797,0.0
5,1,64,1,8,7,803,1031,19,10,96,and,1041,822,0.0
5,1,64,1,8,8,827,1032,20,12,83,tips,1044,847,0.0
5,1,64,1,8,9,970,1031,6,10,75,6,1041,976,0.0
5,1,64,1,8,10,995,1031,51,10,66,Medicare,1041,1046,0.0
5,1,64,1,8,11,1051,1032,18,9,95,tax,1041,1069,0.0
5,1,64,1,8,12,1073,1031,46,10,95,withheld,1041,1119,0.0
4,1,64,1,9,0,725,1056,420,15,-1,,1071,1145,0.0
5,1,64,1,9,1,725,1056,109,15,91,65211.43,1071,834,0.0
5,1,64,1,9,2,1050,1056,95,15,95,1891.13,1071,1145,0.0
4,1,64,1,10,0,63,1069,1009,30,-1,,1099,1072,0.0
5,1,64,1,10,1,63,1069,141,30,91,Adamsmouth,1099,204,0.0
5,1,64,1,10,2,274,1074,29,14,94,OR,1088,303,0.0
5,1,64,1,10,3,360,1073,136,15,93,71848-7881,1088,496,0.0
5,1,64,1,10,4,681,1082,5,10,34,7,1092,686,0.0
5,1,64,1,10,5,705,1082,34,10,87,Social,1092,739,0.0
5,1,64,1,10,6,747,1070,41,29,94,security,1099,788,0.0
5,1,64,1,10,7,795,1083,19,12,96,tips,1095,814,0.0
5,1,64,1,10,8,971,1082,5,10,54,@,1092,976,0.0
5,1,64,1,10,9,994,1082,53,10,90,Allocated,1092,1047,0.0
5,1,64,1,10,10,1052,1083,20,12,70,tips,1095,1072,0.0
4,1,64,1,11,0,725,1107,434,15,-1,,1122,1159,0.0
5,1,64,1,11,1,725,1107,109,15,92,59800.89,1122,834,0.0
5,1,64,1,11,2,1050,1107,109,15,91,65211.43,1122,1159,0.0
4,1,64,1,12,0,11,1133,1122,13,-1,,1146,1133,0.0
5,1,64,1,12,1,11,1133,57,10,0,โControl,1143,68,0.0
5,1,64,1,12,2,74,1133,42,10,96,number,1143,116,0.0
5,1,64,1,12,3,680,1133,7,10,63,9,1143,687,0.0
5,1,64,1,12,4,704,1133,48,10,63,Advance,1143,752,0.0
5,1,64,1,12,5,758,1133,19,10,92,EIC,1143,777,0.0
5,1,64,1,12,6,783,1134,48,12,96,payment,1146,831,0.0
5,1,64,1,12,7,964,1133,13,10,76,40,1143,977,0.0
5,1,64,1,12,8,995,1133,60,13,74,Dependent,1146,1055,0.0
5,1,64,1,12,9,1061,1136,23,7,93,care,1143,1084,0.0
5,1,64,1,12,10,1090,1133,43,10,92,benefits,1143,1133,0.0
4,1,64,1,13,0,66,1158,1022,15,-1,,1173,1088,0.0
5,1,64,1,13,1,66,1158,94,15,96,4858295,1173,160,0.0
5,1,64,1,13,2,1049,1158,39,15,96,287,1173,1088,0.0
4,1,64,1,14,0,12,1184,1163,13,-1,,1197,1175,0.0
5,1,64,1,14,1,12,1187,6,7,39,@,1194,18,0.0
5,1,64,1,14,2,29,1184,65,13,73,Employee's,1197,94,0.0
5,1,64,1,14,3,99,1184,20,10,96,first,1194,119,0.0
5,1,64,1,14,4,125,1187,30,7,96,name,1194,155,0.0
5,1,64,1,14,5,161,1184,19,10,96,and,1194,180,0.0
5,1,64,1,14,6,186,1184,28,10,93,initial,1194,214,0.0
5,1,64,1,14,7,280,1184,23,10,96,Last,1194,303,0.0
5,1,64,1,14,8,309,1187,30,7,94,name,1194,339,0.0
5,1,64,1,14,9,674,1184,11,10,60,11,1194,685,0.0
5,1,64,1,14,10,705,1184,68,13,79,Nonqualified,1197,773,0.0
5,1,64,1,14,11,779,1184,29,13,76,plans,1197,808,0.0
5,1,64,1,14,12,966,1184,20,10,37,12a,1194,986,0.0
5,1,64,1,14,13,1009,1184,22,10,59,See,1194,1031,0.0
5,1,64,1,14,14,1037,1184,71,10,95,instructions,1194,1108,0.0
5,1,64,1,14,15,1112,1184,17,10,96,for,1194,1129,0.0
5,1,64,1,14,16,1134,1184,22,10,96,box,1194,1156,0.0
5,1,64,1,14,17,1162,1184,13,10,92,12,1194,1175,0.0
4,1,64,1,15,0,725,1215,377,15,-1,,1230,1102,0.0
5,1,64,1,15,1,725,1215,38,15,96,300,1230,763,0.0
5,1,64,1,15,2,1049,1215,53,15,96,4755,1230,1102,0.0
4,1,64,1,16,0,64,1229,923,23,-1,,1252,987,0.0
5,1,64,1,16,1,64,1229,95,17,96,Robert,1246,159,0.0
5,1,64,1,16,2,224,1230,95,16,96,Benson,1246,319,0.0
5,1,64,1,16,3,674,1241,13,10,54,13,1251,687,0.0
5,1,64,1,16,4,693,1242,43,10,0,Satay,1252,736,0.0
5,1,64,1,16,5,780,1242,50,8,7,Ratronent,1250,830,0.0
5,1,64,1,16,6,866,1242,53,10,0,โthvapary,1252,919,0.0
5,1,64,1,16,7,940,1225,15,36,24,),1261,955,0.0
5,1,64,1,16,8,966,1241,21,10,47,2b,1251,987,0.0
4,1,64,1,17,0,693,1257,213,10,-1,,1267,906,0.0
5,1,64,1,17,1,693,1257,44,10,56,empoyee,1267,737,0.0
5,1,64,1,17,2,780,1257,18,10,40,plan,1267,798,0.0
5,1,64,1,17,3,867,1257,18,8,96,sick,1265,885,0.0
5,1,64,1,17,4,889,1259,17,8,96,pay,1267,906,0.0
4,1,64,1,18,0,66,1269,1022,22,-1,,1291,1088,0.0
5,1,64,1,18,1,66,1269,76,17,96,84813,1286,142,0.0
5,1,64,1,18,2,160,1270,63,16,96,Eric,1286,223,0.0
5,1,64,1,18,3,240,1270,48,21,96,Way,1291,288,0.0
5,1,64,1,18,4,303,1270,59,21,95,Apt.,1291,362,0.0
5,1,64,1,18,5,386,1269,44,17,96,116,1286,430,0.0
5,1,64,1,18,6,873,1275,10,11,86,x,1286,883,0.0
5,1,64,1,18,7,1006,1272,13,14,87,H,1286,1019,0.0
5,1,64,1,18,8,1050,1271,38,15,79,|685,1286,1088,0.0
4,1,64,1,19,0,594,1300,392,13,-1,,1313,986,0.0
5,1,64,1,19,1,594,1308,2,4,3,โ,1312,596,0.0
5,1,64,1,19,2,674,1300,13,10,43,44,1310,687,0.0
5,1,64,1,19,3,705,1300,31,10,84,Other,1310,736,0.0
5,1,64,1,19,4,741,1301,23,12,87,(see,1313,764,0.0
5,1,64,1,19,5,770,1300,50,10,96,enclosed,1310,820,0.0
5,1,64,1,19,6,826,1300,35,10,96,Notice,1310,861,0.0
5,1,64,1,19,7,866,1301,10,9,96,to,1310,876,0.0
5,1,64,1,19,8,882,1300,61,13,96,Employee),1313,943,0.0
5,1,64,1,19,9,949,1292,9,25,47,|,1317,958,0.0
5,1,64,1,19,10,966,1300,20,10,38,12c,1310,986,0.0
4,1,64,1,20,0,64,1304,526,31,-1,,1335,590,0.0
5,1,64,1,20,1,64,1308,79,17,93,North,1325,143,0.0
5,1,64,1,20,2,159,1308,192,22,91,Amberborough,1330,351,0.0
5,1,64,1,20,3,427,1304,38,31,96,AR,1335,465,0.0
5,1,64,1,20,4,531,1308,59,17,96,9425,1325,590,0.0
4,1,64,1,21,0,1005,1331,83,15,-1,,1346,1088,0.0
5,1,64,1,21,1,1005,1332,13,14,80,E,1346,1018,0.0
5,1,64,1,21,2,1049,1331,39,15,57,|201,1346,1088,0.0
4,1,64,1,22,0,966,1357,20,10,-1,,1367,986,0.0
5,1,64,1,22,1,966,1357,20,10,88,12d,1367,986,0.0
4,1,64,1,23,0,1050,1388,38,15,-1,,1403,1088,0.0
5,1,64,1,23,1,1050,1388,38,15,96,595,1403,1088,0.0
4,1,64,1,24,0,11,1418,213,13,-1,,1431,224,0.0
5,1,64,1,24,1,11,1418,5,10,69,f,1428,16,0.0
5,1,64,1,24,2,29,1418,65,13,69,Employee's,1431,94,0.0
5,1,64,1,24,3,100,1418,44,10,93,address,1428,144,0.0
5,1,64,1,24,4,150,1418,19,10,96,and,1428,169,0.0
5,1,64,1,24,5,174,1418,18,10,92,ZIP,1428,192,0.0
5,1,64,1,24,6,197,1418,27,10,92,code,1428,224,0.0
2,1,65,0,0,0,660,1235,576,5,-1,,1240,1236,0.0
3,1,65,1,0,0,660,1235,576,5,-1,,1240,1236,0.0
4,1,65,1,1,0,660,1235,576,5,-1,,1240,1236,0.0
5,1,65,1,1,1,660,1235,576,5,95, ,1240,1236,0.0
2,1,66,0,0,0,689,1267,204,1,-1,,1268,893,0.0
3,1,66,1,0,0,689,1267,204,1,-1,,1268,893,0.0
4,1,66,1,1,0,689,1267,204,1,-1,,1268,893,0.0
5,1,66,1,1,1,689,1267,204,1,95, ,1268,893,0.0
2,1,67,0,0,0,689,1267,1,28,-1,,1295,690,0.0
3,1,67,1,0,0,689,1267,1,28,-1,,1295,690,0.0
4,1,67,1,1,0,689,1267,1,28,-1,,1295,690,0.0
5,1,67,1,1,1,689,1267,1,28,95, ,1295,690,0.0
2,1,68,0,0,0,718,1267,1,28,-1,,1295,719,0.0
3,1,68,1,0,0,718,1267,1,28,-1,,1295,719,0.0
4,1,68,1,1,0,718,1267,1,28,-1,,1295,719,0.0
5,1,68,1,1,1,718,1267,1,28,95, ,1295,719,0.0
2,1,69,0,0,0,776,1267,1,28,-1,,1295,777,0.0
3,1,69,1,0,0,776,1267,1,28,-1,,1295,777,0.0
4,1,69,1,1,0,776,1267,1,28,-1,,1295,777,0.0
5,1,69,1,1,1,776,1267,1,28,95, ,1295,777,0.0
2,1,70,0,0,0,805,1267,1,28,-1,,1295,806,0.0
3,1,70,1,0,0,805,1267,1,28,-1,,1295,806,0.0
4,1,70,1,1,0,805,1267,1,28,-1,,1295,806,0.0
5,1,70,1,1,1,805,1267,1,28,95, ,1295,806,0.0
2,1,71,0,0,0,863,1267,1,28,-1,,1295,864,0.0
3,1,71,1,0,0,863,1267,1,28,-1,,1295,864,0.0
4,1,71,1,1,0,863,1267,1,28,-1,,1295,864,0.0
5,1,71,1,1,1,863,1267,1,28,95, ,1295,864,0.0
2,1,72,0,0,0,892,1267,1,28,-1,,1295,893,0.0
3,1,72,1,0,0,892,1267,1,28,-1,,1295,893,0.0
4,1,72,1,1,0,892,1267,1,28,-1,,1295,893,0.0
5,1,72,1,1,1,892,1267,1,28,95, ,1295,893,0.0
2,1,73,0,0,0,660,1292,576,7,-1,,1299,1236,0.0
3,1,73,1,0,0,660,1292,576,7,-1,,1299,1236,0.0
4,1,73,1,1,0,660,1292,576,7,-1,,1299,1236,0.0
5,1,73,1,1,1,660,1292,576,7,95, ,1299,1236,0.0
2,1,74,0,0,0,659,925,3,507,-1,,1432,662,0.0
3,1,74,1,0,0,659,925,3,507,-1,,1432,662,0.0
4,1,74,1,1,0,659,925,3,507,-1,,1432,662,0.0
5,1,74,1,1,1,659,925,3,507,95, ,1432,662,0.0
2,1,75,0,0,0,689,1293,547,5,-1,,1298,1236,0.0
3,1,75,1,0,0,689,1293,547,5,-1,,1298,1236,0.0
4,1,75,1,1,0,689,1293,547,5,-1,,1298,1236,0.0
5,1,75,1,1,1,689,1293,547,5,95, ,1298,1236,0.0
2,1,76,0,0,0,689,1293,547,5,-1,,1298,1236,0.0
3,1,76,1,0,0,689,1293,547,5,-1,,1298,1236,0.0
4,1,76,1,1,0,689,1293,547,5,-1,,1298,1236,0.0
5,1,76,1,1,1,689,1293,547,5,95, ,1298,1236,0.0
2,1,77,0,0,0,689,1293,547,5,-1,,1298,1236,0.0
3,1,77,1,0,0,689,1293,547,5,-1,,1298,1236,0.0
4,1,77,1,1,0,689,1293,547,5,-1,,1298,1236,0.0
5,1,77,1,1,1,689,1293,547,5,95, ,1298,1236,0.0
2,1,78,0,0,0,950,1352,286,3,-1,,1355,1236,0.0
3,1,78,1,0,0,950,1352,286,3,-1,,1355,1236,0.0
4,1,78,1,1,0,950,1352,286,3,-1,,1355,1236,0.0
5,1,78,1,1,1,950,1352,286,3,95, ,1355,1236,0.0
2,1,79,0,0,0,1043,1197,1,214,-1,,1411,1044,0.0
3,1,79,1,0,0,1043,1197,1,214,-1,,1411,1044,0.0
4,1,79,1,1,0,1043,1197,1,214,-1,,1411,1044,0.0
5,1,79,1,1,1,1043,1197,1,214,95, ,1411,1044,0.0
2,1,80,0,0,0,950,1409,286,3,-1,,1412,1236,0.0
3,1,80,1,0,0,950,1409,286,3,-1,,1412,1236,0.0
4,1,80,1,1,0,950,1409,286,3,-1,,1412,1236,0.0
5,1,80,1,1,1,950,1409,286,3,95, ,1412,1236,0.0
2,1,81,0,0,0,949,925,3,507,-1,,1432,952,0.0
3,1,81,1,0,0,949,925,3,507,-1,,1432,952,0.0
4,1,81,1,1,0,949,925,3,507,-1,,1432,952,0.0
5,1,81,1,1,1,949,925,3,507,95, ,1432,952,0.0
2,1,82,0,0,0,1,1428,1235,7,-1,,1435,1236,0.0
3,1,82,1,0,0,1,1428,1235,7,-1,,1435,1236,0.0
4,1,82,1,1,0,1,1428,1235,7,-1,,1435,1236,0.0
5,1,82,1,1,1,1,1428,1235,7,95, ,1435,1236,0.0
2,1,83,0,0,0,6,1435,489,13,-1,,1448,495,0.0
3,1,83,1,0,0,6,1435,489,13,-1,,1448,495,0.0
4,1,83,1,1,0,6,1435,489,13,-1,,1448,495,0.0
5,1,83,1,1,1,6,1435,13,10,88,15,1445,19,0.0
5,1,83,1,1,2,29,1435,29,10,58,State!,1445,58,0.0
5,1,83,1,1,3,88,1435,62,13,54,Employer's,1448,150,0.0
5,1,83,1,1,4,156,1436,27,9,86,state,1445,183,0.0
5,1,83,1,1,5,189,1435,10,10,86,ID,1445,199,0.0
5,1,83,1,1,6,205,1435,42,10,95,number,1445,247,0.0
5,1,83,1,1,7,349,1435,11,10,53,16,1445,360,0.0
5,1,83,1,1,8,370,1435,29,10,93,State,1445,399,0.0
5,1,83,1,1,9,404,1438,36,10,90,"wages,",1448,440,0.0
5,1,83,1,1,10,449,1436,20,12,90,"tips,",1448,469,0.0
5,1,83,1,1,11,479,1436,16,9,77,etc,1445,495,0.0
2,1,84,0,0,0,0,1456,1236,31,-1,,1487,1236,0.0
3,1,84,1,0,0,0,1456,1236,31,-1,,1487,1236,0.0
4,1,84,1,1,0,0,1456,1236,31,-1,,1487,1236,0.0
5,1,84,1,1,1,0,1456,1236,31,95, ,1487,1236,0.0
2,1,85,0,0,0,58,1431,3,104,-1,,1535,61,0.0
3,1,85,1,0,0,58,1431,3,104,-1,,1535,61,0.0
4,1,85,1,1,0,58,1431,3,104,-1,,1535,61,0.0
5,1,85,1,1,1,58,1431,3,104,95, ,1535,61,0.0
2,1,86,0,0,0,339,1431,3,104,-1,,1535,342,0.0
3,1,86,1,0,0,339,1431,3,104,-1,,1535,342,0.0
4,1,86,1,1,0,339,1431,3,104,-1,,1535,342,0.0
5,1,86,1,1,1,339,1431,3,104,95, ,1535,342,0.0
2,1,87,0,0,0,0,1530,341,9,-1,,1539,341,0.0
3,1,87,1,0,0,0,1530,341,9,-1,,1539,341,0.0
4,1,87,1,1,0,0,1530,341,9,-1,,1539,341,0.0
5,1,87,1,1,1,0,1530,341,9,95, ,1539,341,0.0
2,1,88,0,0,0,541,1435,119,10,-1,,1445,660,0.0
3,1,88,1,0,0,541,1435,119,10,-1,,1445,660,0.0
4,1,88,1,1,0,541,1435,119,10,-1,,1445,660,0.0
5,1,88,1,1,1,541,1435,12,10,63,17,1445,553,0.0
5,1,88,1,1,2,562,1435,29,10,94,State,1445,591,0.0
5,1,88,1,1,3,597,1438,40,7,95,income,1445,637,0.0
5,1,88,1,1,4,642,1436,18,9,96,tax,1445,660,0.0
2,1,89,0,0,0,538,1512,95,15,-1,,1527,633,0.0
3,1,89,1,0,0,538,1512,95,15,-1,,1527,633,0.0
4,1,89,1,1,0,538,1512,95,15,-1,,1527,633,0.0
5,1,89,1,1,1,538,1512,95,15,95,2672.65,1527,633,0.0
2,1,90,0,0,0,531,1431,3,104,-1,,1535,534,0.0
3,1,90,1,0,0,531,1431,3,104,-1,,1535,534,0.0
4,1,90,1,1,0,531,1431,3,104,-1,,1535,534,0.0
5,1,90,1,1,1,531,1431,3,104,95, ,1535,534,0.0
2,1,91,0,0,0,727,1435,322,13,-1,,1448,1049,0.0
3,1,91,1,0,0,727,1435,322,13,-1,,1448,1049,0.0
4,1,91,1,1,0,727,1435,322,13,-1,,1448,1049,0.0
5,1,91,1,1,1,727,1435,11,10,69,78,1445,738,0.0
5,1,91,1,1,2,748,1435,29,10,94,Local,1445,777,0.0
5,1,91,1,1,3,782,1438,40,10,94,"wages,",1448,822,0.0
5,1,91,1,1,4,827,1436,20,12,94,"tips,",1448,847,0.0
5,1,91,1,1,5,857,1436,16,9,75,etc,1445,873,0.0
5,1,91,1,1,6,929,1435,12,10,76,79,1445,941,0.0
5,1,91,1,1,7,951,1435,29,10,85,Local,1445,980,0.0
5,1,91,1,1,8,986,1438,40,7,96,income,1445,1026,0.0
5,1,91,1,1,9,1031,1436,18,9,96,tax,1445,1049,0.0
2,1,92,0,0,0,1114,1435,102,13,-1,,1448,1216,0.0
3,1,92,1,0,0,1114,1435,102,13,-1,,1448,1216,0.0
4,1,92,1,1,0,1114,1435,102,13,-1,,1448,1216,0.0
5,1,92,1,1,1,1114,1435,13,10,85,20,1445,1127,0.0
5,1,92,1,1,2,1137,1435,44,13,89,Locality,1448,1181,0.0
5,1,92,1,1,3,1186,1438,30,7,96,name,1445,1216,0.0
2,1,93,0,0,0,725,1512,297,15,-1,,1527,1022,0.0
3,1,93,1,0,0,725,1512,297,15,-1,,1527,1022,0.0
4,1,93,1,1,0,725,1512,297,15,-1,,1527,1022,0.0
5,1,93,1,1,1,725,1512,95,15,87,63242.6,1527,820,0.0
5,1,93,1,1,2,928,1512,94,15,95,7283.25,1527,1022,0.0
2,1,94,0,0,0,1113,1518,117,9,-1,,1527,1230,0.0
3,1,94,1,0,0,1113,1518,117,9,-1,,1527,1230,0.0
4,1,94,1,1,0,1113,1518,117,9,-1,,1527,1230,0.0
5,1,94,1,1,1,1113,1518,54,9,96,Briana,1527,1167,0.0
5,1,94,1,1,2,1177,1519,53,8,96,Corner,1527,1230,0.0
2,1,95,0,0,0,1233,874,3,661,-1,,1535,1236,0.0
3,1,95,1,0,0,1233,874,3,661,-1,,1535,1236,0.0
4,1,95,1,1,0,1233,874,3,661,-1,,1535,1236,0.0
5,1,95,1,1,1,1233,874,3,661,95, ,1535,1236,0.0
2,1,96,0,0,0,717,1267,3,268,-1,,1535,720,0.0
3,1,96,1,0,0,717,1267,3,268,-1,,1535,720,0.0
4,1,96,1,1,0,717,1267,3,268,-1,,1535,720,0.0
5,1,96,1,1,1,717,1267,3,268,95, ,1535,720,0.0
2,1,97,0,0,0,920,1431,3,104,-1,,1535,923,0.0
3,1,97,1,0,0,920,1431,3,104,-1,,1535,923,0.0
4,1,97,1,1,0,920,1431,3,104,-1,,1535,923,0.0
5,1,97,1,1,1,920,1431,3,104,95, ,1535,923,0.0
2,1,98,0,0,0,1106,1431,3,104,-1,,1535,1109,0.0
3,1,98,1,0,0,1106,1431,3,104,-1,,1535,1109,0.0
4,1,98,1,1,0,1106,1431,3,104,-1,,1535,1109,0.0
5,1,98,1,1,1,1106,1431,3,104,95, ,1535,1109,0.0
2,1,99,0,0,0,338,1532,898,5,-1,,1537,1236,0.0
3,1,99,1,0,0,338,1532,898,5,-1,,1537,1236,0.0
4,1,99,1,1,0,338,1532,898,5,-1,,1537,1236,0.0
5,1,99,1,1,1,338,1532,898,5,95, ,1537,1236,0.0
2,1,100,0,0,0,4,1508,452,82,-1,,1590,456,0.0
3,1,100,1,0,0,4,1508,452,82,-1,,1590,456,0.0
4,1,100,1,1,0,12,1508,444,28,-1,,1536,456,0.0
5,1,100,1,1,1,12,1508,32,28,96,MN,1536,44,0.0
5,1,100,1,1,2,132,1512,137,15,91,661-57-909,1527,269,0.0
5,1,100,1,1,3,347,1512,109,15,90,37030.53,1527,456,0.0
4,1,100,1,2,0,139,1542,162,22,-1,,1564,301,0.0
5,1,100,1,2,1,139,1542,63,22,95,Wage,1564,202,0.0
5,1,100,1,2,2,211,1542,41,17,96,and,1559,252,0.0
5,1,100,1,2,3,261,1542,40,17,95,Tax,1559,301,0.0
4,1,100,1,3,0,4,1573,250,17,-1,,1590,254,0.0
5,1,100,1,3,1,4,1579,34,11,93,Form,1590,38,0.0
5,1,100,1,3,2,47,1579,25,11,89,W-2,1590,72,0.0
5,1,100,1,3,3,140,1573,114,17,96,Statement,1590,254,0.0
2,1,101,0,0,0,5,1602,291,37,-1,,1639,296,0.0
3,1,101,1,0,0,5,1602,291,37,-1,,1639,296,0.0
4,1,101,1,1,0,5,1602,291,15,-1,,1617,296,0.0
5,1,101,1,1,1,5,1602,40,15,93,Copy,1617,45,0.0
5,1,101,1,1,2,51,1602,10,12,91,C,1614,61,0.0
5,1,101,1,1,3,68,1602,26,12,96,For,1614,94,0.0
5,1,101,1,1,4,100,1602,103,12,86,EMPLOYEE'S,1614,203,0.0
5,1,101,1,1,5,210,1602,86,12,96,RECORDS.,1614,296,0.0
4,1,101,1,2,0,5,1624,276,15,-1,,1639,281,0.0
5,1,101,1,2,1,5,1624,33,15,95,(See,1639,38,0.0
5,1,101,1,2,2,44,1624,69,12,96,enclosed,1636,113,0.0
5,1,101,1,2,3,120,1624,49,12,96,Notice,1636,169,0.0
5,1,101,1,2,4,174,1624,16,12,96,to,1636,190,0.0
5,1,101,1,2,5,196,1624,85,15,95,Employee.),1639,281,0.0
2,1,102,0,0,0,549,1549,105,42,-1,,1591,654,0.0
3,1,102,1,0,0,549,1549,105,42,-1,,1591,654,0.0
4,1,102,1,1,0,549,1549,105,42,-1,,1591,654,0.0
5,1,102,1,1,1,549,1549,105,42,74,cOl,1591,654,0.0
2,1,103,0,0,0,864,1547,367,15,-1,,1562,1231,0.0
3,1,103,1,0,0,864,1547,367,15,-1,,1562,1231,0.0
4,1,103,1,1,0,864,1547,367,15,-1,,1562,1231,0.0
5,1,103,1,1,1,864,1547,81,15,95,Department,1562,945,0.0
5,1,103,1,1,2,950,1547,12,12,95,of,1559,962,0.0
5,1,103,1,1,3,966,1547,20,12,93,the,1559,986,0.0
5,1,103,1,1,4,991,1547,118,15,64,Treasury-Internal,1562,1109,0.0
5,1,103,1,1,5,1115,1547,59,12,94,Revenue,1559,1174,0.0
5,1,103,1,1,6,1180,1547,51,12,96,Service,1559,1231,0.0
2,1,104,0,0,0,666,1549,519,76,-1,,1625,1185,0.0
3,1,104,1,0,0,666,1549,519,76,-1,,1625,1185,0.0
4,1,104,1,1,0,666,1549,519,76,-1,,1625,1185,0.0
5,1,104,1,1,1,666,1549,27,42,64,0,1591,693,0.0
5,1,104,1,1,2,1044,1574,141,51,0,<2zT>,1625,1185,0.0
2,1,105,0,0,0,926,1575,110,33,-1,,1608,1036,0.0
3,1,105,1,0,0,926,1575,110,33,-1,,1608,1036,0.0
4,1,105,1,1,0,927,1575,109,15,-1,,1590,1036,0.0
5,1,105,1,1,1,927,1575,35,15,92,"Safe,",1590,962,0.0
5,1,105,1,1,2,967,1575,69,15,92,"accurate,",1590,1036,0.0
4,1,105,1,2,0,926,1596,82,12,-1,,1608,1008,0.0
5,1,105,1,2,1,926,1596,44,12,94,FAST!,1608,970,0.0
5,1,105,1,2,2,980,1596,28,12,94,Use,1608,1008,0.0
1,1,0,0,0,0,0,0,1236,1658,-1,,1658,1236,0.0
2,1,1,0,0,0,596,1,1,50,-1,,51,597,0.0
3,1,1,1,0,0,596,1,1,50,-1,,51,597,0.0
4,1,1,1,1,0,596,1,1,50,-1,,51,597,0.0
5,1,1,1,1,1,596,1,1,50,95, ,51,597,0.0
2,1,2,0,0,0,1,50,658,3,-1,,53,659,0.0
3,1,2,1,0,0,1,50,658,3,-1,,53,659,0.0
4,1,2,1,1,0,1,50,658,3,-1,,53,659,0.0
5,1,2,1,1,1,1,50,658,3,95, ,53,659,0.0
2,1,3,0,0,0,1,102,658,3,-1,,105,659,0.0
3,1,3,1,0,0,1,102,658,3,-1,,105,659,0.0
4,1,3,1,1,0,1,102,658,3,-1,,105,659,0.0
5,1,3,1,1,1,1,102,658,3,95, ,105,659,0.0
2,1,4,0,0,0,660,154,576,3,-1,,157,1236,0.0
3,1,4,1,0,0,660,154,576,3,-1,,157,1236,0.0
4,1,4,1,1,0,660,154,576,3,-1,,157,1236,0.0
5,1,4,1,1,1,660,154,576,3,95, ,157,1236,0.0
2,1,5,0,0,0,660,205,576,3,-1,,208,1236,0.0
3,1,5,1,0,0,660,205,576,3,-1,,208,1236,0.0
4,1,5,1,1,0,660,205,576,3,-1,,208,1236,0.0
5,1,5,1,1,1,660,205,576,3,95, ,208,1236,0.0
2,1,6,0,0,0,1,256,658,3,-1,,259,659,0.0
3,1,6,1,0,0,1,256,658,3,-1,,259,659,0.0
4,1,6,1,1,0,1,256,658,3,-1,,259,659,0.0
5,1,6,1,1,1,1,256,658,3,95, ,259,659,0.0
2,1,7,0,0,0,1,308,658,3,-1,,311,659,0.0
3,1,7,1,0,0,1,308,658,3,-1,,311,659,0.0
4,1,7,1,1,0,1,308,658,3,-1,,311,659,0.0
5,1,7,1,1,1,1,308,658,3,95, ,311,659,0.0
2,1,8,0,0,0,660,365,576,3,-1,,368,1236,0.0
3,1,8,1,0,0,660,365,576,3,-1,,368,1236,0.0
4,1,8,1,1,0,660,365,576,3,-1,,368,1236,0.0
5,1,8,1,1,1,660,365,576,3,95, ,368,1236,0.0
2,1,9,0,0,0,689,393,204,3,-1,,396,893,0.0
3,1,9,1,0,0,689,393,204,3,-1,,396,893,0.0
4,1,9,1,1,0,689,393,204,3,-1,,396,893,0.0
5,1,9,1,1,1,689,393,204,3,95, ,396,893,0.0
2,1,10,0,0,0,689,394,1,28,-1,,422,690,0.0
3,1,10,1,0,0,689,394,1,28,-1,,422,690,0.0
4,1,10,1,1,0,689,394,1,28,-1,,422,690,0.0
5,1,10,1,1,1,689,394,1,28,95, ,422,690,0.0
2,1,11,0,0,0,718,394,1,28,-1,,422,719,0.0
3,1,11,1,0,0,718,394,1,28,-1,,422,719,0.0
4,1,11,1,1,0,718,394,1,28,-1,,422,719,0.0
5,1,11,1,1,1,718,394,1,28,95, ,422,719,0.0
2,1,12,0,0,0,776,394,1,28,-1,,422,777,0.0
3,1,12,1,0,0,776,394,1,28,-1,,422,777,0.0
4,1,12,1,1,0,776,394,1,28,-1,,422,777,0.0
5,1,12,1,1,1,776,394,1,28,95, ,422,777,0.0
2,1,13,0,0,0,805,394,1,28,-1,,422,806,0.0
3,1,13,1,0,0,805,394,1,28,-1,,422,806,0.0
4,1,13,1,1,0,805,394,1,28,-1,,422,806,0.0
5,1,13,1,1,1,805,394,1,28,95, ,422,806,0.0
2,1,14,0,0,0,863,394,1,28,-1,,422,864,0.0
3,1,14,1,0,0,863,394,1,28,-1,,422,864,0.0
4,1,14,1,1,0,863,394,1,28,-1,,422,864,0.0
5,1,14,1,1,1,863,394,1,28,95, ,422,864,0.0
2,1,15,0,0,0,892,394,1,29,-1,,423,893,0.0
3,1,15,1,0,0,892,394,1,29,-1,,423,893,0.0
4,1,15,1,1,0,892,394,1,29,-1,,423,893,0.0
5,1,15,1,1,1,892,394,1,29,95, ,423,893,0.0
2,1,16,0,0,0,660,421,576,3,-1,,424,1236,0.0
3,1,16,1,0,0,660,421,576,3,-1,,424,1236,0.0
4,1,16,1,1,0,660,421,576,3,-1,,424,1236,0.0
5,1,16,1,1,1,660,421,576,3,95, ,424,1236,0.0
2,1,17,0,0,0,689,421,547,3,-1,,424,1236,0.0
3,1,17,1,0,0,689,421,547,3,-1,,424,1236,0.0
4,1,17,1,1,0,689,421,547,3,-1,,424,1236,0.0
5,1,17,1,1,1,689,421,547,3,95, ,424,1236,0.0
2,1,18,0,0,0,689,421,547,3,-1,,424,1236,0.0
3,1,18,1,0,0,689,421,547,3,-1,,424,1236,0.0
4,1,18,1,1,0,689,421,547,3,-1,,424,1236,0.0
5,1,18,1,1,1,689,421,547,3,95, ,424,1236,0.0
2,1,19,0,0,0,689,421,547,3,-1,,424,1236,0.0
3,1,19,1,0,0,689,421,547,3,-1,,424,1236,0.0
4,1,19,1,1,0,689,421,547,3,-1,,424,1236,0.0
5,1,19,1,1,1,689,421,547,3,95, ,424,1236,0.0
2,1,20,0,0,0,659,105,3,454,-1,,559,662,0.0
3,1,20,1,0,0,659,105,3,454,-1,,559,662,0.0
4,1,20,1,1,0,659,105,3,454,-1,,559,662,0.0
5,1,20,1,1,1,659,105,3,454,95, ,559,662,0.0
2,1,21,0,0,0,950,480,286,1,-1,,481,1236,0.0
3,1,21,1,0,0,950,480,286,1,-1,,481,1236,0.0
4,1,21,1,1,0,950,480,286,1,-1,,481,1236,0.0
5,1,21,1,1,1,950,480,286,1,95, ,481,1236,0.0
2,1,22,0,0,0,1043,326,1,212,-1,,538,1044,0.0
3,1,22,1,0,0,1043,326,1,212,-1,,538,1044,0.0
4,1,22,1,1,0,1043,326,1,212,-1,,538,1044,0.0
5,1,22,1,1,1,1043,326,1,212,95, ,538,1044,0.0
2,1,23,0,0,0,950,537,286,1,-1,,538,1236,0.0
3,1,23,1,0,0,950,537,286,1,-1,,538,1236,0.0
4,1,23,1,1,0,950,537,286,1,-1,,538,1236,0.0
5,1,23,1,1,1,950,537,286,1,95, ,538,1236,0.0
2,1,24,0,0,0,949,105,3,454,-1,,559,952,0.0
3,1,24,1,0,0,949,105,3,454,-1,,559,952,0.0
4,1,24,1,1,0,949,105,3,454,-1,,559,952,0.0
5,1,24,1,1,1,949,105,3,454,95, ,559,952,0.0
2,1,25,0,0,0,1,556,1235,5,-1,,561,1236,0.0
3,1,25,1,0,0,1,556,1235,5,-1,,561,1236,0.0
4,1,25,1,1,0,1,556,1235,5,-1,,561,1236,0.0
5,1,25,1,1,1,1,556,1235,5,95, ,561,1236,0.0
2,1,26,0,0,0,3,607,1110,5,-1,,612,1113,0.0
3,1,26,1,0,0,3,607,1110,5,-1,,612,1113,0.0
4,1,26,1,1,0,3,607,1110,5,-1,,612,1113,0.0
5,1,26,1,1,1,3,607,1110,5,95, ,612,1113,0.0
2,1,27,0,0,0,340,558,1,103,-1,,661,341,0.0
3,1,27,1,0,0,340,558,1,103,-1,,661,341,0.0
4,1,27,1,1,0,340,558,1,103,-1,,661,341,0.0
5,1,27,1,1,1,340,558,1,103,95, ,661,341,0.0
2,1,28,0,0,0,59,558,1,103,-1,,661,60,0.0
3,1,28,1,0,0,59,558,1,103,-1,,661,60,0.0
4,1,28,1,1,0,59,558,1,103,-1,,661,60,0.0
5,1,28,1,1,1,59,558,1,103,95, ,661,60,0.0
2,1,29,0,0,0,532,558,1,103,-1,,661,533,0.0
3,1,29,1,0,0,532,558,1,103,-1,,661,533,0.0
4,1,29,1,1,0,532,558,1,103,-1,,661,533,0.0
5,1,29,1,1,1,532,558,1,103,95, ,661,533,0.0
2,1,30,0,0,0,718,394,1,267,-1,,661,719,0.0
3,1,30,1,0,0,718,394,1,267,-1,,661,719,0.0
4,1,30,1,1,0,718,394,1,267,-1,,661,719,0.0
5,1,30,1,1,1,718,394,1,267,95, ,661,719,0.0
2,1,31,0,0,0,1234,1,2,660,-1,,661,1236,0.0
3,1,31,1,0,0,1234,1,2,660,-1,,661,1236,0.0
4,1,31,1,1,0,1234,1,2,660,-1,,661,1236,0.0
5,1,31,1,1,1,1234,1,2,660,95, ,661,1236,0.0
2,1,32,0,0,0,921,558,1,103,-1,,661,922,0.0
3,1,32,1,0,0,921,558,1,103,-1,,661,922,0.0
4,1,32,1,1,0,921,558,1,103,-1,,661,922,0.0
5,1,32,1,1,1,921,558,1,103,95, ,661,922,0.0
2,1,33,0,0,0,1107,558,1,103,-1,,661,1108,0.0
3,1,33,1,0,0,1107,558,1,103,-1,,661,1108,0.0
4,1,33,1,1,0,1107,558,1,103,-1,,661,1108,0.0
5,1,33,1,1,1,1107,558,1,103,95, ,661,1108,0.0
2,1,34,0,0,0,1,658,1235,5,-1,,663,1236,0.0
3,1,34,1,0,0,1,658,1235,5,-1,,663,1236,0.0
4,1,34,1,1,0,1,658,1235,5,-1,,663,1236,0.0
5,1,34,1,1,1,1,658,1235,5,95, ,663,1236,0.0
2,1,35,0,0,0,4,3,1230,717,-1,,720,1234,0.0
3,1,35,1,0,0,4,3,1230,717,-1,,720,1234,0.0
4,1,35,1,1,0,55,3,1138,17,-1,,20,1193,0.0
5,1,35,1,1,1,55,5,103,15,91,REISSUED,20,158,0.0
5,1,35,1,1,2,216,7,6,7,25,{a,14,222,0.0
5,1,35,1,1,3,236,0,70,24,69,Employee's,24,306,0.0
5,1,35,1,1,4,312,4,35,10,96,social,14,347,0.0
5,1,35,1,1,5,352,4,48,13,95,security,17,400,0.0
5,1,35,1,1,6,406,4,48,10,95,number,14,454,0.0
5,1,35,1,1,7,782,3,35,14,96,"Safe,",17,817,0.0
5,1,35,1,1,8,822,3,71,14,96,"Accurate,",17,893,0.0
5,1,35,1,1,9,1043,0,35,26,95,Visit,26,1078,0.0
5,1,35,1,1,10,1084,4,18,12,95,the,16,1102,0.0
5,1,35,1,1,11,1108,4,23,12,96,IRS,16,1131,0.0
5,1,35,1,1,12,1136,4,57,12,96,Website,16,1193,0.0
4,1,35,1,2,0,44,6,1136,45,-1,,51,1180,0.0
5,1,35,1,2,1,44,19,126,32,96,STATEMENT,51,170,0.0
5,1,35,1,2,2,312,28,151,15,91,133-45-6693,43,463,0.0
5,1,35,1,2,3,612,29,28,10,93,OMB,39,640,0.0
5,1,35,1,2,4,646,29,14,10,96,No.,39,660,0.0
5,1,35,1,2,5,671,29,57,10,87,1545-0008,39,728,0.0
5,1,35,1,2,6,781,28,44,12,95,FAST!,40,825,0.0
5,1,35,1,2,7,835,28,28,12,96,Use,40,863,0.0
5,1,35,1,2,8,900,6,120,45,0,e-file,51,1020,0.0
5,1,35,1,2,9,1031,6,12,45,0,),51,1043,0.0
5,1,35,1,2,10,1048,30,12,11,96,at,41,1060,0.0
5,1,35,1,2,11,1068,22,25,29,88,www,51,1093,0.0
5,1,35,1,2,12,1102,29,78,15,58,irs.goviefile.,44,1180,0.0
4,1,35,1,3,0,12,56,1143,13,-1,,69,1155,0.0
5,1,35,1,3,1,12,56,7,10,79,b,66,19,0.0
5,1,35,1,3,2,29,56,54,13,90,Employer,69,83,0.0
5,1,35,1,3,3,88,56,70,10,95,identification,66,158,0.0
5,1,35,1,3,4,164,56,42,10,96,number,66,206,0.0
5,1,35,1,3,5,681,56,4,10,70,1,66,685,0.0
5,1,35,1,3,6,704,56,40,13,79,"Wages,",69,744,0.0
5,1,35,1,3,7,753,57,24,12,95,"tips,",69,777,0.0
5,1,35,1,3,8,783,56,28,10,96,other,66,811,0.0
5,1,35,1,3,9,819,48,76,26,96,compensation,74,895,0.0
5,1,35,1,3,10,970,56,7,10,31,2,66,977,0.0
5,1,35,1,3,11,995,56,41,10,83,Federal,66,1036,0.0
5,1,35,1,3,12,1042,59,40,7,96,income,66,1082,0.0
5,1,35,1,3,13,1087,57,16,9,96,tax,66,1103,0.0
5,1,35,1,3,14,1109,56,46,10,96,withheld,66,1155,0.0
4,1,35,1,4,0,66,80,1028,15,-1,,95,1094,0.0
5,1,35,1,4,1,66,80,136,15,92,65-8736227,95,202,0.0
5,1,35,1,4,2,725,80,122,15,91,165296.64,95,847,0.0
5,1,35,1,4,3,985,80,109,15,88,49693.12,95,1094,0.0
4,1,35,1,5,0,13,108,1139,13,-1,,121,1152,0.0
5,1,35,1,5,1,13,111,6,7,48,ยข,118,19,0.0
5,1,35,1,5,2,29,108,62,13,94,Employers,121,91,0.0
5,1,35,1,5,3,97,111,30,7,87,"name,",118,127,0.0
5,1,35,1,5,4,137,108,44,10,90,"address,",118,181,0.0
5,1,35,1,5,5,191,108,19,10,96,and,118,210,0.0
5,1,35,1,5,6,215,108,18,10,96,ZIP,118,233,0.0
5,1,35,1,5,7,239,108,26,10,96,code,118,265,0.0
5,1,35,1,5,8,681,108,6,10,69,3,118,687,0.0
5,1,35,1,5,9,705,108,34,10,89,Social,118,739,0.0
5,1,35,1,5,10,747,100,43,25,93,security,125,790,0.0
5,1,35,1,5,11,797,111,33,10,96,wages,121,830,0.0
5,1,35,1,5,12,970,108,7,10,66,4,118,977,0.0
5,1,35,1,5,13,995,108,34,10,71,Social,118,1029,0.0
5,1,35,1,5,14,1035,108,117,13,96,security,121,1152,0.0
5,1,35,1,5,15,1084,100,18,25,96,tax,125,1102,0.0
5,1,35,1,5,16,1107,108,45,13,96,withheld,121,1152,0.0
4,1,35,1,6,0,65,133,1029,20,-1,,153,1094,0.0
5,1,35,1,6,1,65,134,92,19,95,"Cooper,",153,157,0.0
5,1,35,1,6,2,178,134,81,19,96,Spence,153,259,0.0
5,1,35,1,6,3,275,133,41,15,96,and,148,316,0.0
5,1,35,1,6,4,331,134,69,19,96,Curry,153,400,0.0
5,1,35,1,6,5,415,133,41,15,96,Ltd,148,456,0.0
5,1,35,1,6,6,725,133,122,15,89,198300.45,148,847,0.0
5,1,35,1,6,7,986,133,108,15,90,15169.98,148,1094,0.0
4,1,35,1,7,0,66,159,1053,28,-1,,187,1119,0.0
5,1,35,1,7,1,66,167,38,15,96,871,182,104,0.0
5,1,35,1,7,2,121,168,69,19,96,Tonya,187,190,0.0
5,1,35,1,7,3,205,168,111,19,96,Causeway,187,316,0.0
5,1,35,1,7,4,681,159,6,10,71,5,169,687,0.0
5,1,35,1,7,5,705,159,51,10,78,Medicare,169,756,0.0
5,1,35,1,7,6,761,162,36,10,96,wages,172,797,0.0
5,1,35,1,7,7,803,159,19,10,89,and,169,822,0.0
5,1,35,1,7,8,827,160,20,12,89,tips,172,847,0.0
5,1,35,1,7,9,970,159,6,10,64,6,169,976,0.0
5,1,35,1,7,10,995,159,51,10,74,Medicare,169,1046,0.0
5,1,35,1,7,11,1051,160,18,9,96,tax,169,1069,0.0
5,1,35,1,7,12,1073,159,46,10,96,withheld,169,1119,0.0
4,1,35,1,8,0,725,184,419,15,-1,,199,1144,0.0
5,1,35,1,8,1,725,184,122,15,92,164615.68,199,847,0.0
5,1,35,1,8,2,1050,184,94,15,81,4773.85,199,1144,0.0
4,1,35,1,9,0,64,198,1008,32,-1,,230,1072,0.0
5,1,35,1,9,1,64,202,42,14,93,New,216,106,0.0
5,1,35,1,9,2,120,201,168,20,92,Davidborough,221,288,0.0
5,1,35,1,9,3,353,198,32,32,96,AL,230,385,0.0
5,1,35,1,9,4,458,201,137,15,94,63538-3453,216,595,0.0
5,1,35,1,9,5,681,210,5,10,76,7,220,686,0.0
5,1,35,1,9,6,705,210,34,10,76,Social,220,739,0.0
5,1,35,1,9,7,746,211,42,12,44,security,223,788,0.0
5,1,35,1,9,8,795,211,19,12,85,tps,223,814,0.0
5,1,35,1,9,9,970,210,6,10,24,8,220,976,0.0
5,1,35,1,9,10,994,210,53,10,54,Allocated,220,1047,0.0
5,1,35,1,9,11,1052,211,20,12,82,tips,223,1072,0.0
4,1,35,1,10,0,725,235,446,15,-1,,250,1171,0.0
5,1,35,1,10,1,725,235,122,15,90,198300.45,250,847,0.0
5,1,35,1,10,2,1050,235,121,15,90,164615.68,250,1171,0.0
4,1,35,1,11,0,11,262,1122,13,-1,,275,1133,0.0
5,1,35,1,11,1,11,262,7,10,0,โd-,272,18,0.0
5,1,35,1,11,2,29,262,39,10,93,Control,272,68,0.0
5,1,35,1,11,3,74,262,42,10,96,number,272,116,0.0
5,1,35,1,11,4,680,262,7,10,70,9,272,687,0.0
5,1,35,1,11,5,704,262,48,10,75,Advance,272,752,0.0
5,1,35,1,11,6,758,262,19,10,90,EIC,272,777,0.0
5,1,35,1,11,7,783,263,48,12,96,payment,275,831,0.0
5,1,35,1,11,8,964,262,13,10,81,10,272,977,0.0
5,1,35,1,11,9,995,262,60,13,78,Dependent,275,1055,0.0
5,1,35,1,11,10,1061,265,23,7,96,care,272,1084,0.0
5,1,35,1,11,11,1090,262,43,10,93,benefits,272,1133,0.0
4,1,35,1,12,0,12,313,1163,13,-1,,326,1175,0.0
5,1,35,1,12,1,29,313,65,13,81,Employee's,326,94,0.0
5,1,35,1,12,2,99,313,20,10,94,first,323,119,0.0
5,1,35,1,12,3,125,316,30,7,94,name,323,155,0.0
5,1,35,1,12,4,161,313,19,10,96,and,323,180,0.0
5,1,35,1,12,5,186,313,28,10,95,initial,323,214,0.0
5,1,35,1,12,6,280,313,23,10,95,Last,323,303,0.0
5,1,35,1,12,7,309,316,30,7,94,name,323,339,0.0
5,1,35,1,12,8,674,313,11,10,56,71,323,685,0.0
5,1,35,1,12,9,705,313,68,13,69,Nonqualified,326,773,0.0
5,1,35,1,12,10,779,313,29,13,65,"plans,",326,808,0.0
5,1,35,1,12,11,966,313,20,10,36,12a,323,986,0.0
5,1,35,1,12,12,1009,313,22,10,64,See,323,1031,0.0
5,1,35,1,12,13,1037,313,92,10,95,instructions,323,1129,0.0
5,1,35,1,12,14,1112,305,19,25,96,for,330,1131,0.0
5,1,35,1,12,15,1134,313,22,10,96,box,323,1156,0.0
5,1,35,1,12,16,1162,313,13,10,91,12,323,1175,0.0
4,1,35,1,13,0,86,344,1016,17,-1,,361,1102,0.0
5,1,35,1,13,1,86,358,3,3,0,z,361,89,0.0
5,1,35,1,13,2,725,344,38,15,95,148,359,763,0.0
5,1,35,1,13,3,1006,345,13,14,80,P,359,1019,0.0
5,1,35,1,13,4,1050,344,52,15,80,|6940,359,1102,0.0
4,1,35,1,14,0,63,358,924,23,-1,,381,987,0.0
5,1,35,1,14,1,63,358,128,17,96,Michelle,375,191,0.0
5,1,35,1,14,2,272,359,79,16,96,Brown,375,351,0.0
5,1,35,1,14,3,674,370,13,10,57,1B,380,687,0.0
5,1,35,1,14,4,693,371,43,10,50,Slatutory,381,736,0.0
5,1,35,1,14,5,780,371,50,8,2,___Retrement.,379,830,0.0
5,1,35,1,14,6,866,371,53,10,0,___Thre-parky,381,919,0.0
5,1,35,1,14,7,966,370,21,10,58,1,380,987,0.0
4,1,35,1,15,0,693,385,213,9,-1,,394,906,0.0
5,1,35,1,15,1,693,385,44,9,18,empeyee,394,737,0.0
5,1,35,1,15,2,780,385,18,9,46,plan,394,798,0.0
5,1,35,1,15,3,867,385,18,8,85,sick,393,885,0.0
5,1,35,1,15,4,895,387,11,7,85,pay,394,906,0.0
4,1,35,1,16,0,66,396,1022,17,-1,,413,1088,0.0
5,1,35,1,16,1,66,396,44,17,96,730,413,110,1.0
5,1,35,1,16,2,129,396,78,17,96,Huber,413,207,1.0
5,1,35,1,16,3,226,396,94,17,96,Island,413,320,1.0
5,1,35,1,16,4,338,396,77,17,96,Suite,413,415,1.0
5,1,35,1,16,5,434,396,44,17,96,344,413,478,1.0
5,1,35,1,16,6,786,402,10,11,94,x,413,796,0.0
5,1,35,1,16,7,1005,399,13,14,90,D,413,1018,0.0
5,1,35,1,16,8,1049,398,39,15,30,|495,413,1088,0.0
4,1,35,1,17,0,65,427,921,25,-1,,452,986,0.0
5,1,35,1,17,1,65,435,190,17,89,Collinshaven,452,255,1.0
5,1,35,1,17,2,338,436,30,16,91,IN,452,368,1.0
5,1,35,1,17,3,433,435,157,17,95,29316-8972,452,590,0.0
5,1,35,1,17,4,674,427,13,10,49,44,437,687,0.0
5,1,35,1,17,5,705,427,31,10,81,Other,437,736,0.0
5,1,35,1,17,6,741,427,23,13,86,(see,440,764,0.0
5,1,35,1,17,7,770,427,50,10,96,enclosed,437,820,0.0
5,1,35,1,17,8,826,427,35,10,96,Notice,437,861,0.0
5,1,35,1,17,9,866,428,10,9,96,to,437,876,0.0
5,1,35,1,17,10,882,427,61,13,94,Employee),440,943,0.0
5,1,35,1,17,11,949,419,11,25,46,|,444,960,0.0
5,1,35,1,17,12,966,427,20,10,38,12c,437,986,0.0
4,1,35,1,18,0,1005,458,83,15,-1,,473,1088,0.0
5,1,35,1,18,1,1005,459,13,14,75,D,473,1018,0.0
5,1,35,1,18,2,1050,458,38,15,66,(625,473,1088,0.0
4,1,35,1,19,0,966,484,20,10,-1,,494,986,0.0
5,1,35,1,19,1,966,484,20,10,88,12d,494,986,0.0
4,1,35,1,20,0,1050,515,38,15,-1,,530,1088,0.0
5,1,35,1,20,1,1050,515,38,15,94,954,530,1088,0.0
4,1,35,1,21,0,11,545,213,13,-1,,558,224,0.0
5,1,35,1,21,1,11,545,5,10,91,f,555,16,0.0
5,1,35,1,21,2,29,545,65,13,53,Employee's,558,94,0.0
5,1,35,1,21,3,100,545,44,10,91,address,555,144,0.0
5,1,35,1,21,4,150,545,19,10,96,and,555,169,0.0
5,1,35,1,21,5,174,545,18,10,94,ZIP,555,192,0.0
5,1,35,1,21,6,197,545,27,10,96,code,555,224,0.0
4,1,35,1,22,0,6,562,1210,13,-1,,575,1216,0.0
5,1,35,1,22,1,6,562,13,10,74,15,572,19,0.0
5,1,35,1,22,2,29,562,29,10,25,State!,572,58,0.0
5,1,35,1,22,3,88,562,62,13,18,Employer's,575,150,0.0
5,1,35,1,22,4,156,563,27,9,96,state,572,183,0.0
5,1,35,1,22,5,189,562,10,10,95,ID,572,199,0.0
5,1,35,1,22,6,205,562,42,10,96,number,572,247,0.0
5,1,35,1,22,7,349,562,12,10,88,16,572,361,0.0
5,1,35,1,22,8,370,562,29,10,96,State,572,399,0.0
5,1,35,1,22,9,404,565,36,10,79,wages.,575,440,0.0
5,1,35,1,22,10,449,563,20,12,96,"tips,",575,469,0.0
5,1,35,1,22,11,479,563,16,9,86,etc.,572,495,0.0
5,1,35,1,22,12,541,562,11,10,88,17,572,552,0.0
5,1,35,1,22,13,562,562,29,10,91,State,572,591,0.0
5,1,35,1,22,14,597,565,40,7,96,income,572,637,0.0
5,1,35,1,22,15,642,563,18,9,92,tax,572,660,0.0
5,1,35,1,22,16,726,562,12,10,77,48,572,738,0.0
5,1,35,1,22,17,748,562,29,10,91,Local,572,777,0.0
5,1,35,1,22,18,782,565,36,10,96,wages.,575,818,0.0
5,1,35,1,22,19,827,563,20,12,93,"tips,",575,847,0.0
5,1,35,1,22,20,857,563,16,9,94,etc.,572,873,0.0
5,1,35,1,22,21,930,562,11,10,80,19,572,941,0.0
5,1,35,1,22,22,951,562,29,10,93,Local,572,980,0.0
5,1,35,1,22,23,986,565,40,7,96,income,572,1026,0.0
5,1,35,1,22,24,1031,563,18,9,96,tax,572,1049,0.0
5,1,35,1,22,25,1114,562,13,10,87,20,572,1127,0.0
5,1,35,1,22,26,1137,562,44,13,91,Locality,575,1181,0.0
5,1,35,1,22,27,1186,565,30,7,96,name,572,1216,0.0
4,1,35,1,23,0,16,587,1218,23,-1,,610,1234,0.0
5,1,35,1,23,1,16,588,29,14,94,OR,602,45,0.0
5,1,35,1,23,2,132,587,136,15,89,678-39-524,602,268,0.0
5,1,35,1,23,3,347,587,108,15,91,89521.54,602,455,0.0
5,1,35,1,23,4,538,587,95,15,96,4885.71,602,633,0.0
5,1,35,1,23,5,725,587,123,15,90,184434.59,602,848,0.0
5,1,35,1,23,6,927,587,109,15,90,29698.57,602,1036,0.0
5,1,35,1,23,7,1113,594,54,11,94,Nguyen,605,1167,0.0
5,1,35,1,23,8,1177,594,57,16,68,Square,610,1234,0.0
5,1,35,1,23,9,1227,583,9,31,68,|,614,1236,0.0
4,1,35,1,24,0,16,638,1213,18,-1,,656,1229,0.0
5,1,35,1,24,1,16,639,26,14,95,RI,653,42,0.0
5,1,35,1,24,2,131,638,138,15,89,229-34-366,653,269,0.0
5,1,35,1,24,3,347,638,108,15,92,80550.75,653,455,0.0
5,1,35,1,24,4,539,638,94,15,95,3668.12,653,633,0.0
5,1,35,1,24,5,725,638,122,15,91,117149.08,653,847,0.0
5,1,35,1,24,6,928,638,108,15,88,32563.47,653,1036,0.0
5,1,35,1,24,7,1113,644,45,12,95,Bobby,656,1158,0.0
5,1,35,1,24,8,1169,644,60,9,95,Islands,653,1229,0.0
4,1,35,1,25,0,139,670,1092,22,-1,,692,1231,0.0
5,1,35,1,25,1,139,670,63,22,96,Wage,692,202,0.0
5,1,35,1,25,2,211,670,41,17,96,and,687,252,0.0
5,1,35,1,25,3,261,670,40,17,96,Tax,687,301,0.0
5,1,35,1,25,4,864,675,81,15,96,Department,690,945,0.0
5,1,35,1,25,5,950,675,12,12,96,of,687,962,0.0
5,1,35,1,25,6,966,675,20,12,93,the,687,986,0.0
5,1,35,1,25,7,991,675,118,15,35,TreasuryโInternal,690,1109,0.0
5,1,35,1,25,8,1115,675,59,12,96,Revenue,687,1174,0.0
5,1,35,1,25,9,1180,675,51,12,97,Service,687,1231,0.0
4,1,35,1,26,0,4,677,689,43,-1,,720,693,0.0
5,1,35,1,26,1,4,709,34,11,93,Form,720,38,0.0
5,1,35,1,26,2,47,709,25,11,91,W-2,720,72,0.0
5,1,35,1,26,3,140,701,114,17,96,Statement,718,254,0.0
5,1,35,1,26,4,549,677,27,42,21,c,719,576,0.0
5,1,35,1,26,5,588,677,27,42,50,0,719,615,0.0
5,1,35,1,26,6,628,677,26,42,59,1,719,654,0.0
5,1,35,1,26,7,666,677,27,42,52,0,719,693,0.0
2,1,36,0,0,0,4,732,482,37,-1,,769,486,0.0
3,1,36,1,0,0,4,732,482,37,-1,,769,486,0.0
4,1,36,1,1,0,5,732,462,15,-1,,747,467,0.0
5,1,36,1,1,1,5,732,40,15,93,Copy,747,45,0.0
5,1,36,1,1,2,51,732,43,12,91,B--To,744,94,0.0
5,1,36,1,1,3,100,732,19,12,96,Be,744,119,0.0
5,1,36,1,1,4,126,732,35,12,95,Filed,744,161,0.0
5,1,36,1,1,5,167,732,32,12,96,with,744,199,0.0
5,1,36,1,1,6,206,732,87,15,85,Employee's,747,293,0.0
5,1,36,1,1,7,300,732,76,12,96,FEDERAL,744,376,0.0
5,1,36,1,1,8,382,732,27,12,95,Tax,744,409,0.0
5,1,36,1,1,9,415,732,52,12,96,Return,744,467,0.0
4,1,36,1,2,0,4,754,482,15,-1,,769,486,0.0
5,1,36,1,2,1,4,754,29,12,96,This,766,33,0.0
5,1,36,1,2,2,40,754,79,12,93,information,766,119,0.0
5,1,36,1,2,3,126,757,10,9,93,is,766,136,0.0
5,1,36,1,2,4,143,754,38,15,94,being,769,181,0.0
5,1,36,1,2,5,187,754,67,12,96,furnished,766,254,0.0
5,1,36,1,2,6,260,754,12,12,96,to,766,272,0.0
5,1,36,1,2,7,278,754,22,12,96,the,766,300,0.0
5,1,36,1,2,8,307,754,52,12,93,Internal,766,359,0.0
5,1,36,1,2,9,365,754,62,12,95,Revenue,766,427,0.0
5,1,36,1,2,10,433,754,53,12,96,Service,766,486,0.0
2,1,37,0,0,0,469,825,294,14,-1,,839,763,0.0
3,1,37,1,0,0,469,825,294,14,-1,,839,763,0.0
4,1,37,1,1,0,469,825,294,14,-1,,839,763,0.0
5,1,37,1,1,1,469,825,55,11,51,Tuthere.,836,524,0.0
5,1,37,1,1,2,537,825,32,14,92,Keep,839,569,0.0
5,1,37,1,1,3,575,825,34,11,94,lower,836,609,0.0
5,1,37,1,1,4,614,826,42,13,96,portion,839,656,0.0
5,1,37,1,1,5,661,825,17,11,72,for,836,678,0.0
5,1,37,1,1,6,682,828,28,11,94,your,839,710,0.0
5,1,37,1,1,7,715,825,48,11,67,records,836,763,0.0
2,1,38,0,0,0,1,872,1235,5,-1,,877,1236,0.0
3,1,38,1,0,0,1,872,1235,5,-1,,877,1236,0.0
4,1,38,1,1,0,1,872,1235,5,-1,,877,1236,0.0
5,1,38,1,1,1,1,872,1235,5,95, ,877,1236,0.0
2,1,39,0,0,0,212,874,1,52,-1,,926,213,0.0
3,1,39,1,0,0,212,874,1,52,-1,,926,213,0.0
4,1,39,1,1,0,212,874,1,52,-1,,926,213,0.0
5,1,39,1,1,1,212,874,1,52,95, ,926,213,0.0
2,1,40,0,0,0,596,874,1,52,-1,,926,597,0.0
3,1,40,1,0,0,596,874,1,52,-1,,926,597,0.0
4,1,40,1,1,0,596,874,1,52,-1,,926,597,0.0
5,1,40,1,1,1,596,874,1,52,95, ,926,597,0.0
2,1,41,0,0,0,1,923,1235,5,-1,,928,1236,0.0
3,1,41,1,0,0,1,923,1235,5,-1,,928,1236,0.0
4,1,41,1,1,0,1,923,1235,5,-1,,928,1236,0.0
5,1,41,1,1,1,1,923,1235,5,95, ,928,1236,0.0
2,1,42,0,0,0,1,974,1235,5,-1,,979,1236,0.0
3,1,42,1,0,0,1,974,1235,5,-1,,979,1236,0.0
4,1,42,1,1,0,1,974,1235,5,-1,,979,1236,0.0
5,1,42,1,1,1,1,974,1235,5,95, ,979,1236,0.0
2,1,43,0,0,0,660,1026,576,3,-1,,1029,1236,0.0
3,1,43,1,0,0,660,1026,576,3,-1,,1029,1236,0.0
4,1,43,1,1,0,660,1026,576,3,-1,,1029,1236,0.0
5,1,43,1,1,1,660,1026,576,3,95, ,1029,1236,0.0
2,1,44,0,0,0,660,1077,576,3,-1,,1080,1236,0.0
3,1,44,1,0,0,660,1077,576,3,-1,,1080,1236,0.0
4,1,44,1,1,0,660,1077,576,3,-1,,1080,1236,0.0
5,1,44,1,1,1,660,1077,576,3,95, ,1080,1236,0.0
2,1,45,0,0,0,1,1127,1235,5,-1,,1132,1236,0.0
3,1,45,1,0,0,1,1127,1235,5,-1,,1132,1236,0.0
4,1,45,1,1,0,1,1127,1235,5,-1,,1132,1236,0.0
5,1,45,1,1,1,1,1127,1235,5,95, ,1132,1236,0.0
2,1,46,0,0,0,1,1178,1235,5,-1,,1183,1236,0.0
3,1,46,1,0,0,1,1178,1235,5,-1,,1183,1236,0.0
4,1,46,1,1,0,1,1178,1235,5,-1,,1183,1236,0.0
5,1,46,1,1,1,1,1178,1235,5,95, ,1183,1236,0.0
2,1,47,0,0,0,660,1236,576,3,-1,,1239,1236,0.0
3,1,47,1,0,0,660,1236,576,3,-1,,1239,1236,0.0
4,1,47,1,1,0,660,1236,576,3,-1,,1239,1236,0.0
5,1,47,1,1,1,660,1236,576,3,95, ,1239,1236,0.0
2,1,48,0,0,0,689,1266,204,3,-1,,1269,893,0.0
3,1,48,1,0,0,689,1266,204,3,-1,,1269,893,0.0
4,1,48,1,1,0,689,1266,204,3,-1,,1269,893,0.0
5,1,48,1,1,1,689,1266,204,3,95, ,1269,893,0.0
2,1,49,0,0,0,689,1267,1,28,-1,,1295,690,0.0
3,1,49,1,0,0,689,1267,1,28,-1,,1295,690,0.0
4,1,49,1,1,0,689,1267,1,28,-1,,1295,690,0.0
5,1,49,1,1,1,689,1267,1,28,95, ,1295,690,0.0
2,1,50,0,0,0,718,1267,1,28,-1,,1295,719,0.0
3,1,50,1,0,0,718,1267,1,28,-1,,1295,719,0.0
4,1,50,1,1,0,718,1267,1,28,-1,,1295,719,0.0
5,1,50,1,1,1,718,1267,1,28,95, ,1295,719,0.0
2,1,51,0,0,0,892,1266,1,29,-1,,1295,893,0.0
3,1,51,1,0,0,892,1266,1,29,-1,,1295,893,0.0
4,1,51,1,1,0,892,1266,1,29,-1,,1295,893,0.0
5,1,51,1,1,1,892,1266,1,29,95, ,1295,893,0.0
2,1,52,0,0,0,776,1267,1,28,-1,,1295,777,0.0
3,1,52,1,0,0,776,1267,1,28,-1,,1295,777,0.0
4,1,52,1,1,0,776,1267,1,28,-1,,1295,777,0.0
5,1,52,1,1,1,776,1267,1,28,95, ,1295,777,0.0
2,1,53,0,0,0,805,1267,1,28,-1,,1295,806,0.0
3,1,53,1,0,0,805,1267,1,28,-1,,1295,806,0.0
4,1,53,1,1,0,805,1267,1,28,-1,,1295,806,0.0
5,1,53,1,1,1,805,1267,1,28,95, ,1295,806,0.0
2,1,54,0,0,0,863,1267,1,28,-1,,1295,864,0.0
3,1,54,1,0,0,863,1267,1,28,-1,,1295,864,0.0
4,1,54,1,1,0,863,1267,1,28,-1,,1295,864,0.0
5,1,54,1,1,1,863,1267,1,28,95, ,1295,864,0.0
2,1,55,0,0,0,660,1294,576,3,-1,,1297,1236,0.0
3,1,55,1,0,0,660,1294,576,3,-1,,1297,1236,0.0
4,1,55,1,1,0,660,1294,576,3,-1,,1297,1236,0.0
5,1,55,1,1,1,660,1294,576,3,95, ,1297,1236,0.0
2,1,56,0,0,0,689,1294,547,3,-1,,1297,1236,0.0
3,1,56,1,0,0,689,1294,547,3,-1,,1297,1236,0.0
4,1,56,1,1,0,689,1294,547,3,-1,,1297,1236,0.0
5,1,56,1,1,1,689,1294,547,3,95, ,1297,1236,0.0
2,1,57,0,0,0,689,1294,547,3,-1,,1297,1236,0.0
3,1,57,1,0,0,689,1294,547,3,-1,,1297,1236,0.0
4,1,57,1,1,0,689,1294,547,3,-1,,1297,1236,0.0
5,1,57,1,1,1,689,1294,547,3,95, ,1297,1236,0.0
2,1,58,0,0,0,689,1294,547,3,-1,,1297,1236,0.0
3,1,58,1,0,0,689,1294,547,3,-1,,1297,1236,0.0
4,1,58,1,1,0,689,1294,547,3,-1,,1297,1236,0.0
5,1,58,1,1,1,689,1294,547,3,95, ,1297,1236,0.0
2,1,59,0,0,0,659,925,3,507,-1,,1432,662,0.0
3,1,59,1,0,0,659,925,3,507,-1,,1432,662,0.0
4,1,59,1,1,0,659,925,3,507,-1,,1432,662,0.0
5,1,59,1,1,1,659,925,3,507,95, ,1432,662,0.0
2,1,60,0,0,0,950,1353,286,1,-1,,1354,1236,0.0
3,1,60,1,0,0,950,1353,286,1,-1,,1354,1236,0.0
4,1,60,1,1,0,950,1353,286,1,-1,,1354,1236,0.0
5,1,60,1,1,1,950,1353,286,1,95, ,1354,1236,0.0
2,1,61,0,0,0,1042,1197,3,214,-1,,1411,1045,0.0
3,1,61,1,0,0,1042,1197,3,214,-1,,1411,1045,0.0
4,1,61,1,1,0,1042,1197,3,214,-1,,1411,1045,0.0
5,1,61,1,1,1,1042,1197,3,214,95, ,1411,1045,0.0
2,1,62,0,0,0,950,1410,286,1,-1,,1411,1236,0.0
3,1,62,1,0,0,950,1410,286,1,-1,,1411,1236,0.0
4,1,62,1,1,0,950,1410,286,1,-1,,1411,1236,0.0
5,1,62,1,1,1,950,1410,286,1,95, ,1411,1236,0.0
2,1,63,0,0,0,949,925,3,507,-1,,1432,952,0.0
3,1,63,1,0,0,949,925,3,507,-1,,1432,952,0.0
4,1,63,1,1,0,949,925,3,507,-1,,1432,952,0.0
5,1,63,1,1,1,949,925,3,507,95, ,1432,952,0.0
2,1,64,0,0,0,1,1429,1235,5,-1,,1434,1236,0.0
3,1,64,1,0,0,1,1429,1235,5,-1,,1434,1236,0.0
4,1,64,1,1,0,1,1429,1235,5,-1,,1434,1236,0.0
5,1,64,1,1,1,1,1429,1235,5,95, ,1434,1236,0.0
2,1,65,0,0,0,0,1456,1236,31,-1,,1487,1236,0.0
3,1,65,1,0,0,0,1456,1236,31,-1,,1487,1236,0.0
4,1,65,1,1,0,0,1456,1236,31,-1,,1487,1236,0.0
5,1,65,1,1,1,0,1456,1236,31,95, ,1487,1236,0.0
2,1,66,0,0,0,340,1431,1,104,-1,,1535,341,0.0
3,1,66,1,0,0,340,1431,1,104,-1,,1535,341,0.0
4,1,66,1,1,0,340,1431,1,104,-1,,1535,341,0.0
5,1,66,1,1,1,340,1431,1,104,95, ,1535,341,0.0
2,1,67,0,0,0,59,1431,1,104,-1,,1535,60,0.0
3,1,67,1,0,0,59,1431,1,104,-1,,1535,60,0.0
4,1,67,1,1,0,59,1431,1,104,-1,,1535,60,0.0
5,1,67,1,1,1,59,1431,1,104,95, ,1535,60,0.0
2,1,68,0,0,0,532,1431,1,104,-1,,1535,533,0.0
3,1,68,1,0,0,532,1431,1,104,-1,,1535,533,0.0
4,1,68,1,1,0,532,1431,1,104,-1,,1535,533,0.0
5,1,68,1,1,1,532,1431,1,104,95, ,1535,533,0.0
2,1,69,0,0,0,717,1267,3,268,-1,,1535,720,0.0
3,1,69,1,0,0,717,1267,3,268,-1,,1535,720,0.0
4,1,69,1,1,0,717,1267,3,268,-1,,1535,720,0.0
5,1,69,1,1,1,717,1267,3,268,95, ,1535,720,0.0
2,1,70,0,0,0,1234,874,2,661,-1,,1535,1236,0.0
3,1,70,1,0,0,1234,874,2,661,-1,,1535,1236,0.0
4,1,70,1,1,0,1234,874,2,661,-1,,1535,1236,0.0
5,1,70,1,1,1,1234,874,2,661,95, ,1535,1236,0.0
2,1,71,0,0,0,921,1431,1,104,-1,,1535,922,0.0
3,1,71,1,0,0,921,1431,1,104,-1,,1535,922,0.0
4,1,71,1,1,0,921,1431,1,104,-1,,1535,922,0.0
5,1,71,1,1,1,921,1431,1,104,95, ,1535,922,0.0
2,1,72,0,0,0,1107,1431,1,104,-1,,1535,1108,0.0
3,1,72,1,0,0,1107,1431,1,104,-1,,1535,1108,0.0
4,1,72,1,1,0,1107,1431,1,104,-1,,1535,1108,0.0
5,1,72,1,1,1,1107,1431,1,104,95, ,1535,1108,0.0
2,1,73,0,0,0,338,1533,898,3,-1,,1536,1236,0.0
3,1,73,1,0,0,338,1533,898,3,-1,,1536,1236,0.0
4,1,73,1,1,0,338,1533,898,3,-1,,1536,1236,0.0
5,1,73,1,1,1,338,1533,898,3,95, ,1536,1236,0.0
2,1,74,0,0,0,0,1530,341,9,-1,,1539,341,0.0
3,1,74,1,0,0,0,1530,341,9,-1,,1539,341,0.0
4,1,74,1,1,0,0,1530,341,9,-1,,1539,341,0.0
5,1,74,1,1,1,0,1530,341,9,95, ,1539,341,0.0
2,1,75,0,0,0,4,878,1227,717,-1,,1595,1231,0.0
3,1,75,1,0,0,4,878,1227,713,-1,,1591,1231,0.0
4,1,75,1,1,0,55,878,1137,16,-1,,894,1192,0.0
5,1,75,1,1,1,55,879,103,15,91,REISSUED,894,158,0.0
5,1,75,1,1,2,216,881,6,7,63,[a,888,222,0.0
5,1,75,1,1,3,236,878,71,13,38,Employee's,891,307,0.0
5,1,75,1,1,4,311,878,36,10,92,social,888,347,0.0
5,1,75,1,1,5,352,878,48,13,92,security,891,400,0.0
5,1,75,1,1,6,406,878,48,10,96,number,888,454,0.0
5,1,75,1,1,7,750,878,23,10,95,This,888,773,0.0
5,1,75,1,1,8,779,878,61,10,96,information,888,840,0.0
5,1,75,1,1,9,846,881,8,7,90,is,888,854,0.0
5,1,75,1,1,10,860,878,29,13,90,being,891,889,0.0
5,1,75,1,1,11,894,878,51,10,93,furnished,888,945,0.0
5,1,75,1,1,12,950,879,10,9,96,to,888,960,0.0
5,1,75,1,1,13,965,878,17,10,96,the,888,982,0.0
5,1,75,1,1,14,988,878,40,10,84,Internal,888,1028,0.0
5,1,75,1,1,15,1034,878,47,10,93,Revenue,888,1081,0.0
5,1,75,1,1,16,1087,878,40,10,74,Senice.,888,1127,0.0
5,1,75,1,1,17,1141,878,6,10,77,If,888,1147,0.0
5,1,75,1,1,18,1150,881,20,10,77,you,891,1170,0.0
5,1,75,1,1,19,1176,881,16,7,94,are,888,1192,0.0
4,1,75,1,2,0,751,895,477,13,-1,,908,1228,0.0
5,1,75,1,2,1,751,895,44,13,95,required,908,795,0.0
5,1,75,1,2,2,800,887,8,26,96,to,913,808,0.0
5,1,75,1,2,3,805,895,25,10,96,file,905,830,0.0
5,1,75,1,2,4,836,898,5,7,78,a,905,841,0.0
5,1,75,1,2,5,846,896,18,9,78,tax,905,864,0.0
5,1,75,1,2,6,869,896,35,10,65,"return,",906,904,0.0
5,1,75,1,2,7,910,898,5,7,95,a,905,915,0.0
5,1,75,1,2,8,921,895,60,13,96,negligence,908,981,0.0
5,1,75,1,2,9,987,895,41,13,96,penalty,908,1028,0.0
5,1,75,1,2,10,1033,898,10,7,95,or,905,1043,0.0
5,1,75,1,2,11,1048,895,28,10,96,other,905,1076,0.0
5,1,75,1,2,12,1081,896,47,9,96,sanction,905,1128,0.0
5,1,75,1,2,13,1134,898,24,10,97,may,908,1158,0.0
5,1,75,1,2,14,1163,895,12,10,96,be,905,1175,0.0
5,1,75,1,2,15,1181,895,47,13,88,imposed,908,1228,0.0
4,1,75,1,3,0,44,903,1018,22,-1,,925,1062,0.0
5,1,75,1,3,1,44,906,126,15,96,STATEMENT,921,170,0.0
5,1,75,1,3,2,312,903,151,15,78,133-45-6693,918,463,0.0
5,1,75,1,3,3,612,903,28,10,96,OMB,913,640,0.0
5,1,75,1,3,4,646,903,14,10,79,No.,913,660,0.0
5,1,75,1,3,5,671,903,57,10,80,1645-0008,913,728,0.0
5,1,75,1,3,6,751,915,12,7,50,on,922,763,0.0
5,1,75,1,3,7,776,915,12,7,38,you,922,788,0.0
5,1,75,1,3,8,794,912,6,10,38,if,922,800,0.0
5,1,75,1,3,9,803,912,20,10,79,this,922,823,0.0
5,1,75,1,3,10,829,915,40,7,55,income,922,869,0.0
5,1,75,1,3,11,875,915,8,7,92,is,922,883,0.0
5,1,75,1,3,12,888,912,41,10,92,taxable,922,929,0.0
5,1,75,1,3,13,935,912,19,10,96,and,922,954,0.0
5,1,75,1,3,14,967,915,12,7,75,you,922,979,0.0
5,1,75,1,3,15,984,912,15,10,75,fail,922,999,0.0
5,1,75,1,3,16,1004,913,10,9,86,to,922,1014,0.0
5,1,75,1,3,17,1020,913,31,12,52,report,925,1051,0.0
5,1,75,1,3,18,1057,913,5,9,52,it,922,1062,0.0
4,1,75,1,4,0,12,929,1143,13,-1,,942,1155,0.0
5,1,75,1,4,1,12,929,7,10,11,'b,939,19,0.0
5,1,75,1,4,2,29,929,54,13,95,Employer,942,83,0.0
5,1,75,1,4,3,88,929,70,10,94,identification,939,158,0.0
5,1,75,1,4,4,164,929,42,10,96,number,939,206,0.0
5,1,75,1,4,5,681,929,4,10,60,1,939,685,0.0
5,1,75,1,4,6,704,929,40,13,67,Wages.,942,744,0.0
5,1,75,1,4,7,753,930,20,12,91,"tips,",942,773,0.0
5,1,75,1,4,8,783,929,28,10,96,other,939,811,0.0
5,1,75,1,4,9,816,930,79,12,96,compensation,942,895,0.0
5,1,75,1,4,10,970,929,7,10,0,2,939,977,0.0
5,1,75,1,4,11,995,929,41,10,80,Federal,939,1036,0.0
5,1,75,1,4,12,1042,932,40,7,96,income,939,1082,0.0
5,1,75,1,4,13,1087,930,17,9,96,tax,939,1104,0.0
5,1,75,1,4,14,1109,929,46,10,87,withheld,939,1155,0.0
4,1,75,1,5,0,66,954,1028,15,-1,,969,1094,0.0
5,1,75,1,5,1,66,954,136,15,92,65-8736227,969,202,0.0
5,1,75,1,5,2,725,954,122,15,90,165296.64,969,847,0.0
5,1,75,1,5,3,986,954,108,15,87,49693.12,969,1094,0.0
4,1,75,1,6,0,13,980,1139,13,-1,,993,1152,0.0
5,1,75,1,6,1,13,983,6,7,47,ยข,990,19,0.0
5,1,75,1,6,2,29,980,62,13,95,Employers,993,91,0.0
5,1,75,1,6,3,97,983,30,7,94,"name,",990,127,0.0
5,1,75,1,6,4,137,980,44,10,92,"address,",990,181,0.0
5,1,75,1,6,5,191,980,19,10,93,and,990,210,0.0
5,1,75,1,6,6,215,980,18,10,94,ZIP,990,233,0.0
5,1,75,1,6,7,239,980,26,10,96,code,990,265,0.0
5,1,75,1,6,8,681,980,6,10,65,3,990,687,0.0
5,1,75,1,6,9,705,980,34,10,90,Social,990,739,0.0
5,1,75,1,6,10,745,972,45,25,96,security,997,790,0.0
5,1,75,1,6,11,797,983,33,10,96,wages,993,830,0.0
5,1,75,1,6,12,970,980,7,10,42,4,990,977,0.0
5,1,75,1,6,13,995,980,34,10,79,Social,990,1029,0.0
5,1,75,1,6,14,1035,980,117,13,96,security,993,1152,0.0
5,1,75,1,6,15,1084,972,18,25,96,tax,997,1102,0.0
5,1,75,1,6,16,1107,980,45,13,96,withheld,993,1152,0.0
4,1,75,1,7,0,65,1005,1029,20,-1,,1025,1094,0.0
5,1,75,1,7,1,65,1006,92,19,95,"Cooper,",1025,157,0.0
5,1,75,1,7,2,178,1006,81,19,96,Spence,1025,259,0.0
5,1,75,1,7,3,275,1005,41,15,96,and,1020,316,0.0
5,1,75,1,7,4,331,1006,69,19,96,Curry,1025,400,0.0
5,1,75,1,7,5,415,1005,41,15,96,Ltd,1020,456,0.0
5,1,75,1,7,6,725,1005,123,15,90,198300.45,1020,848,0.0
5,1,75,1,7,7,986,1005,108,15,90,15169.98,1020,1094,0.0
4,1,75,1,8,0,66,1031,1053,28,-1,,1059,1119,0.0
5,1,75,1,8,1,66,1039,38,15,96,871,1054,104,0.0
5,1,75,1,8,2,121,1040,69,19,96,Tonya,1059,190,0.0
5,1,75,1,8,3,205,1040,111,19,96,Causeway,1059,316,0.0
5,1,75,1,8,4,681,1031,6,10,66,5,1041,687,0.0
5,1,75,1,8,5,705,1031,51,10,76,Medicare,1041,756,0.0
5,1,75,1,8,6,761,1034,36,10,96,wages,1044,797,0.0
5,1,75,1,8,7,803,1031,19,10,90,and,1041,822,0.0
5,1,75,1,8,8,827,1032,20,12,90,tips,1044,847,0.0
5,1,75,1,8,9,970,1031,6,10,65,6,1041,976,0.0
5,1,75,1,8,10,995,1031,51,10,72,Medicare,1041,1046,0.0
5,1,75,1,8,11,1051,1032,18,9,96,tax,1041,1069,0.0
5,1,75,1,8,12,1073,1031,46,10,94,withheld,1041,1119,0.0
4,1,75,1,9,0,167,1056,977,19,-1,,1075,1144,0.0
5,1,75,1,9,1,167,1073,3,2,8,7,1075,170,0.0
5,1,75,1,9,2,725,1056,122,15,92,164615.68,1071,847,0.0
5,1,75,1,9,3,1049,1056,95,15,94,4773.85,1071,1144,0.0
4,1,75,1,10,0,64,1070,1008,32,-1,,1102,1072,0.0
5,1,75,1,10,1,64,1074,42,14,93,New,1088,106,0.0
5,1,75,1,10,2,120,1073,168,20,92,Davidborough,1093,288,0.0
5,1,75,1,10,3,353,1070,32,32,96,AL,1102,385,0.0
5,1,75,1,10,4,458,1073,137,15,94,63538-3453,1088,595,0.0
5,1,75,1,10,5,681,1082,5,10,64,7,1092,686,0.0
5,1,75,1,10,6,705,1082,34,10,84,Social,1092,739,0.0
5,1,75,1,10,7,745,1083,69,12,85,security,1095,814,0.0
5,1,75,1,10,8,797,1070,22,32,84,tips,1102,819,0.0
5,1,75,1,10,9,971,1082,5,10,54,8,1092,976,0.0
5,1,75,1,10,10,994,1082,53,10,83,Allocated,1092,1047,0.0
5,1,75,1,10,11,1052,1083,20,12,94,tips,1095,1072,0.0
4,1,75,1,11,0,725,1107,446,15,-1,,1122,1171,0.0
5,1,75,1,11,1,725,1107,122,15,90,198300.45,1122,847,0.0
5,1,75,1,11,2,1050,1107,121,15,91,164615.68,1122,1171,0.0
4,1,75,1,12,0,11,1133,1122,13,-1,,1146,1133,0.0
5,1,75,1,12,1,11,1133,57,10,0,โControl,1143,68,0.0
5,1,75,1,12,2,74,1133,42,10,96,number,1143,116,0.0
5,1,75,1,12,3,680,1133,7,10,68,9,1143,687,0.0
5,1,75,1,12,4,704,1133,48,10,68,Advance,1143,752,0.0
5,1,75,1,12,5,758,1133,19,10,92,EIC,1143,777,0.0
5,1,75,1,12,6,783,1134,48,12,96,payment,1146,831,0.0
5,1,75,1,12,7,964,1133,13,10,78,40,1143,977,0.0
5,1,75,1,12,8,995,1133,60,13,66,Dependent,1146,1055,0.0
5,1,75,1,12,9,1061,1136,23,7,94,care,1143,1084,0.0
5,1,75,1,12,10,1090,1133,43,10,92,benefits,1143,1133,0.0
4,1,75,1,13,0,66,1158,1022,15,-1,,1173,1088,0.0
5,1,75,1,13,1,66,1158,94,15,96,4458678,1173,160,0.0
5,1,75,1,13,2,1049,1158,39,15,96,245,1173,1088,0.0
4,1,75,1,14,0,12,1184,1163,13,-1,,1197,1175,0.0
5,1,75,1,14,1,12,1187,6,7,44,@,1194,18,0.0
5,1,75,1,14,2,29,1184,65,13,76,Employee's,1197,94,0.0
5,1,75,1,14,3,99,1184,20,10,95,first,1194,119,0.0
5,1,75,1,14,4,125,1187,30,7,95,name,1194,155,0.0
5,1,75,1,14,5,161,1184,19,10,96,and,1194,180,0.0
5,1,75,1,14,6,186,1184,28,10,93,initial,1194,214,0.0
5,1,75,1,14,7,280,1184,23,10,96,Last,1194,303,0.0
5,1,75,1,14,8,309,1187,30,7,94,name,1194,339,0.0
5,1,75,1,14,9,674,1184,11,10,60,11,1194,685,0.0
5,1,75,1,14,10,705,1184,68,13,79,Nonqualified,1197,773,0.0
5,1,75,1,14,11,779,1184,29,13,76,plans,1197,808,0.0
5,1,75,1,14,12,966,1184,20,10,33,12a,1194,986,0.0
5,1,75,1,14,13,1009,1184,22,10,61,See,1194,1031,0.0
5,1,75,1,14,14,1037,1184,92,10,95,instructions,1194,1129,0.0
5,1,75,1,14,15,1112,1176,19,25,96,for,1201,1131,0.0
5,1,75,1,14,16,1134,1184,22,10,96,box,1194,1156,0.0
5,1,75,1,14,17,1162,1184,13,10,91,12,1194,1175,0.0
4,1,75,1,15,0,86,1215,1016,17,-1,,1232,1102,0.0
5,1,75,1,15,1,86,1229,3,3,0,z,1232,89,0.0
5,1,75,1,15,2,725,1215,38,15,96,148,1230,763,0.0
5,1,75,1,15,3,1006,1216,13,14,75,P,1230,1019,0.0
5,1,75,1,15,4,1050,1215,52,15,75,|6940,1230,1102,0.0
4,1,75,1,16,0,63,1229,924,23,-1,,1252,987,0.0
5,1,75,1,16,1,63,1229,128,17,96,Michelle,1246,191,0.0
5,1,75,1,16,2,272,1230,79,16,95,Brown,1246,351,0.0
5,1,75,1,16,3,674,1241,13,10,58,1B,1251,687,0.0
5,1,75,1,16,4,693,1242,43,10,35,Siatutory,1252,736,0.0
5,1,75,1,16,5,780,1242,50,8,0,___Relrement,1250,830,0.0
5,1,75,1,16,6,866,1242,53,10,0,___Threhparky,1252,919,0.0
5,1,75,1,16,7,966,1241,21,10,51,1,1251,987,0.0
4,1,75,1,17,0,693,1257,213,10,-1,,1267,906,0.0
5,1,75,1,17,1,693,1257,44,10,23,employee,1267,737,0.0
5,1,75,1,17,2,780,1257,18,10,51,plan,1267,798,0.0
5,1,75,1,17,3,867,1257,18,8,95,sick,1265,885,0.0
5,1,75,1,17,4,889,1259,17,8,94,pay,1267,906,0.0
4,1,75,1,18,0,66,1269,1022,17,-1,,1286,1088,0.0
5,1,75,1,18,1,66,1269,44,17,96,730,1286,110,0.0
5,1,75,1,18,2,129,1269,78,17,96,Huber,1286,207,0.0
5,1,75,1,18,3,226,1269,94,17,96,Island,1286,320,0.0
5,1,75,1,18,4,338,1270,77,16,96,Suite,1286,415,0.0
5,1,75,1,18,5,434,1269,44,17,96,344,1286,478,0.0
5,1,75,1,18,6,786,1275,10,11,93,x,1286,796,0.0
5,1,75,1,18,7,1005,1272,13,14,90,D,1286,1018,0.0
5,1,75,1,18,8,1050,1271,38,15,44,|495,1286,1088,0.0
4,1,75,1,19,0,65,1300,921,25,-1,,1325,986,0.0
5,1,75,1,19,1,65,1308,190,17,88,Collinshaven,1325,255,0.0
5,1,75,1,19,2,338,1309,30,16,91,IN,1325,368,0.0
5,1,75,1,19,3,433,1308,157,17,96,29316-8972,1325,590,0.0
5,1,75,1,19,4,674,1300,13,10,49,44,1310,687,0.0
5,1,75,1,19,5,705,1300,31,10,84,Other,1310,736,0.0
5,1,75,1,19,6,741,1301,23,12,85,(see,1313,764,0.0
5,1,75,1,19,7,770,1300,50,10,96,enclosed,1310,820,0.0
5,1,75,1,19,8,826,1300,35,10,96,Notice,1310,861,0.0
5,1,75,1,19,9,866,1301,10,9,96,to,1310,876,0.0
5,1,75,1,19,10,882,1300,61,13,96,Employee),1313,943,0.0
5,1,75,1,19,11,949,1292,9,25,49,|,1317,958,0.0
5,1,75,1,19,12,966,1300,20,10,49,12c,1310,986,0.0
4,1,75,1,20,0,1005,1331,83,15,-1,,1346,1088,0.0
5,1,75,1,20,1,1005,1332,13,14,77,D,1346,1018,0.0
5,1,75,1,20,2,1050,1331,38,15,64,(625,1346,1088,0.0
4,1,75,1,21,0,966,1357,20,10,-1,,1367,986,0.0
5,1,75,1,21,1,966,1357,20,10,88,12d,1367,986,0.0
4,1,75,1,22,0,1050,1388,38,15,-1,,1403,1088,0.0
5,1,75,1,22,1,1050,1388,38,15,92,954,1403,1088,0.0
4,1,75,1,23,0,11,1418,213,13,-1,,1431,224,0.0
5,1,75,1,23,1,11,1418,5,10,91,f,1428,16,0.0
5,1,75,1,23,2,29,1418,65,13,46,Employee's,1431,94,0.0
5,1,75,1,23,3,100,1418,44,10,92,address,1428,144,0.0
5,1,75,1,23,4,150,1418,19,10,96,and,1428,169,0.0
5,1,75,1,23,5,174,1418,18,10,94,ZIP,1428,192,0.0
5,1,75,1,23,6,197,1418,27,10,96,code,1428,224,0.0
4,1,75,1,24,0,6,1435,1210,13,-1,,1448,1216,0.0
5,1,75,1,24,1,6,1435,13,10,91,15,1445,19,0.0
5,1,75,1,24,2,29,1435,29,10,58,Statel,1445,58,0.0
5,1,75,1,24,3,88,1435,62,13,47,Employers,1448,150,0.0
5,1,75,1,24,4,156,1436,27,9,94,state,1445,183,0.0
5,1,75,1,24,5,189,1435,10,10,94,ID,1445,199,0.0
5,1,75,1,24,6,205,1435,42,10,93,number,1445,247,0.0
5,1,75,1,24,7,349,1435,11,10,89,16,1445,360,0.0
5,1,75,1,24,8,370,1435,29,10,93,State,1445,399,0.0
5,1,75,1,24,9,404,1438,36,10,85,wages.,1448,440,0.0
5,1,75,1,24,10,449,1436,20,12,92,"tips,",1448,469,0.0
5,1,75,1,24,11,479,1436,16,9,84,etc.,1445,495,0.0
5,1,75,1,24,12,541,1435,12,10,85,17,1445,553,0.0
5,1,75,1,24,13,562,1435,29,10,91,State,1445,591,0.0
5,1,75,1,24,14,597,1438,40,7,95,income,1445,637,0.0
5,1,75,1,24,15,642,1436,18,9,96,tax,1445,660,0.0
5,1,75,1,24,16,727,1435,11,10,91,18,1445,738,0.0
5,1,75,1,24,17,748,1435,29,10,93,Local,1445,777,0.0
5,1,75,1,24,18,782,1438,40,10,90,wages.,1448,822,0.0
5,1,75,1,24,19,827,1436,20,12,95,"tips,",1448,847,0.0
5,1,75,1,24,20,857,1436,16,9,85,etc.,1445,873,0.0
5,1,75,1,24,21,929,1435,12,10,60,19,1445,941,0.0
5,1,75,1,24,22,951,1435,29,10,91,Local,1445,980,0.0
5,1,75,1,24,23,986,1438,40,7,96,income,1445,1026,0.0
5,1,75,1,24,24,1031,1436,18,9,96,tax,1445,1049,0.0
5,1,75,1,24,25,1114,1435,13,10,80,20,1445,1127,0.0
5,1,75,1,24,26,1137,1435,44,13,95,Locality,1448,1181,0.0
5,1,75,1,24,27,1186,1438,30,7,94,name,1445,1216,0.0
4,1,75,1,25,0,16,1512,1213,18,-1,,1530,1229,0.0
5,1,75,1,25,1,16,1513,26,14,95,RI,1527,42,0.0
5,1,75,1,25,2,131,1512,138,15,89,229-34-366,1527,269,0.0
5,1,75,1,25,3,347,1512,108,15,92,80550.75,1527,455,0.0
5,1,75,1,25,4,539,1512,94,15,96,3668.12,1527,633,0.0
5,1,75,1,25,5,725,1512,122,15,90,117149.08,1527,847,0.0
5,1,75,1,25,6,928,1512,108,15,88,32563.47,1527,1036,0.0
5,1,75,1,25,7,1113,1518,45,12,95,Bobby,1530,1158,0.0
5,1,75,1,25,8,1169,1518,60,9,92,Islands,1527,1229,0.0
4,1,75,1,26,0,139,1538,1092,57,-1,,1595,1231,0.0
5,1,75,1,26,1,139,1542,63,22,95,Wage,1564,202,0.0
5,1,75,1,26,2,211,1542,41,17,96,and,1559,252,0.0
5,1,75,1,26,3,261,1542,40,17,95,Tax,1559,301,0.0
5,1,75,1,26,4,549,1549,27,42,92,2,1591,576,0.0
5,1,75,1,26,5,584,1538,31,57,52,Oo,1595,615,0.0
5,1,75,1,26,6,624,1538,30,57,32,"i""",1595,654,0.0
5,1,75,1,26,7,662,1538,31,57,46,Oo,1595,693,0.0
5,1,75,1,26,8,864,1547,81,15,96,Department,1562,945,0.0
5,1,75,1,26,9,950,1547,11,12,96,of,1559,961,0.0
5,1,75,1,26,10,966,1547,20,12,93,the,1559,986,0.0
5,1,75,1,26,11,991,1547,118,15,40,TreasuryโInternal,1562,1109,0.0
5,1,75,1,26,12,1115,1547,59,12,96,Revenue,1559,1174,0.0
5,1,75,1,26,13,1180,1547,51,12,96,Service,1559,1231,0.0
4,1,75,1,27,0,4,1573,250,17,-1,,1590,254,0.0
5,1,75,1,27,1,4,1579,34,11,93,Form,1590,38,0.0
5,1,75,1,27,2,47,1579,25,11,89,W-2,1590,72,0.0
5,1,75,1,27,3,140,1573,114,17,96,Statement,1590,254,0.0
2,1,76,0,0,0,5,1602,291,37,-1,,1639,296,0.0
3,1,76,1,0,0,5,1602,291,37,-1,,1639,296,0.0
4,1,76,1,1,0,5,1602,291,15,-1,,1617,296,0.0
5,1,76,1,1,1,5,1602,40,15,93,Copy,1617,45,0.0
5,1,76,1,1,2,51,1602,10,12,91,C,1614,61,0.0
5,1,76,1,1,3,68,1602,26,12,96,For,1614,94,0.0
5,1,76,1,1,4,100,1602,103,12,86,EMPLOYEE'S,1614,203,0.0
5,1,76,1,1,5,210,1602,86,12,96,RECORDS.,1614,296,0.0
4,1,76,1,2,0,5,1624,276,15,-1,,1639,281,0.0
5,1,76,1,2,1,5,1624,33,15,95,(See,1639,38,0.0
5,1,76,1,2,2,44,1624,69,12,96,enclosed,1636,113,0.0
5,1,76,1,2,3,120,1624,49,12,96,Notice,1636,169,0.0
5,1,76,1,2,4,174,1624,16,12,96,to,1636,190,0.0
5,1,76,1,2,5,196,1624,85,15,95,Employee.),1639,281,0.0
2,1,77,0,0,0,926,1575,256,36,-1,,1611,1182,0.0
3,1,77,1,0,0,926,1575,256,36,-1,,1611,1182,0.0
4,1,77,1,1,0,927,1575,109,15,-1,,1590,1036,0.0
5,1,77,1,1,1,927,1575,35,15,95,"Safe,",1590,962,0.0
5,1,77,1,1,2,967,1575,69,15,95,"accurate,",1590,1036,0.0
4,1,77,1,2,0,926,1578,256,33,-1,,1611,1182,0.0
5,1,77,1,2,1,926,1596,82,12,16,nto,1608,1008,0.0
5,1,77,1,2,2,1068,1573,12,45,29,@,1618,1080,0.0
5,1,77,1,2,3,1094,1573,12,45,58,>,1618,1106,0.0
5,1,77,1,2,4,1048,1578,134,33,80,file,1611,1182,0.0
5,1,77,1,2,5,1173,1573,12,45,46,),1618,1185,0.0
